#####################################
#  . .   ...... .  ... # # # #.#.# ##
# ## #.#### # #=# ## # #   . #.# .  #
## ## #    .# #  #.# # # ## #. # ## #
#  . . # ## # # #.   # #.# #o# # #.##
### ### #   #.## #### #  #.#.#.#   .#
# # # #  ##.#.  .  .  .#.#.# #.# # ##
# # # # #  .# # # #.## #   # # # .#.#
# . # #. ####.##.# ## ## ### # # #  #
#.# #.  # . .  =  ..  ..    ...#. # #
### # # #.# ### # ## #########.# ##.#
#   # # # #.#. # # #.# .  .  . # =  #
###.# #.##.# #.# #.## ########.# ####
#  .# #       ..o.  .  .   .  .   . #
### # #.# # #########################
#   # #  # #.. ..     .   ..    . . #
###  ##.#   .########################
# #.#   # ##....    .\.    .  . . ..#
# .. ##.#  #.# ### # #### # #.##.# ##
# # # # ####. # . # #   #. # #.# #.##
#.#.  ..   . ##.###.## #.### # ### .#
# # # ## # ##         ... . .. ....##
# #. # #.#=# ## #### ##.## ### ### ##
###.#% #.##   .#   # # ## ## ###.#  #
#.  =#..   # ###.##             .# ##
###.#  ##.#   . .. # #####.##.## # ##
#.. =# # # # # # ##..#.  .#.#  #.#  #
# # # ..  .  # #  .#.### ## ###  #=##
# # .####.## # # ##  ..      . # #o.#
# #.#...  #  # #   #.##### # # # # ##
# # # #### # ##.####. . .#.## #. # .#
# #. #. ..  o ... . .### # .= .#.#.##
# # # #.# #.# # #.## ...# .# ## .# .#
#.#   # # #..# # #.#.##. # #.# #.# ##
#.# #.# # #### # #.#. #.#  # # # #. #
#.# # # #  . .. .. # #. .# #  .#.# ##
#####################################
