##############################
#. #   % ..   #  ### . .  #..#
## ###.## ###.# # #.#### ##.##
#.. .  # #. = #.  ..      .. #
## ## #  # # # .# ###.##.## ##
# ..#.# # .#o## ###.##. # #  #
## # # . #.  .. .. .  #.. . ##
#   . #.## # ##.#####.# # ##.#
# ### #.   ## #.  .   #.    .#
##. #.# ###.  # #####.. #.##.#
## ##.# #.  #o #. .   ## # . #
#   ...# # ## #..###\#.#.# ###
##.##.# .. . .## .   o..     #
#.# # # #.#.## . ### ### ##.##
#  .. ..#=#  # #    .  . . .##
# ## # ##   #  # ###.#### ## #
# #  #  .#####.#.   ...   ...#
#. ###.##   #. ##.#.#.# # ####
# #  . #  # ##  # # #.# # #  #
# # # # #.#.   # # ##.#  #.# #
#..#.#  # ##.##  ...  #.#. #.#
#.#..  #. .#   # #.# ## ##   #
#.# ##.## # ####.#.##. .   # #
# ##       .     # .o#.# #.###
#    ##### # ##.#..##  #.#.  #
#.## #  . . # ## ## ##  # #.##
#. # =#### #.. . .#  ..# ..  #
#.##.#     ####.# .###.# ## ##
#     #.##=... .. #  ..# .. .#
##############################
