#################################################################################
## . .   ..# ..# \ #.# #  . ......# #.#.# #.# #.## #.#.#.#.##.##.##.#. # #.# #.##
#..# ##.## #.#.#.### # # #.# ##.#..  . . ......  ..... ..     ... ..#.# ..  .. .#
##.### ## ##.##  ....#. #.#.# # #.# ##.##.### # ##.#.# ##.#.##.#.# #  ## ###.# ##
#..  .. ..  .. ## ## #.#.  .. ..# ## ### ##.##.# ##.#=## #.#.## # #.#. #.# .#..##
#####.######.### # # #..#### ##...... . .  .   . .  ..       ..=.   #.## ##.##  #
# ..#.# ...  .     . # # .. # # # ####.####### ## ####### ##.# #.# #.  .  .. #.##
# ## ..#.# ##.# # ##.#  # #  . .#.#  #.#    .   . ... ..# #..#.#.# .# #.#####  ##
#.  # #.#.#.###.## #...#.## #####.# # # ####### #######.##.##.#.# ###.#.#  . #  #
#.## .#   .. . .  .  # ......  .....     .  .. .. .  .   .. . . .. . .# .# # #.##
# # #.#.# #.# ### ## .# # ## ##.## ## # #.## #.## ##############.####.# ## # # .#
#.#.# .#.##.# #.#.#  # # ## #.##  # .# #.#. # #..# . . . ... .. #...  # #  ## .##
#.# #.#. .. # # ...# #   .... .  #..#. ...#.   #. # # ## # #.##. #.##.#.##  .# .#
# . # #=#.# #. ##.##.#.# #.#.# # ##..###.## ## #.#=# ##.# #.# #.#  .#. # # ###.##
# ##. #.#.# #.#.###. .# #.#.#.##..#.#  . #.  ....  .... .. ......# ## #.  ..... #
# #.#.# #.# #. ... #.#.= ... . . #..#.##  #.# # ### ### #.#.### # .. . ###.# #.##
# #...# #.# # #.#.#...###.###### ## ## # # #.# ## ### ## #.## #.#####=#..#.#.#..#
#. ## # # #.#..# #.#.# ....  .  . ..  .        .. ...    .  .. ...    # #  #.#.##
# ###.#.# #.#.#  .  ..# ##.## # # # ###.# # ## #.#.# # #.#.#.## ##.## # #.#.# ..#
#.##  # # #.# # ####.#.#..# #.##.#. # ##.# #.## #.# #.#.# # # # # ##..  .. ..# ##
#   # #.#.#=# #.# .#.#. # #.#.....#.  . ....  .  . ...    .... ..= .#.#.# ###...#
# ###.# #.# #.#  # #.#.#.  .#.##.#. ##.# # ## # # # ##.## #.# # ##.#. #.# #..# ##
# . ..# . #.# #.#. #.# ## #.## ##.#.#.# #o#.## # # ## ## # # # #.## # ## ##.##. #
## ##.#.# #.##.# #.#  .  .  .......=.  ...      . . =..  . .... .   #. . .   . ##
## .#. ##.# .......# ### ### # ##.##.################## ###### #####= #.# ## # ##
#. #..#. .. #.##.#.#.#.# # .## #.#.# ...........   ......      ..  .#..# # ###. #
##..#  ## # #.#  # # #.#..# #. # #. .##.###.##=#### ## ### #.# #####..# .  .   ##
# ### # ###.#  # . # #.#.#   # #.### .# # .# # #  #..#.# ..# ... .  #  #######. #
# .. .#   ..# #  ## .#.# .#.##.#.. ..#...#.  # # #  #..#.##.########. # ...  #.##
#####  ##.#.#..#   # #.#.#  .  # # #..####.#   #..#. #.#. . ... .. .#.#####.##.##
#. .#.# ..# #.#.# #. # ##=###### ##..#.... # # # # .#  # ###.#######  .. .... o.#
# # #..##.#.#.. .. #     . ... ....# #.# #.#  .#  # ##.#...#... . . # # ### ## ##
### # #.## # #######.##############.# #.## ## ## # #.#.#.## #########.### ### #.#
#  ... ...  .. ..    ..   ..  ... .. ..  .  .     ..  .  .. ..  ..     .  .... .#
### #.## ## ##.# ##.# #.# # #.# #.# ### # # # ###.###.### ### ##.####.#.###.#.#.#
# . #.# .#.  # #.#.#.#...#.. #...#.##.##.#.#.##.### ### .#. ..# .# ..#.##.# #.  #
###...##. .#.# #.# ... # #.##..#.   ....  .#  .. . .   # .# # .#.#.#.# # .#.# ###
#   # .#.#.#.# #..## #.#.# #.# # ########### ##### ##### # #.##. .## #  #.. #.# #
# #.#.#  # #.# # #   #.# #.#  .#  ... .......  . ....  .  ..  .# #.....#..# #.#.#
###.# ##.#.# #.#..##.# #.#.###. ##.#.###.#.# ###.########### #.# ##### ##.#.. . #
#...#... # # # # #.. # ... ..#.##.#.##.## ##. .# #.   ...  .  ##.  .. ..#.#.## ##
###.# ##.#..   .. ##.#.# ## #. #  ..  .. ..  ##..#.##.##.#.#.#.. #.# #.#..# .  ##
#.#.# .# #.##.##.##.## ###.# #.######.######.#.# ### ## # # #.###.#.#.#.# ##.##.#
# #.# # .  ... ....o . ... . .  ....      .     ... .  ..  ..  . .. ...     ... #
#...#..#.## ## #.##.# ##.#.##.# ###.#### # ## ## ##.#.#.##.# ### ## #.#.## ### ##
# #.#.# ...# #  .# .# ..# #.# #.#.  .  .# ##.# ###.#.#.#.## .# ###.#.#.#.# #.#. #
# # #.##.#=  .#.#.#.##.##.# #.#..##.##.# .   .... .. =   ..#.#  . .. . ..### ####
###.#..# # # #   .... ... ..#.# # #.#.# #.#####.## ##.## #.#.#.# ####### .     .#
#. .#.#   .#. ###.#.#.# # #.# # #...#  .  #  . # ## # #.#.#  #.  #. .    # # #.##
# #.#  #.# #.#.  .#.## # #.# .#.###.#.###.####. ....#.. .  #...#. #.## #..#.#   #
# #. .##.#.#...####  .  .  .#.#...# #.#.... .# # ## # ## #. .##..# ##.##.#..## ##
#.# # #  ## .#. ....#.# #.#.# # # # #  ##.##. .#.#.#. # ##.# . #....    . # .#. #
# #.   #  .#.# ## #.#  # . ## #  #.#.## # .  # # #  # #.#..# #.#.#######.##.#. ##
#.# #.#. ##.. # #.# .###.#.#. # #   . .   ###  # #.#..#  # # # # .  ...#.#. .#.##
#.#.# ##.#.#.# .#.# #. . . .#.# # # # # #.#  #.#.#  #.# #..# # # #### # . # #  .#
#.# # .# #  ..#.#.#. ###.# #. # ## # # ##.#.## ### ##.#.## #.#.#..   ..# #   # ##
#.#.#.##. ## ## ##. #   .# ##.# .  .. . ..#. .  .. . .#..  # # #.######...# ##.##
# #.#.#  # # . =. #..##### .#= ###.# #### .#### ## ##...## #.#.# ..  . # #. #...#
# #.#. #  .# #.# ##.#. .. .##.#. # #.. .#.#  ...#.....####.#.## ######## ## #####
#.# # # .# #.#.#.   .# # #..  # #o#.####... #.#.# ###.#.# =#. . ..  ... ... .. .#
# #.#.##.# #  # #.# # #.#  ##. .. .=.  .#.#  .# .## # ...#.#.##.## ## ###.#######
###.# .#.##..#... ..  #. #. #.#=##.##.##. .##.# # .. .#.##.#...# # #.     ... . #
#.  # ##...# #.# ## ##. ## # .#.##..#.. #.# .. . ####.#.# .# #...# #.###.###.# ##
# #.# #..#  .#.# #. #.# # ..# # .. #. # #..# ## #  .# # .#.#.  # # #..  .# . #  #
#.#.# .#...# # .  # ...  # #  # ##..# #.#.#.#.# ## # .#.# .#.#.#.# #.### # #.# ##
# . # ##.#...#.# #  ######.##.###.## # # .....# .. .#.# ##  .#.# .  ....  ..  . #
# #.#.#..#.# # #. # . . ....#     ..    #.#### #####.# #.####.##.################
# . # .# #.# #  ### #.# # ## .##########. ...... . . ...  ..    .  ..   ... . ..#
#.# #.#  ..# #.#. ..# # ## ##.    . .   # ##### #.# # ## #.#.# ##### #.#.#.######
###.#..#.#.#.#..### # #... .# ## ########.# =. # #.# #.##.#.#  .   #.##  #..... #
#...#.#  #. =# ## #.# #.##.#  #..#       ...## # . .     . .# ##.## ...#.#.######
###....#.# #.#. .   # ..#  ##..#.#.## ### #.#. # # # #.#### .  . # #.## .#.. .. #
# #.#.#. . #.## ### #.#. #. # ##.#... . ..#..#.# ##.##. ..  # ##.# # #.#.#.# #.##
# #.#..# #  . #.# #.#.#.#  #..#..#.# ##.#.# #  #     ..# #.#. . ..... .#.#.#.# .#
#.#.#=# ..## #  . #.# #.##.## ## ## ## ## #.## #.## # # #.# #.#####.###.#.#.# ###
#%..# .#.#. .. #### #.# .#  .  .. .. . .. . .. . . ..... . . .....   .. .  ...  #
# #...##..##.# . ...# # # .##.#.# ########### ## ## ## ##.##.##.#.# # #.##.#.##.#
# . # #..#  ..#.#.#.##.. #.#..# ....  ...  .#.# ..  ....# .# #..## #.#.## # # # #
###.# ## ###.#.# ##. .#.# . # # ### ###.#####.#.### # #.# #..##..      .. .. .# #
#.. .. #.    .. ..  ##. .# #  #.#.. #...#     #   . .   # .# =#.## ##.#.##.# #. #
#################################################################################
