########################################################################################################
# .  ..   # #.## #.#.#.      # #  .  ..# #.#  .# #  ... ..  #.    #  . ..    .        .#  #  # ## #.# .#
# # # ####  #    # # #.####### .#### # # # # #..  # ##### # # ###   #### #.####.######## #. # .   # # ##
# #       # #### #.# #.#    .  #.  # # # # #.  ##  ..    .# #.# #.#..      #   . . ...   .# ##### #.# .#
# ## ######        # # ####### ###.### # #.# # # ## #####  .#   #  ##.#.##.  #.#########.#.       # # ##
# . .    . .## # # #.   .       .  ....# # #  ..     . ...#.####. # #  # #.#    .     .#  # ####### #.##
###########.#.. ##.#.### #########.###.# # # ######### ####  ...# #   #. #. ## # #.##.#  #.  ..    .#  #
#      .  #  # #   # # # . ..   .  . . #.#.#    .  ..       ## #. ## # # # #.##.#.## # # ########.# # ##
#.# #.# ## .# # ## ### ########### ### # #.. #.#.# ## # ### # #.#     ... .  .         ..          .   #
# #  # #  #     . .   .  ..    .   .   #.# ## # # ##.#.#  # #.  # #.### # # #.### # ## ## # # # #.# # ##
# # #  #.#  ## # # # # # # ### ###.## #  # ..   .      #.#  #.#.  # #.#  # ##. =#     # # ## # # # # # #
#.# ##.#.## # # # # #.# # ## # # ### # # # ## ## ###.### ## # . # # #.#.#  # ###.####.#.# .  . .    .  #
#.           ..  .  .       . .          #  .         . .   # # # #   #. #          ..# # #### #.####.##
## # #.##### ## # ##.####.## ### #### ## ## ## #.# ##.# ###    .#.# # # # .## ##.#.# #. # #  # # . ..# #
#. # # #    #  #.# # .. .. # #  .#.    #  #   .## #.# #   # # ##  # ###..# #.# ## # # # # #.#.#.###### #
##  #. #.#### #.. .# #### #   .# ## ###. # # #    # # # # ..#.  #.#    .##.   .         #  .          .#
#.## ###..     #.## .# .   # # #      .#   #.# ###  #.#.#.# #.## . #### #  #.# # # ##.# # # ####### ####
# .      #######   #  # # #  # #.# ####. # # #    # #.#. .  #. .# #.    ##  # #.##.# ## #.#.     . # . #
### #.##.     .. ##  #. # ## # # ## .. # ###.###### ## #### ####.   ###  # # .   . .    # # ######.  #.#
#=#.##.# # #####.# ## ## #.## # # # ####      . \  ..   .  .  . #.#   ..##   ## ####### # #  . .  .# # #
#  . .. .   . .   ..   . ..     .        ### # ### ##.# ##.## ##   #### #..#. ..      . # # # # ## # # #
#####.## ##### # ## #### ## #### ##.# ##.#.# .#   #.#.#.#  .## ##.#  ..  #. ###### ##.#.# # ##.# ## .# #
#.. # # # . . . #.## % #.# #    # ###    # # ## #   #   # #       # ### #. #     #. # # # .   ..   #.###
# #.# # =###.# #     ##  #.# #.#. .   ##.# # .. # #.# #   # ## ## #   #  # # # # # # .# # # ## ### #   #
### #.# #    # #.# #. .# # ##  # # ## .# # # ##  .# #.#.#    #. #   ###.## #.# #    #   # #.# # .   .# #
#    .#..#.# #.## # .#.#.   .# # .  # #  #.#  # ## .## # ## #  #  #    .#  # ## ## ## # # # # ###### ###
### #.#.#  # #   ..# #   ## # .#.## #  # #.# # .  # ..... #. # ##  ## #  # # .  .. # .# #.#        #  .#
#   # # .# .  .## #. .##     # # . = .#. # #  # # #.## ###. ##  ..# ### # . ######  # # # #.# #=##   #.#
####.## # # #.# #.## ## ###### ####### #   # #.  ##.#     # #  ## #  ...## #. ...  #  #   # .#.# ### #.#
#           .    . .    ..      ..       #.#. # #.. #.# #... # #. #####. # # ### # ## # # # #. . .   # #
# ######### ############# ##.########### # #.# .# #  ##.  # # . #.   .# # .#.#  .#  # # #.# # # #### # #
#    . .  .      . .         .        .#.# # .#. .  #.  #..  # # .##.#.. # # #.##. ##.. # # #  .   . #.#
## # # #.# ## ### ### # ## # # #.# ## ## # # #  ###. ## # # #. ##  #  # #  ..    # #  #.# # ######## # #
# . # # # # .# .# #  .##  #. #  #. .#.# .#.#  #   # #  . .#  #..  # ###.##.### # ## ###.#.#       . .#.#
# #     #.# # .#. # # . #. # #### ##.. # ## .## ### ###.### # ### #    .      ..           ######### # #
#. ## ##  # .#  #.#.#.#.# ##.       # ##   #  ..         . ..     # # ## ### #.## ##.## #.# .     . .# #
# #.# . #.#.##.#  # #.#.#  .#.#o### #.#  # # ### ############.###. #.# ###.## ## #.# # .# .#########  .#
# #  .### # #   #.# # # # ## # ## # #..#. .# # # #          .## # #       .     . .   #  .#. .  . .  # #
#  ## #.  # ## #. #...# #   .  .  # # ## #.# . #  ### ### ## #  #. ### # ### # ## ## #  # # ### ####.#.#
#.#   .##    # ##.# # # # # ## #.#. #.#  # # ## .#      .. #  #.#.#..# #.#.     # #  .#.#.# #  #.  # # #
# ### # # #.# . ..# #.### ### # # ## # # #.#  .# .### # ## #.##  . #.###.#.#### ##.# # .# #  # ## # .# #
# .. .    # # # # .##  .   ..  .. .    #  .# # #.# .. .  # #    #.#      #. . . .     # # # #      # . #
# #.#.#.# #  #.#  #   ## ### #.## # #.# .#.. #  .## #.####.# # #    ##### ############# # # .# ## # .###
#   ##  #.# #. ##. ## . ## ## # #. # # #...# # #    .  .   # ## # #...       ..  .        # ## #  ## # #
# #   # #.# .# .  # # #    .   ...#  . # # ..# # # ##.## ##   ..#.### ####.######## ## ## # #   #  # # #
#.#### #.## ## ####.## ## ########.#.# # #### # # #.# # ## # ####  .# #. # #    .. # #   .# ##### # .  #
#     ..      .        .   ..  ..     ..    .   .  . ..    . .    # # ##   ####.###  # ## #.    . .# # #
## ## ## #####.# ## # # ##.#######.### ###### # # #### ##.#.##.## # #  # #  . # .  #    # # ## # # # # #
# #  # .      # #.#.# # #  #        . .#    ..# # #. . #. # #.# # .# ### ###### ####.#### # # ## ##  # #
# # # .#.# ##   # . #.   # # ##### # #  #### # .# # ### # ### # # # . ...   ..    . .    .# #      # # #
# # ## # ###  #.# # # #.#.  ..   #  ## #  ....# ##. .     ... ..#. ### #.## ### # ###.# # # #.## ## .# #
# .   .#     ## ## # # # #### ##.##.# # #### # # ## ############# ##.##.##.##.## ## ## # ## ##.### #.###
### # ## # ## ..      .  .  . .    .     . . ..   .  . . ..  . .     . . .. .  .  ... .   .  .     ....#
# # # #  ### #### # #### ##### ## # # ### ##### #.# ### ##.### # #.## ### # ### ###.# # #.####.#.# ## ##
#.# #  #         # ## ..    . # #.# #.#. #    # # . # #    .   # #  #.# # # # ##   # ## #.#    ## #. # #
# #.# #  ## # #.#    # #.#### #.# # # ##. .## # ##### #.## ## #  #.##.# # # # .# # #    # # ##. #  #.# #
#.# ## # # # # . # #.# #  ..  # # #  ..  # .  ...     #  # #. .# # # ## ##.##.## ### ### #.## ### ##   #
# #.   #.  .  # ##  ##...# # #  # # ####  ### # # # #.#.#.# #### # # . ..     .        .   . .   . ..#.#
#  .### .###### # .#  .## # # # # # #..# #. # # # #.# #   . ..   # # ### ##.## # # ## # ##### #.#### # #
###.   #.# . .  .#..##.#  . .   #.# #.# . # #.# ### # # # ## ### # #.#. ..# # # #.# ##.##..  # #.  # ###
#.# ####  # ### #  # .  #.##### #.# #  #.## #..     # # ## .#  # #   # # ## #  ..    .  .# #.# ### #   #
#        #  #   ## # # ##     # # #  o#.    # ###### .#. . ## #  #.#.#.#.#..  ############ ##     .# ###
### # ##  ##.### # ###.# # ####.# #### # ##.#    .  # # ##   . # #.# #   .# #     . .  .  ...# ###.    #
#   # #  #              .      .   .      # # # ### #.## # ##.#. # # # # #   .## ## ##.## # #  ... #.#.#
# # # ##  #### ### ####### #### ########.## ## ## ###  . .. .  # # # #.#  # # #  # # #  # .  # ##.#  #.#
### #  # #         #.     ..    #   .    ..        .  # # ####   # # #.#.## # .# #    .## ## # .#  # # #
#  .#.#   # ### ## #### # #.# # #.## ###.############  # #..   # ..# #.# # .#.##  #### #  # ## ## #  #.#
# #.#. #.# ## ##.     # .# # ##     #..#. .         #.#   #.###  # # #.#  # # # .#. .#.## #. . #   #.# #
##.# ###.#.    ..# ## #.#       #### #.# #.#########. ## #  .  # # # # #.## #.## # #.#. # # ## .# ##.# #
# .      # #### ##      # ## ##.  .  # # . ..      .#. #  #.###. # # # #   .#. .   # # # ..  # ## .  # #
# ## ### # #.  #   # ##   ..  . ##.#.   .#.### ## #.# #. #. #. # # # # # ## # ##.### ## #.####.# ### # #
# #. . #o#.### ## # ## #########.# #.###.# #    # # # ## ## #.# .# # # # #       ...    ..       . #.# #
# ###.##  . .   .      .     .  .  .   ..#  .# ##.# #   ..   . #   #.# # .# # # ### ## ##### ### # # # #
#     ..### ## ##.# #### ##.# # ######## # #      #.# ##.# # # # #   # # ##. # ## #.# . .. .    #.##.# #
#.# #.# # . =# # # # ..  #.# # #.   . . .#. ##.##.#..  #.#  .# # # #   ... .#.  .    # #.# ###.#       #
#.# # # # # ## # #  #### # # #  ## ##### # # ##.#   # #.   #.#.# # #.##.#.# ## #### #.# ##=# # ##.##.#.#
#.# # # # # #  # # #.    . # #.#     . # # .  .   # # ##### #.#. #.# # # ##. # #  # #   . .  ..   . .# #
# . . . # # .# # #. # ###### # ########  #.#### # # #       .  #  .#.#.     # .## #  # ##.##.## # ## # #
#.#.####  # #  # #.#     ... #.   . .. #.# #   # #    #### ####  #.#. #####  ## # #.# # ## ##.### ## # #
# #.#..## #. # #.# .### ####.# # # # # #.# # #.   # #  .  .  . # #.# #  ..  #.  .  .#             .  #.#
# #.##  # # #  #.#.#         . # # . #.# # ### # #  # # # #.## #.# # .# ### .# ## # #.# # ###.## #.#.# #
# #.  .# .# ## # #. # ## #.# # # # # #.# #. .     #.# ## # .#.# .# # # . .  #.# # # # # ###.### .#.# # #
# ####.##. # #.# # #.   #   .#.# # # #.#.#.# ## #.# #. # #### .#.# # ######... .#.# #.  .    . # ##. # #
#.      #.#  . # # #### # ## # ## # # #. #.# # # .# #.#  .    #  #.#   .  # # # #.#.# ###.## # #   #   #
# ##### # .###      .     . . .   .    # #.#.#.# #..#..# #### ##.# ####### # #.##.## ## ## ## # ####.###
#       . # .  # ## ################## # # #.     # # #.  .    ..# .. ..        .. .   .. ...          #
# ######## .## # .#.. .     .. . . . ..#.## #######.# # ######## #.##### ## ## # ########## ###.#.# ## #
# #       #  # # #. ######## # # # ###.#.  .   . .    . ..   ..# # #   .  # ..##         ..#    # #.# ##
#  #### #.####.#. # #     . .# #.#   #.#.# ## ##.# ##.# ##.##.#. # #.##### ## # ######### ## ### #. #. #
# #. ..  . . ..# #  #.# #.## # #.# # # #  #  # # ## ## #   # #.#.#       .  .        .  .     ..  # #.##
#.#.## ####.##.#  # ## # ## # # # ## ##  ##.##    #. . # #     # # ## #.# ######### # #.# # ## ## #  . #
#.  # # .  # #.# #.  .  ...    .    ...# . ..  # #  #### # ### # #  .# # #  .  .  .. #..# ## ###.# .####
# # # # #.##.#.#  # # #######.# #######  #### #   #    .       # #.#.#.#.#.##.##.# # #.##   . .   #  . #
#.# # #  .   # # #  #     . #.. ..     #.#    ## ## # ##.#.## ## # .##.#.# # # ### # #  . ## # ##.#.##.#
# # # #.# ###   #.#..## # # # # # # ###    ##  #.#  # # #  # #   # #.         ...   . ### #.#.# # #  # #
# #.# #   .  # #    # # #.# #   #.#.#  # # # .##  # # #..# #   #.#  ### #### # #####.#.  .    # # # #..#
##.##.###.### # #####.##.## # ## # # # #.## ### # ## ## # ##.## ## #     .  .#  .  #.# ##.# # # # #  #.#
# . .  . .           .. .  ..     .      .   ..           .    .   ## # # ## # #### .#   .# # # #.# #  #
# ##.###.# #.# ##.## # ## #### # ## ### ## #.#.# ##.######## ### #  ## # # #    .  # #.##.#.# #.# #  # #
#. # #.## # # # #  #   #.#.. #  #   .   .# .  #.    .     . # .# # #..       # # ### #  # # #.#.. # #  #
# ##..  ....  ..# #.#### ## # ### #######. ##.#.#.#####.### #.# #.  .# # # #   # .. .# #..  #.  # # ##.#
#   .## # #### #    .o     . .  ..  . .. #     ..     .       .  # ## #.# # #.## ###.##.## ## ## # # ###
## # #  #   .#..# # ## #.# # ## #.# ## ##  ## ## # #.## #.## # # #   . .  .         ..  .. .           #
########################################################################################################
