#################################################################################
#            .        ..       # #   #  .. # # #.#   .#      .  .   # #.##. #   #
## # ## ##### # # # #### # ##o#  #.# # ## #      #### ######### ## #  #   # ##.##
# #.## #    # ## # # . #  # # # #  #.## #  # ####        .    #  ## # .# #    . #
#.#.  . #.##   . # #.# # #  #   .# #      # .   # # ####.## # #.# .  .## # # ####
# ##.# # .#.#### # #.## . #.##.#  # # ### ## ## #. #.    #  #. .# # #    # #    #
#   ## ##       # .#.  # #   .#.###.##.    .   #  ## ##.# # # # # # # ###  # #.##
# ##    # ## ##  # # # # # # #. .   . ##### ##  # #  #    # # ##.  # .#  # #  # #
#    ###  # #  ##. #  #   ## # ### ## #   #  # # . #  # # #  #  # #  # .#  #=#  #
# ### . .#    # ## # # .##  .# #   #   ## # #   # #.# # # . #o ##  #.##=## # .# #
# . . # # .###    .#  #  # ### # #### # # ## # # #   ## ####.# #.###   . .  ##  #
# ### ## #. .# # # #.#  #      #.# #            ..# # .   .      ..  # # # ##  ##
##       ### # # #  .# # #.# # ### # # # ## ## ##    .### #.#.#.# ##  # # ## #.##
# .# # #   #    #.## #     ##      ## #.# #. .#  # ## #  . # # ## #  ## .\    . #
## #  # ## .##.#.  #  ## #  # # ##. . # # # ### # #.  # # #.  .    #   .## ## # #
#.#. # .  ###.# #.## # # # # # # # ## # # #     # # #. ##..# #### ####### # ## ##
#  # ##.##    .    . .   # .     #.#  # # # ###    #  # .# ##   #  #            #
# #        # ## #.### ### ## ### #. #     # #  ####. # #.#.  ##..##  ## ####.# ##
#   ### # ###  # #. # # # # #  #  ### #####  #     # #  ..## ## # .#.  #    #  ##
# ### ## ### .#  # ## #     . # .#    #  .  ## # ###  # #       # #  ## ###  #  #
# .       # #  # .     # # ##. # # ## ######    #    #  # #.## ##  #  #     ## ##
# ### # #.#.# # # #.# #. .#   #. # ###.     # # # # # ### ## # #  # # # # #o   ##
# # ## ##    .# ##. # ###  ##  # #  # # ### #.# #.### .    # # ##.# #  #.# ##.#.#
#.#  #    ### #   ##    # ## ## ## #    #.#.# # # .  .## #.#  # . #.  ##  . # # #
#  #. ### #    ##   # ##           .### #   ###.##.# #  .# # #  # ### # .## # # #
## ##.#.  ##### . ##   #.##### ### #.   # ## .  . ###.# # .  # ##  .  #.###   # #
##  # #.#       ##.# ### #.  .#    # ###.#.# ##.## ##   ## # # # # # # # # ###  #
#  #  # ##### ##    #    # ### ### #   .   # # .     # # # # # #. # ##        # #
## ## #  .  #.#  ## ## #     ..#   # # # #. ## ##### # # # ###  #      ## ##.#  #
#     # ## ## ## #.   ## #####.# #   ##.# .#    . .#  #  # .   # # ## ### # # # #
## ### # ### # # #### # #  . # #. ##     ## ## #### # ## .####      # .#    .   #
#    #.    ..      .#.#   # #. #.#   #.##   .#      #   #   .  # # #  #.# ##.## #
## # . # ####### # #  #.# # # #  # # ##.# #.# .#### # ### ##.#### # ### ...# .# #
#.# ###          # ### ##.##.# #.# #. # .  #.#    ## #    .# #.#   ..  ## # .## #
#  .#  # # # ### .#   .         # ## # ## #  # ###   #.### #.#   # ###    .# #  #
# ##.# # # ##  #.#  #### # ## # #.  #   #   ## .. ##.# #  #  .## # # .# # ##  #.#
#  .  .  #  ## #  #     # #.# # # # # ##  #   ### #.    #  # #   # # #.# ## ## ##
## ## ##  #. .  # # ## #  # # #.# # #.###. ##   #  ## ##  # # ### ##          ..#
# #   #  #  # # #     # #. . #  # #   .# # ##.##  # #   # .      .   ## # #######
# # #.# # #    # #### # # ###  #  # ####      . #.  # ### ## ## ### #.# #       #
#.#  # .# # ## # #  # #..     # # #      # ##.# ### #.  ..#. # ##   #. #  ## # ##
# # ### #    ..# # ## ##### #.# #  ## ##.# #.###  #  # ##  ## .  ## #.#  #  #   #
#   ##   ## ###  # #     . #    # #  # # # #. # #  # #.#  # # ## #  # ##   #  # #
# ##  # #   # # #. .# ### #  #.#  # #  # .#.#     # .# ## # . #.  #.#    ## ##. #
#  . #   #### # ## ## # .## # # # #.## # #    # ## # #  # #### # ## #### #  . # #
#.###.#.#  .  # .      #.. ## # # #  #   #.## #  # # # ##     .# # #     ###.#  #
#.#.#  ## #### # #### #  ## .    .# # ## #   #.##  # ###  # ##   . # ###   #. # #
#.   .#      . # # .   #.#  # #.# #   #  # #      ## .  #  # # ## ##   # ##  ## #
# # ##  # ## ##. ## #.#.  # #  ## ###  # . # # ## # .## # # .# #  #  # # ###..  #
# # # #  # #.  #. .## ## ## # #  .= # #  ## #.##   # ..##. # #  #  #.# #..# ## ##
#.#   # #. # ##  ##.   .... # # ### # ##   . .  #.#  # #  #.   # #.# # #.#  #.#.#
## ## #  #.#  ##. # # ####.# #.#  # # .  # # ## #.# #  .# #.##    #  #  # #     #
#  ..   ##  ##  .#  ##.  # . #  #  .## ## # # # # ..#### . # #.## .#  ##.  .###o#
## ## #.# #  # ## ## . ##. # # # ##  #  #      # ##  . .# #.    # #  #  # # #   #
# .# #    # #  ##  ### . # .     .  #  ### # # .  # #### .# ## # # # ## ### ### #
##   # ## #  # . #  . ## # #########.## #.# # # ##  #.  # .#  #       #.     .# #
# ##.# .#  # # # ### #     .   .             .# #.# #.##  ## #  # ##.## ## # ## #
#   #  #  ##.# #  . . # ### ###=## # # ##### ##         #    .#. # #     # # #. #
# #  #  # .     # ###.# #  #.  #   .  #     ##  #######.# # # #.## # #### #.#.###
# # #  ### ##### ##. #. ## #.#.# # # # #### . # #  .   ## # # #                 #
###  # ##.#         # #    ##. #.  ###    # ###   ## ##   # # # ## #.## ### ## ##
#  .#      ###.# ## . # ### .# # ##   ###    . ##     . ## # ##  ## # ## . .# #.#
# #. # # #.. #. # #.##   ..# # # #  ##. # # ###   ### ## .    . #... .  ##.## # #
# # ## # # # # #  #  #.###.# #.#  # # # ###.# ### #.## # ### # ## ##.##.#     # #
### . . ## # #. # # #  # #   #  # # #    . .#   #.      #  # #.#.  #  #  # ##.# #
#   #####  #=# #     # # #### # # # #.###.### ###.# ### # ## # ## #..#  # .#  # #
# #.=  . # # #.## #.##.       # # #  #    #       #.   #     #   # #  #  # .##  #
##  ## # #.#     #   .### ### # #.#.# # # ####### # ##  # ##  ## # ###  #  #.# ##
#.# # #  # ###### # ##   #  # # #. .   #     ..   ##   #  ##.# #      #  # # #  #
# #    # #   ..     #  #.## # # # ## #.# #.## # #   ##  .#  # .. #.# # .#. #   ##
# # # # ## # #######.##     . #.#.###    ### # # ## #  #  #  ###. #  ##  # # ##.#
# #.# #  . ##      .   .# ## #  #  ### ## .=  .%  #  # # ## #   ## #  # #  #    #
#    # # ## . ## # # ## ### # #.# # # ## # ## #### # #  .   # #  # # #  ## .## ##
###.## ## # #.#  # # #            #   #.    #        ## # ### # ##.  ## .  #    #
# #.     . #  .# ##  # ######### ## # #.## # # # ### .# # #  #  #. #   # #.# ## #
#   ###.## ## #   .#.# #  =     .#   #  #  # #####.# #  # # # #  #   ##  # # # ##
# # ..#.# # ..# # ## .## ### # #  #.# #  #     #     =#.#..  .  # ## # ##  #.# ##
### #.#  . ## # # #  #.  .  #. #.#      ## # ##.##### ### #####.    #.   #    . #
#   ## ###  #  .# #.#  ## # #### # ####.#  #              #    .# ## # ###.## # #
# #    .  ##  # #.#  # .  # .     #      #  # #.## ## ## #  #.#  #     ...  # # #
#################################################################################
