###########
#=.==...%.#
#=#.#.##.##
#..##o...##
###.o#.#..#
#..o#....##
#.#...##.##
##.##.#...#
#.....\#.##
##.##.#o..#
###########
