######################
##.## #.# #   .= #..##
#   .. ...#.# ###o#..#
##.##o## # %.\  . . ##
##.# ##..#=### #.##.##
#  ....# #. . ##.#. .#
##=#.#     # # =  #.##
#  #  ###o#   ####..##
#.# .#... ##.##. .#  #
#  #..#.##..  o.# #.##
######################
