########################################################################################################
# #  ##.# #.# . .... ... ...#.# #..#.##.# ## # # ## # #.## #.##.## #.#.# #.#.# #.#.. # #.   .#.# #.#  .#
#.#.#  ..  .#.##### # ######. # ## #  . .   . ..... ..  ..... .       .   .   .. # ##   #.## #   #.##.##
#  . ###### # #.. # ## .  ..# #..#.# ##.##.####.# ## #.##.##.## # ##.##.# # ## #.#.# #.# # #..## # ... #
###.#..   #.# #.#.#   #.#.#.#.# ##.#.#   .#..  # # .# #..#.# #.# .#.# .# # .# # #. #.#.. . #.#.. #### ##
#.#  #.##.#.# #. .# ### ##.#..# #. #.###### ####.##.#.#.## ### ####.# ##.## # #  # #.# ##.#.. ##.   .  #
#.# ## #.#  # ### #   .  . .#.# ##.#.   . .  . . .  ...  .   .. . ..  . ..# # #.#..#.#.# # #.#.# ##### #
# #.# .   # #.. # # #.# ##.# .#  ..# ######### ##.# ###.#.# #.##.#.#.# # ## # #.##   #.# #.# #.# #..   #
# # ##.### .#.###.# .#.# ##.#.# ###. #    .. ..# #.##.##.#.# ## # # ## #.#. #  .  .##..# #.#.  # # ### #
# #... ...#.#.#.  # #....   #.#....# # ####### # .. ...    ...        .# ## # # ##   #    .#.##. # #. .#
#.# ##.## #.#  ##.# ## ### # .#.#### #.#.. . #..##.## ##.#.##.#.## ###.#  # # # .# ##. #####.# # ##.####
#.#.#..# #  # #.# #..# #.#..#.# #. .  ##.####.## ###.# ##.## # ##.##.##.## #.#.###.# #  .    .  ..    .#
# #. # #  #.#.# #.#### #.### .# .### # .. .  .  .  .  ..      ..    .... ..  .  .. #  .############### #
#.# # .# #  # .. . .... . ..# #.#. . .############################################.### # .   .    .  ..#
# #..#.#. #.# ########### ## .# # ## # ..  . . .  .   .     ..     . . ..  .  .    ... #.## #.#.# ##.# #
#.#.#  #.##.#.# .    .. . # #.#..#.# ####.## ###.#####.#.# #.# # # ## #.##.# #.## # ## # #.#.#.#.##.##.#
# #..#.# # .#.#.## ### ##   # # #     ...#=#.#..#. .....# #.# #.#.##.#.## # # ##.#.##..#.#    . .   .  #
#.#.#..#. #.#..##.##.### ####.# .### # # #.# ##..## ## ##.#.#.# ..  .. . .# #  .   . # # ## ###.##.#.# #
# #  #.#.##.#.#.. . ... .  .  #.#.....#.## ##.# #.##.#.   # # #.###########.#### #.#.# #..# # ##.#.# # #
# # #  #.#..# #.# ## ##.#.### # #### #.   . ...   . .# ####.  # .... ..      ..# .# #  # # .# ...# ##. #
#.#.## # .# # # #..#.# #..  # #.   #.#.######## ## # #.#....### ## #.# ### # #.#.## ## #  # # ## #   #.#
#.# .#.# #..# .# ##.##.######.# ###  # .....  #.# .# #.#.## #.  #.#  # # ..# # #. ...#  ## ## # #.#### #
# # #..#..#.#.#.. ... ..   .. # #  #. #########.###.# #.#.# ### #.###.# ###.# ## ####  # .... . .    . #
#.#. #.#.#. # #.##.## ### ### #.# # .#           . . ..  . .     ..  . .  ..  .  ... #. #.## #.#.### #.#
#.#.# ##.## # # # ..# # .# .# #.#. #  ### #.#################################### ##### #.# #.# #.#.# #.#
# #. . . .# # #. ####..#.##.# # # ## #.  #.#          . .  .    ..  .  . . .    .# . . # # ##.#.## ## ##
#.# #.#.# #.#.#.#. .. # . ... # # ...#.# #.######.# #.# ##.#### #.# # ########## ##### ......  . .   . #
# #.## #.# .# # #.#.# #######.# .#.# # #.#... . .#.# # ##.#   .# #.##   ..    .#   . # ##.##.### ##.## #
#.#  .....#.# #.#.#.#.  ..  # #.# # .# #.# #### # .# #. . ##.##. #.# .# #.## ###.#####. #.# ##.##.#  #.#
#.#.######  # #.# # #.## # #  #.# .# # # # #   . # #  # #   . .#.#  # # .# # #.  #..  .## # ..  . . #  #
# #  .   .#.#.# .##.# #.#..##.# #.#  ###.# ####### #.#.##.######.# # #.###.## ##.##### # # #########.###
# #.##.## #.# #.#   # #  #  #.#....#  . .  .  ....... .   .... .   .     . . .    .   ... . .      ..  #
# # # ## # .#.#  ##.#.#.#  #  #.# #  # ### # ##.#.###.###.# ####### # ##.#.### ###.#.###### ##.#.# ### #
# #....  .#.# #.#   #.#.##.## #  # # .## .#.# ##.## #.#.#.# #.. .. # #.## # .  #.# ##   . #  # ## ##..##
#   # ##.#..# #. ## #.# .#  #.# #. . #   #....   .. # #.## . #####.# # .#.#.##.#.## #.####..#   ..  # ##
### ## ## #.# #.#   #.# #. #..#.#### #.#. ### ####### #  .#.#. . . #.# #   # #       .   .#..######## =#
# #..    .# # # #.# # #o## .# #.....  ## #     .  ... #.## .######.#.#.## #.   ##.## #.#.#..#  .  o. .##
# #.# ####. #.# o#.##.# .. # . # #.# #.  # # ##.###.#.# ..#...  ..  .#  # #### # ## #.#.#.#..######## ##
# #.#..   # #.#.#.. ..#####.# # #.## .##.##.# ### ##.##.###.#########  #   . # . ... .   .# #. .    #..#
# # # ####  #.# #####\.   . #.# ..  .#..   ..  ....  .. ....# .. ....# ##.####.#.##.####.# . ##.##### ##
#.#.# #. .#.#.#.    # ### ##..#.##.#. # # #.## # ## #.###.# # # ## # #  # #.   # #.#. . # # # ...  . ..#
#.# ### ### # ###### ##.### #.##.### #.#.#.## #.# ## ## ## #.# # ### #.## #####.##.#.####.##.########.##
#. .. .  .    .  . ..        . .. ... . .     .. ... ...    .  ... . .   .. .   . . ... .... .  .  .   #
# ##.##.#.#.##.# #.#.# #.##.# #.#.## #.# ##.# #.###.# ##.# ###.###################.#.#### ## #.#########
## ## ##.## #.# # #.# # #. #  .# ## # # ## #.#.##.## #.#.# #.... .  .. .     . ..# # # .#.#.# #...     #
# . .. . ..  .. .  .  . .#.## # ...   .   .  ..   .  .   # .##.####.# # ##.## ##.# # # #..#   .# #.# #.#
## #.#### ###.## # ##.###.  . .# ##.#.# ######### ####.#.#.### #.  .#.#.#.#  # # # #.# .# #.##.#  # ## #
#.#..  ..#  # # .#  #    # ## #.#..# # #. .   .  .# .#.# ##.# #.#### #.## ##.#.##..#.# ##.#.#..#.#  .  #
#.######## #.#.##.## ####.#.#. . #.# #. # ## ## #.# #.## ..  . . .  .  ...   ... #.# #.#.## ####. # ##.#
#.. . ......   ... ..  . .. ..#.# . .#.#.# ##.### # #.   ### ## #.# ##.## ###.##.# #.#.#   . . . ##.#..#
### ## ## ##.##.### ## ######.##.# ## .#..... .  .#.####.#.. # #.#.#.#.# ##  # #.# # # #########.#.#.###
#.# #.# # # #  # .# # #.  .=# .... . #..##.# ## #.# . .# ### #. .... #.  ..#.# # #.# #  . . . ... .    #
#.#.#.# ###.## # #  # ## ##.#.####.### # ##.# ##.## ###   .# #.# # ##. # ##. # # #.#.#.# #########.#####
#.#.#.#. .   # # ## # .#.#. # # ....  . .  . .     .   # #.#.# # #.#.#.#.. # #.# # # # #.    . ..#.#   #
# # #. ####.# ....# # #.  # #..####################.#### ##.## ##.## ##.#### # ## .# #.# ##.## ##..#.#.#
# . #.#   #  #.###  # ####. #.#    . . . . ..        .  =.      .... .... .  .. .# ### ### # ###.##.## #
###.#  #.##.##.   # # . ..#.#. ######.####.# #####.##### ##### ##.# ## #.# ### # # .      .. ..   .  . #
#...#.#  # .#  # #..# #### .#.# . .  .#  .#.#..  # #. .#.#.   # # #.#.# #.## ##.#..## #.#.## ## # ## ###
### #..#  #  #.##.# # # . #.#. ###### .# #. .##.##.# ##. .#.# #.#.# # # #. . ... #  .# #.#.# # # #.# #.#
# . # #..##.# ..... # .# ##.#.#    .  #  ## #.# #. # #.# #. # #.# # # # # # ##.##  # # # #.#.#   # # # #
# # #  #.# ..# # ## #.# .. .#..#######.#  # ..  .#.# # .. # #.# #.# #.#.#.#.. #  #  ##.# # #.# # . # # #
# #.# # ..# # #  #. # # ###.# #   .  .. .#..##### .# #.#.##.###.# # # #.# ##### # .# . . ..#.### ##  #.#
#.# #. #.##.#.##  # # ###.# #  ###.# #.#. # # ...#.# # #.#.   ... # # #.#..  .   # .## ##### ....  # # #
### # #. .. #  #.#..#       #.##.##.#.##.##.#.####.# # #. ### #.# #.#   . ##.##.#  #.   =... ###.# #   #
# ..#..# ## # #. .#..# # ## #.#.... . .     # #.   #.#.# # .#.##. #.# ### #.#.  ##.# #.# #.#.# ##. #.# #
#.# # #. #  # .# #. # # #.#.# .############ #.#### #. ##. # #.  #.# #.#.#.#.#### #. # # # .#.. ..# # # #
### #..#  #.# #  .#...   .# #.#...... .......    . # #   # .  # #.# ## .# # ..     # ..  #.#.#.## .# #.#
#   # #..# .#  #.# .######..#. #.#.# #.#.# ###.#.#.#. ##..###.#.# #  .# #..##.##.# #### #.#.#.## ## #.##
### # .#  #.# #   # #    .#.# #.#.#.# ##.# # # # # #.### #   ...# #####.# #.### # . . .. .     . .  . .#
# # # #..#.... # #  #.### #.# #   ...   .#=#  .# #.#=##. .#.# #.#     .  .... . .#.#.# # # ## # ###.## #
# # # .#  # ##.# .# # #   #.# #.## ##.##.# #.#.# #..  .# # .# # # # # ## ##.#.## # #.#. #.#.###.# .#.# #
#.# # # ## .#..#.#. # ###.#.#.##.### #.##.# #.# # ##### # ## #.# #.#.##.## #.## #..#.#.#..  . ..# #. . #
#   #    .# .#.#..#.#...# # #    . ..%.  . . .. .   .. ......  .  ..   . . .  . .# # #.#####.##.#  # #.#
### # ##### # # ## #.####.# # ### # #.#.#.# #### ## #.#### ## # # ##.#.#### # # # .# #..   .#  .# # #. #
# ###.  .   .  .  .. ..     # #  ## .#.#.#.#.  . # .# #... # # # #  #.# . .#.# # #.#.#.##.## .# # ...# #
#...  ###### #.#######.## # #  # #.###=# # .## # ###  .###.# # #.#.## ###.#   ...# # # # # ##.### ###.##
## ##.#..  #.# #.. . ..#. #.#.##..  .. . #.# #.#. ..# # ...# #.# ..   .   .#.# ## .# #      ......   ..#
# #.# # ####.#..####### # # # #. ## ##.# #  .# #.##.#..### # # # ###.### # #.#.. #.# #.##.#.## ##.# ####
# . . #      #.#  .. .....# # ##. #.#.# # .###.# #..#.#  #.# # #.#.###.## #  ####  # #  .# # .#.## #  .#
# # #.# ##.#.# #.## ## ## # #..#.#   .. .# #.  #. #.#.# #..# #.#.#...  .  .# .   #.#.# ### #.##.    # ##
### #.### # #.# ##.# ###.#..#.## .#.### # ..##.#.#.# .#. # #   . # #.# #.#.# ## #..#.# # ... #. ### # ##
#   # .. .... . ..   . ...#.# #..# .#   ## ###.#  ..#.#.#. .##.# #.##.# # ##.# # #.# #  # ##. # #.. # .#
#.# #.################# ##  #. # ###.###.# ##.#.##### #.## #.. #. . ..   . . .   # # #.#.#.#.##.#####.##
# # #.#..  . . .  .    . .#.# #..   . .     . ... ....#. # .##.#.##.# #.### ######..##.#.  .   .   .. ##
##.## #################### ##.## # ##########.###.#.#.# ## # #.#.# ## ### #    . . # .  ## ##.#.## ##..#
#....  ... ...    .  .  .  . ..# # # ... . .  #.  #.# #.#..# ..#.#.  . .  # ##.# #  ## #.###.# ##.# # ##
##.## # ########### # #.##.##.#..#  # ##.##.#  ## ##..#. #.##### #########.## #.#  #.     .  ..  . ..  #
# # ###....  ..  ..# . .#.# ...# #.#.## #.#.#.#.....# # ##.. .    .  .   .    . .# .##.### #.#.#.#.###.#
#   ....############.#### ### #  # #... # ..# #.#.# #.# ...### ## # #.##.# ## # ##.#.  #. # # # # ##.###
# ## ## .. ..    .      .  .#  # #=.###.### #   #.##.  ### #.## ##.#.##.# # # # # ..##  # # . ..  . .  #
##o# # .# #######.#### # ##.# #..#.#  . ..  # #.#.  #.#... #   .    ..... .   # ## ##. #  #.#.# ## ### #
#.... #.#  .. ..#.# ..# #.# #  ###..#.### # # # # ##. #.##. #.########## # ## # .# ..#.## #  #.## ##.# #
##.# #..#.# ## ##  ## # # . #.# .. ##.#.  #.# # # .##.#..# # .#     . .#.#. #.# #..# # ...# #. ... . ..#
# #.# ##.# #.###.##.#.#.##### .#.#.# # ### # .# #.#.  #.## .#.####.####.# ## .# .#.## #####.############
#. ..... ..... . ..       ..  ## #   .   .  # ## # ## # # .##..  .   .  .  .#.#.#....   .   . .   ..   #
#### ### ##.#.#.# #.# # #.# #.#  # ##########. . .  #..# #.#  # ##.##.## ##.#.#  # ###.#.## # #.#### ###
#.  ...#.# # # # #.#.#.# # #.   ##.#.   ..  . #### #  #.. .## ##.##. #.# # # .# # . ..# #..# #.# .    .#
## # ### . .      .. .   .. #.#  ...#########.. .#. #  # #  #  ...#.#. #.#..# #. # #### #.## #.#.#######
#.#. #.. ### # ###.# ##.##.# .#.## #        ..### .#. # ##.#. ##### ## ###.#..# #.   ..   . . ..  ..   #
# .# ### # ## ## ## # ### #.#.# #..#.####.###... #  # # .   #     .. .. . . #.#  #.##### #.#.#.# ## ## #
# ##.  # #.  ...  .  ..  ..  .# ##.#. . #.#.# #.# .#  .#.# ## # # # ##.#.# #..#.#  .  .# #.##.# ## #.###
#. ..### ### ## ## #.#### ###.#..# # #.#. #.# # .#  # #. # #.  #.#.##.# # # #.# .# #.## .# .. .  . .   #
## #.# ..  #.#  .#.#.  .#.#.  #.#  # #  #   #.#.#. #   # #..#.# .   . .     ..# #..#...# #.## # ## # #.#
########################################################################################################
