##################################################################
# .    .  . ..#. . . .. .. .  .#  #....# #.. .  ..# # ##.# .  . .#
#.#.##.##.#.# # ##### ## ##### #.# .##o#..# #.# #....      #.# #.#
# ..#   #   #..   . . ..  .   .  .# ##.#.# #.#   .# ######   # ###
# ### ###.## .#.#.##.# #######.# # ..  ... .. #.#.  . .  # # #...#
#... %. .   #.# . .# # .  .. #.# ## #####.###.#.# # ## # #.#=#.# #
# ## # ###.#..#.# #  ..### # #   .    .\. . ..# # ..#.#..# ..# # #
#.. #  .. . #...#  .##. .  # # #.## ####.###### #.#.  .# #.#    .#
# #  .# ##.# .#. #.## # ## #.#  . . .      .  ..#.#.##.#.#.#.# #.#
# #.#     . #   #..    ....    ##.## #.# # ## #. . .# . .   .  ..#
# . #.####### #.# # #.#.## ###. ...# #.## #.#.# # #.### ##.#.#=#.#
#.#    .   .. #.#.# # ## ..  # #.# #... .     ..# # ... .  .. ...#
#.# #.# ##.##..   ..     #.#.  # #.######.####.#..# ## # ##.# ##.#
#. .## # ##.# # ### # ##.   .#  .  .  ..      ..#.#.   ..   #.#.##
# ##..   .    .... #.## ######.# #.#.#.# # #.##    .# # # # ### .#
# . .# ##.###.####. ...  . ....# . .#. . #.# #. # ##.# ..=    ..##
# ## . ..  . .  .# #### ## # #.  ##..#.#  ....# #..  . # ##.##.# #
#.## #.## #.# # #...  ... #. . #.. .#.#.## # ##.#.## #.#.# .#  # #
# .  .  .# # # # # ####.#..#.#.# ##.. ...  ..   #.#.##.#.##.##. .#
#.##.#.#  .   .... .....#.##.#.### ###.#.###.## # .   ....#  # ###
#... #.## ##### ## ## #.#.# ...    .. . .= .. ..# #.####.#..#  # #
####.....   . .. .    . . .# #.#.#.#.#.#.## #.#.. #. ..  .#. # . #
#   .# #### # # ## ## # #.#. # # ##.#.#.## # #.## ## ##.## ##.##.#
## #.# #. .. ...   .. . .. #  .      . ..   .  .  .  . .. . =. ..#
#.  .  # ######.## ##.# ##.# ###.# #.#####.#.#.#.## ### ## ### ###
## # #...... ....  # .#  #   .  ..   . .. .#  .#..  .    ..  #   #
# .  .# #.# # # ## ##..# # # ## ##.##.## ##.#.#. ###.#### ## ..# #
# ##.#   #.#.##  #....#.   #.#.. ..#.. # #  .. #. ..    ...  # # #
# .#  .# ..   ..#..##...## #...#.#   # #.. ## #o.##.# ###.##.  # #
#.# .# ###=# ## # ##.###.#.#.#  .# #.  # #  .  # ##.# #.   . #.. #
#  # # . .. .. ..#  .. ... #.#.#.#. ##.### ## ##. ..# .## # ## #.#
#.#  ..#.# #.##.#. ##.## #  ..   . #..... .. . . ##.##     .. .# #
#..#.# ..#  # #. #   #.# #.#.#.# #..# # ## # #=#....  .#.## ## . #
#.#..#.#.# #  # # .# ... . ....  #.# #.#.##.#.## ## ##.   #..#.#.#
#.## ##.#.# # #.## ## ####.#=### #.#  .  ...     .# . .#.#..#. . #
#  # ..  ..    . . .. .... #.  . #. #.## # # ### # .##.# .# .#.#.#
# #  # # # # #.# ###.###.# . ###. .# # #.#  .  # ## # .# ##.#    #
# ..# # ## ##.## . #.. ### # . # # #.. .. .###. . .  # #. . .# #.#
#.#  . ...   .  .#   #.   ...#.. # . #.# # # . # ## ## .#.#### ###
# # # ## #### #### # #.##.##  =#   # #  . ...#   #..  .# ...  .. #
#  .    ..   # .   ..## ###  ##.# ##.#o#### # ###.##=# ##.# ## # #
##.## ## # # # ### # . .. .#   .  .       .   .. . . .  ..      .#
##. #...   .  .     ## #.# ..##.### ##.##.### # ##.#.##.#.### ##.#
#..# .##.## ## ## # . .. # # ..## ## ## ###  ..  ..#  . .  .. .# #
## ##  #. .  # .    ## #  .#.#.  .... .    ### # # #.#.#.# ###.#.#
#  .. #.## # ..## # #.#.# ##  .#.#.##.# # #       ..   .  .. ....#
## ##  .. .. #.  . ..=   . . #.# # #.# # ##.##.## ## ## ## # ## ##
# #.####.### ## ####.#.#.#.#. .#  .. . .=.. #  .. ..# #..# . # # #
# ....=...... . #.  # #.#  ..#.# ## ####.##. # #.##....# #.# # . #
###.########.##. .#.  ...# #....  .  ..    .## #..# #.#    #...#.#
# #  ..      .# ##.#### ##..#.## # #.# # ## .  . #  #  #.# ..#...#
#=# ##.###.####.  .   ..# .#.#. # #. ##.# # ##.#   ## ## # #   #.#
#   .# .  . ... ### # #. #.# #=#   #  ....# #  #.#  . .  #.# # . #
#.# ## # ## # #.#.##.##.## # # ## # #######.#### ## #.## ###.### #
#.# #  #  ...   ..  .  . .   .o  ... .  .. . ...   . ...   ..  ..#
#.#. # .# ### # #.# # ## #.# #.#.# ##.## ## ###.#.# ###=##.## ## #
#   ##.# .#.##.# ## #  .#   # ##.#   #.# ## # ## ##.  # #  . .#. #
#.#. ...#.    .  .    #. #.#. ... .#.#  =.      .  .#.###.### # ##
# ..## #  #### ## ###.# ## .#.####.  .# # #.###.# # # .     #    #
# #  # ## # ...# . .#.# #. #  .. . ##.# #   .  ...# #.###.# . ## #
#...# . .  # # .# ##  #. #  # ##.# # ..  .#.## # #.=.      .#.  .#
# # #.###.#.   #. ###.#.## #.# ..#  #.#.# ..  .#  #.##.##.#.#.## #
###.# ....## # # #.##.# #    # #.#.##.#.# # # ## ## #=#.# ##  #.##
#.. ### #...  . ... . .. # #   .. . .. ..     . ... .. .. . #. ..#
#.#.     .#.# # #.#.# ##.  #.# #.#.##.#.# # # #.# #.## ##.# #.#.##
##################################################################
