##########################
#    # # # #    #.#  #o# #
## # # # # #.## #.## # # #
# .#.#    .   ## . ... ..#
## ##  ######  .# ## # ###
#    #      .## #  # #   #
# ###  ##### #  # # ## # #
# #=## #  .# .# #.# # # ##
# .  # ## ## #. #.#      #
# # ##      # ### # ######
# # # .# ### ..   # #    #
# #  # # #   # ## # # ####
# #### # #=# #  #        #
# .. .  # #..# # .##### ##
###### ## ##=#  #o     # #
#      .     # #  ## ##  #
## ########## # # #.## #.#
##  o   .      .#    .   #
# ### # ## ## ## .#.######
# # ### ####.# ## #   .  #
#.   .= .#    . # # ### ##
### ### #% ## # # ##    o#
#  #    ##  # # .   ######
## #.## .# #  # # #.    .#
#    #  #   # # \#  #.## #
##########################
