###############################################################################################################################
#  .#.#       .       # # #  .#.# #  #.# ##       = . #.#.## #.#   # ## # ##.#.# # #.# #  ##.# #  #         #  ..# # #=#     .#
###.# #.## #### # ## #..#.# ### # # #.  =  # #########  #   =  # #       .   . . # # # ##.    . # # ## ## #.# # #= # #. ## ## #
#.  # # #  .  #. # .# # # #   .  .. =# ## ##.     .   #. # # #  ##.### # # # # ##  # #  #.##### #. ## # # # ##  ## #.# # #. #.#
# # # # # ##### ## #  #   # #########  #. #. #########. #.# ## #   # ## #.# # #  # #.# #. #    .# # .  .      #.. .# #  .# # .#
### # # #       #   # #.### .     .  #  # .#     o =..# #     .# # #    # # # # ## # #. # #.###.#.######### ### #### #.## # # #
#   # # # ## ##  # #  # #   ##.#.# # # #  #  #########. #### #      ###   . #    . # # #  # ..# #     .    .            . .   #
# # #.#  #..  #.# .##.#  ## #.# # # ## ### # .        # .  ..# ### ##.# ## ## ## #.#.# ## ##### # #######.# ## # # ## ## # # ##
#.# #.# # .# #  .#. #.# #         .          ######### .# ##.# . # #     .   .# # .# # . . . .         .# #  #  # # # #. .. # #
# # # #  # #  # ##.#  # # ## ## ###### #####  .       #.###.#  # #  #.#.### #  ..# #.#.#.# # ## #.## ## # ###  #  # . # ## # .#
#  .. #.#  #.#      # # # #   # #. .    .    #### ## #.   .  # #=#.#.#.## #   ###  #.# #.# ##.###.# # ##     #  # .####  #  # #
# ### #. # # ## ## #  #.#  # ## .##.########  .   # # # ######   #  .     . #.#. # # # # #=     . .    .# #.#..## #     # ##  #
# # # # #  #  #..#.## # # # .#  #         .#.## #     #  .  .  # # ###### ##  # #. # #.# # ###### ## #### .# # #..# ###     # #
# # # #  # # #..#     #  # ## ## ########### #.# ###### ######.#.#    = .  .#.# .# # # # #.. . .# #  #    #   . # # # # ##### #
# # # # ## #..#  # #.## #   .    .      .   .#.  .   .   . ..#  .# # #### ##  # #  # # # # ##.# #  ## # #=.# #.#  #.# # #     #
# #.# #.#  # #  # .# #   ## ### # # ## # ### .# ## ## #.## ##  #.  # .  #  .# #  # # # # # #.# #  #.     .#. # .#. ##.# #####.#
### # #  # #  #  # #.##.#   # ##.# #  #.#  # # #  # # #   # .# . #.# ###.## # #=#  # # #.     . #.######## ## ##  #  .        #
#..  .# # .# #  #  #  # # #  .     # # . .#. # # #  # #.##  # .###.#          # ## #.# # # ## # # .    . . .. . # # # ### # # #
### # #  #.## ## # #### ## ## ###### #### ## # # ## ### # # ## #   .#.# # ### #..#.#.## # #.## ##.#### #####.# #  ##.# .# # # #
# ##  # #  .        .   ..        .    . .      .        ..     ## #.# # ## # # ##.#  .         . #.  .    # ## # .# ## ## .# #
# ..# # ## ########.####### #.## ## ## # # ## ## ####.# # # ## #.          .      .#### ######### # # #.###   ..# # . # . # # #
#.##  #  # #    .. . . .  #  # # # #   #  # # #  #  ## #.# # #  # #.# # ##.# # ###              # # .# #   # #### ## ##.## ## #
#   # # #..#.##############.#    # #.# # #.   .#.# #   #   #.  #  #.##.#  #.## # . ##### ## ##### #.#   # #  #  .      .    . #
#=# #=#  # # =    . . .     # ##   .   # ##.# #  #  ## ### #.#..# ##.# # #  .  #.# #.  ..#.#    . # ##.#.  #  #.#.# # #### ## #
# ##. # #. ################ #.#.### ###   # # .# # #     . # #.#  .  . # # #.#   #. ## # #  # ### #. #  # ## # #  #. # . # #  #
#   # #. #   .            #     .   .  # #  # #    ####### ##.  ######## ##.## ###.# # # # # .  ..# # .#  #  # ## ####.##   #.#
# ### # ## ###.# ### # # ## ###.# # ###   # #.# ##  . .  .   # #      ..   .   #   #.#.# # ###### #  # ## ## # .         # #  #
#       #    # #.# .# #  #  #  #.# #= .# #.# # # # ### ######  =#.###### # ### ### # #=# #        # # . .    # ##.# # ##.#  #.#
## # ## .#.# # #  #..  #  #  #.# # #.# #           .       . # ## #      ..#    .# # # #  # # ### # #########.# # ##.# ## # # #
# # #.# # #.# # ### ## ###.# # #.#.### ## ##.#################.#.#.##### ##.######   # # #  ###.#      ..  .  . = .. .   .    #
#   .       . .        .    .   .                            ..   .. . . .         ##..#..#    .# #.##.## # #######.# # # ##.##
# ##.### # ## # ## ## # ## ## #####.## ########################################### #.#.#.#  #####.# # #.### #.    . .# #. # # #
##.# . # # # # #  # #. ##.# ##.. ..  #         ..   .              =   . .   . ..# # ..#  # . .   # # # ..   ###### #   #.# #.#
#. #.## ## #.   #. .#.#.   . # ##.# #  ###.###### ##.# # # ### # ################   ####.#. ##### # #  #.## #     # .#.#  # # #
## #      .# #.#. ### # # # ## # #.# # # .  .   . # # # #  # ## # ..    ..    .  # #.    ##.  . . # #.## # .. # #.  ##. #.# # #
# .  # # # #.#  # #  .# #.#.#   .... # .######### .      #    . # ###############   # ##..#.##### # #..   # # ##.## #. # .# # #
# ## #.# #  ## ## # # # # # .# ##.##   #  .   .   ###### #.#.# #   . .  . ...  . # #  #  #    . #   # #=# # #   .  . #  #.# # #
###.## ### # .   .#..  #.##.## # ## ## .#### ## # .  .  .# # #  # ### #### ### ##   #  #  #.####  #.# ## ##  # #### #  #  # # #
#.     .    #####   # #    .     .    .#..  .#. # ## ## #  # #.#. # # #  #.   #  # ## ## #   .  #.#    .  ..#  #  # .#  #.  #.#
# # ## #.# # .  . ##   # # #### # ## #  # ##  # #.#  #   # # #  # #  .#.#. # #  ##.# ## # # ##### ########## ### # ### # ## # #
#. #.# # #  ## ##   #.#  # .  #.##.# # # #.### # # ## ### # # ### # ###.### # # #    . .    .       .   .   ..     . ..=      #
# #. # # # #  # # # # ## # ## #      #     .     .   . ...      .              . # ##### ###.# ##.#.##### ###############.#####
#  # # # # # ## #.# #  . # # ##.##### .##### # #.#.#.## ##### ######## ### ######  # .      # #  #..#   .# ..     .. .        #
#### ## ## .      # =.## #   .  .    # # .  ## ## # #  #.   .#        ... # .. . # # ##### ## ##. #  ### # # # # ## # ## # ####
#   .      ## # #   # #. ######.## # #.# # #  .     # #  #.# # ############ #####  #   .. .#  .  #  #    . #.# # . #.# #. #.  #
# # ## # #  # # # #.   #.     # # # #   ## ### #### #  # #  #      .   ..        #  ### ## ## ## # # #####   #.#.# # #=# #  ###
#  # # ##  # #.## #.# #  ## # #      # #.      #..# # #  ##.##.#### ##.## # # ###. #.     .      .... . .# #   # #.# # #  #   #
#.#      #.#      # # ###.##.# ######  .##.### # #  #  #.    #.#.     # ##.# #.  #. ## #### #### ########  # #  # ## #.# ## ###
## ### ## .#### # ###    . =  .     .# #      .   #.#.## #.##    ## # #  . . .#.## # # #.      . # .    .# # # # .   # # #  # #
#.       #    # #  .  #############.##   #.### #### # #      # #    #.# #######.#  #    ## # # # # ##### #.# #  #### #    #=  #
# ###.###.#### ## ###  .    ...     =  #   # . #    #. # # # # ##### #  #       ##. .# #.# ##.## # #.  . # # # #     # # #. ###
#..                  .### ###### ## ## #### ##.  ## # #  # #.#. .     #.#.# ###  # # # #  .     .# # ###   # # # # # #  .##   #
##### #### ######.### #.     . # #.  # .       ## # # ## ### #.#######..## ## # ##.## #.######## ## ## # # ## # #.## # ## # ###
# . #..   # ..      #  ######## # #.#  # ## ## #. ..             ..   #.  .             .    .     .  ..   . .    .           #
## ## ## #  # # # ##  # .         . ##  # # ##  ########## ### ## # # # ##.#.# # # ## ##.## ## ## ## ## ## #.# # # ### # ## # #
## # # ## #.#.# # # #. # ## ##.## #    #   .   #..   .  .# # # # # ## #   #.# #.# # # #.# # #.##.#.###.# ##.# # #.## ## # ## ##
#  #     .   # #.##=# #  #.# ## #.#=## # #.### # ## # ##. .#.# #    ..# ##  #.   .  #        ..           .  .    .  .    ..  #
## #.## ### #    = .# .#..      # # #  # # # # # #.## #  # # #  #.# # #   #  ###.## #.# # #.# ## ## ###.#################### ##
#  # # . . . # ##.# #.# .# # # ## # .# # #   # .##.#. .# # ..# # .## .#.### #  # .#.#  # #.# # # #..# .#.  . .      ..      # #
## #  # # # #  #.# .#   # # # ##.## #  #  #### # .  # #. # ##   #  .# #.#.  # ## #  #.#  # #. .#. #  #.#.# #.## ######### # # #
#  # #  # #. #    # # #   .     .    # #.#  .   ## #   #.# # # # ### #.  ## #     #.#  #.# . # #.#..#  # ## . # #   .   #.#.#.#
## ## ## #  ## ###  # #.# ## #.## # #  # ##### #.   #.#  # # #        # #.# ##.#.# .# #  # # # # .#. #     # #  # # #.# #.  #.#
# . ..    # #.## ## # #.## ##    #  .# #    .   ## #   # #   #.# #### # #    # # ## #..#.  # # ### ### #####  #.# ## ## #####.#
## ## ### # #    .. #        # #  # #. .######.# # .#.#. # ##  # #. #.#   #.#  # .# #.##.# #   . .. ..      .# .#    ..       #
#..# ## # # ####### # # #####  # #  ## #   .   # # #.  # #   # # # # .#.# #  # # # .# #  # #.## ### ## ### # .#  # # ## ## ##.#
##.#.   # #         #.#. .   # # ##  #. ###### # #  # ## #=## ..    #.#   # ## #  #.#. # #  # ### ### ##.### #. # ## .# # # #.#
#  # # ##.# ### ####  #.# # ## #  #.## # .     # # #  #  #.  # #####  # # # #  # # .# ## #.#    .     . .    ## #.   #.     # #
##.#..      # ###\ ##  # # ## ##.## #.  ####.#. .#  #  #.# # #.   . # # # #. # #  # # #  # .## ## ##### # ## .#. ###.####### .#
## .#.## ## #.    #. .#.          . ## #   # #.# # ## #  #.# # ## # #.# =##.# # ### #  #.#.#  # # #.     # # #  ##.#   .   .# #
#. #  #  .#  #### ### .##.## # # ##  # # ### . ##  #  ## # #.# .# # # #.#.  .  .   .# #..#.# #. #.# # # #  #. # #.   # # ## # #
## .#  # #  #         ##.# ## ## .# #..#     #  .# .#  # # ##  # ## # # # #### ##.# # ## # # ## ## #.# #.# # # # #### # # # # #
#  #  ## .# ###.# # #    ..      #   # ######..## .## #  #   # #    # # #    .# # # #.                    ..     .  . .       #
##.#### ##.   # ## #..#.##.# #.# ##.# .      # # # #  ##.# # # ######.#.# ## #  ##  # ### ## ####### ## ## #.####### # # #.# ##
#    .    # ##    . # # # # # .#  #.## #####   # . .#  # #.##        .# #.# # #.  # # # ...#  .    #  # . # #   . ..#   .# #  #
## #### ##  # #.# ##  #  .   # # ## .       .#.# # #  #  #.  # #.# # #  ### #.# ###.## #### #.#### #.# #### #######.### #.#.###
## # .# #.# # # ##.##.# ##.# #   #..## ##.# #. # #  #  # #.##  # # .# #  o           ..      ..   ..      .= ..    ..         #
#..# # ##.#   #       # #  # # #  # #.  # #. #.# # #..#..# #.# #  .#.   # # # ## ## ## #.## #.# ## ### # #.## ## # # ## #.#.# #
##. .  .. . ##. # ###  #.## ## ## ## # #. #.#  # #  #. # # # # # #.  ##.# #  # #..# #  # #  # ##..#. .# ## .### ##.# #.# # #.##
## ########.# ### # # #  .   .          # # .# # # ## ## # # #.# #.#. # #.#.#  # #  .# #.# #   # ## ### #  #    .  # #.       #
#             .      . # ## ## # ##.## ## # #  #.# #  #  #.#  o..# .# #. ##  # # # ### # #  # #     .    # ..## ##.#  ## # # ##
####### ##.# #.###### # ## # ## ## # # #.#.# # #.# .# ## #  ## # # # .  #   #. #.#.   .# . ## ## ###.##### #  # #  # # #   #  #
#   =  #  # # .# .. #     .  ..   .  .      .#.## .# . # # #   # # .# # # #. #.#. #### #.#    .. ..  ... . #.##  # #.# ## #. ##
## ###.# #   # # # ## #.##.# #.# # # # ## ###  ..# ##.#  #  ## # # # ## # # ## # #     # .# # ### ## # ### #    ## #      .#. #
## #.#.#  #=#  # # #.  ## # # #.# ## # # #.  # #.# . . #.#.#. .#.#.#    # #    #  ## #.# # # ## ## ## ## ## ##### # ##### ##.##
#    # # ## ## # # .#.#.   ..    .#..# # ###.# #.#.##.#  # #.# # #  # # # # ###  # ##  #.           . .         ....  . . .   #
##.##  #     # # # #   ########## ## # #     # #.#.#  .# #.##.  ## # ##.# # # .# # . #.# ###### ############# #=### # #########
##   # # ## #  # ## # #.     .  .    # #.### #.  #  # #  #   # #.  #    # #  # # # ### # #   .#      .      # #  .  # #.      #
#  # #.  .   # #      #.## # #.#.# # # #.#.# # ### ##  # # # # #.#  ### # # #  # #.  . #  # ### ###### ## ##  .####.# # # # # #
##.# # # ### # #.# ##. ## #.#.# #.## # # #   #.   .   ## # ##  # # ## # # #  # # ## ##   # ..        ..#    # #     # # # ## ##
##.#.# # # ## .# #  # #   . .    ..  #.# # # #.##.# #=#  #   #.# #..  # # #.# .#  #  # ## # ########### ## # # ##### ## ## # ##
# .# #.# #.  #.# # #..# #.####.#.# # # # ## ## # # # #.# ###.# ## ####  # #  # # #  #  .  .   .   .   ..        . ..   .      #
## #.#.# # # #.# #  # #.# .  #.#  .# # #.      . .             ..     # #.#.#. #  ##.# ## # # ### #####################.# ### #
# # ## ### ### ## ##. # #.## # # #.# # .## # # #### # # ##.#### #.#.##..# # .#.# #     # # #    #  .   . .       .     #.#. # #
#...    =.. ..     .# # #.#  # # # # #.### #.#.# .  # # # #      # #. #.# #.#  #  ## # #    ### # ## ## ## # ## #.#.# #   # # #
# # #.######## ## ##  #.#.## #.  # # #. # # ## #### # # # .# ##.#   # # #.#..# # # ###.### ## #.#.# #.### # # ## # # # # ## ###
###.# .       .# # ## # #  # # #.# #.# #        . # # # # #.# # ##.#  # ###.#  # #   .   #.#    #    ..   .   ..           . .#
# . # ### # ## #.#  # # #.#  #.##  # # ####.## ###  #   #  .  #  ...# #      # # # ### # # #.## # ## ### # ### # ## # ## ## # #
### #   #.##.#   # ## # # .# #   # # #  . #  .   .# # # # ### # ## #  # ### # .# ##..# #.# .# # # .### ## #   # ## #.#  # # # #
#.# # # #  # # ###.#  #.# #.#. ##  #.#.# #  ## # #  # #.# # ##.  ## # # # # ## #. #.#  #.# #   .# #    .  #.#         # # # # #
# # # # # #  #      # # #   .# .## # # # .#  #  # # #.# #    .# #.    # # # .# #.# .## ###.#### # # ###.# #  # # #.## #   #=# #
# # # # . ## #.#.#.#  #.#.## # #.  # #. ### #  #   . #.## ####.# ####.#.  # ## #  # .#         .#.### ### # # # ##.# ## ### ###
#   # # #   .# ##  ##.# # # #  ####. # #....## ## # #    ..           # ## .. .# # .## ###### ###. = .              .    .    #
# # #  ...# #  . #  # # # #  #    .#.# # ##  #  #.#..#####.##### #### #.  # #.## .# #  #    # .  .# ## #### ####### ### ##.## #
# # # # ## # # # # #  # # # # .## #. #. # # #  #  # #    ..     #     # ### # #  #   #  ##.#.# ## # # # .  #. .  .# # #.#.# # #
# # #        #.# #  # # # #  #     # # #     #  # #  # ### #### #####.# #    . # ## #..#     ...  ##  .# # ## # # #.# # # # # #
# # # # # # #..##  #  #.# #.#  ## # .# .### ## ## # #    .          . #  ## #.#      # .## ### ##   # #  #  ###.### #   # #.# #
# ## # # # #.# ..#  # #.# #  #  # ##.#.## # #  # .# .#.# ## # #.# ### # # #  # # ####. #  .#    #.### ##.# #  =.   .# #   # # #
#. .     .   ..##  #  # # # ## #   # # #.    #  # # # .#  # # # #  .# #  .#.#       .#  ## #####  #   .# #.########.# # #     #
##.## #.#.## # # #. #.# # # # . # #  #  ### #  #  #   # ## # # # #### #.#.# # ## # # # #  ..    # ### #   ..     .# # # .# ## #
# # #. #.# # # .   ##.# #    # #   # #.## ## #  # # # .     ..  ..   .# # # #.# .# ##   ## #####  . # #.## ## ##.#  # # ##.#  #
# ..## # # # #.# # #  # #.# #  .#.# .#.# .    .# #. ############ #### # # # ## # #   # #   #    # ### # #= #. #  ## # #.#  ## #
###  # #.  # #  ##.## # # #. # #  .# #..######    # .    ..  = . =    #.#.#  ..# # # #. ## # ## # #   #  #  # ##  # #.#.###.  #
# # #  # #.# #.#      # # # #   # #  #.#  .   .##   # ### # ## # ## #.#.#.. ####.# #.  # # # #  #. ##.# ## #.    # .#   .   #.#
# # ## #=### # . #### # # # .# # # #.# # ## ## # ##   #    #  #.. ## ##   #          # # #.#  #.# # # # #. ###### #  ##=## #. #
# .   ..   ..# #.%    # #.# #  .   #.. ##.#. #    # # # ## # #  #..# #  ##  #### #.# # #.# #.##.#  .# # ##     .  # #.. #   #.#
### #### # # #  # # # # # #  #.###.# #  # # #  ####.# #.   # ## # ## ## # #    #  ## #. .# #.#  # ###.## # ## ## #. # # # # # #
# #   .# # # # #.#.# .  ###.## # ## .  #.  . # #    # .# #     .  ..  #.# #.#.#  #.  #.## ##.#### # ..    .#   #=.#.# # #.# # #
# # ##  .  #.# # # ## #   .    #   # #..# # #. # ## # # ## ##### ###### # # #.## ###  .#    .  .   ####### ## # ###.# # # #.# #
# #    # #.# # #    . .###.###.#.##  # ## #  # .# # # #     .  .   ... .#.#. .   .   #.# ### #### #           .  .. #.# # # # #
# ##### # #.##  ##### #    # #.#   #.# #.  .## # . .# ###########.### # # #.# ## ## #  ##.  #  .  # # ##.# # #.# ## #.# #.#.# #
#.    .  .     #  ..   #####.# # ## .#  ###.#    ## #o .  . .   # # # # # #  # #.#  .#  # ### #.#  ## # # #.# # #.# # # #.# #.#
# # ## ## #.## ######.#  .     #...#.# # ..  # # =#.#.#.# # ####    ....# # #. #.####..#.. . .  ..# .            .# # #.# #.#.#
## # ## # # .# =.   # ##.##.## # ##  #   ## #  # #  #  # ## #  .# # # # # # ## #   . # # # ######.# #.# #.# ## # #. #.# # # #.#
#   .     # #  ######     #. # #...# #.### # #    # # #     # ## .## .# #      #.##### # #..    # #.#  # # ## ## ## #       # #
####### # # ## #      # ## ## ## ##.#  . .   #.## #.# ## #### #.# . # # # # #### ..  ..## #####   # # # .        .# # #.## #  #
#   .  .# #.    # # #   .     . .. . # ## # #  #. . #  . .     .  # # # # #     .# # #..  . .  .#   #.  # ## # #.#.   #  #  #.#
###############################################################################################################################
