##################################################
# # . .      .     .  .       # # .# .##.#.# #.#.#
#.# #.## ### ## # ## #.# ## #  ..# # #  . .  ..  #
#   ##   # # #o #.# #.#.# ### ##.#.# #.## ##.#.#.#
# #.  .# #    # #   .   .      #.# # #.. # . ## ##
### #.#    #.## #.#### # ##.#.#..#.# #.#  .# .  .#
#  . . # # #.. .      .#.#.# .## #.# # ###.#.### #
###.# #. #.# #.## ##.# # #  #   .# #.#.    #... .#
# #  .#### #.# ##.# #.# ## ## # ## # # ###   ##.##
#.# # \  .. .      . .....         #       #. #. #
# ..# ######.# # ### ## ## ## ## # . # # # # ## ##
# #.#.#.    # .. . . . .# #   .  # # # #  #   .. #
#. =## #### ##### ### ###.## #####.#.## #.##.#####
# #    . .     .    o. . .  .   ...   . .   =  ..#
### ######.# # ## ##### ## # ##.#.# ##.### ##.#.##
# .. .. .#.## #  #.    # #  . # # #.#.#.. .    . #
# # ## ##   #..# # # # # #=## # # #.# #.###.#.##.#
# .     .# #. # .#. ##.. ## # . #.  #     .   .  #
# # ## #... # .#   #   #.  .. #.##### # # # ####.#
#   #  ..# ## ##.# # #.# # ###    .    .   ....  #
# #  # ### #   ..  # # # ### ## ##.##.## ##.# ##.#
#...# .# . .# # ##  ##.#    .   # # # #  #  ##.# #
# # .# # # #  # .# #     ##.#.# #. .#  # # #. .# #
# #.#    #..#.###  # # #.#  # # .##.# #  # # # #.#
# #= # ##  ## ...# . #  ..# # # # # #. # # #  .#.#
# # ## # # #=.##.  #.### ## # # #     #o##.# # #.#
#.#     .%. # ##.#.     .#  # #. # ##.#    ### # #
# . # # ## #=   .# #.# #..#   # #   #  # # .. . .#
# #.# ## ## #=####.## ##.# ## . # # ..#..#.###.###
###. . .. ..           ..    .#  .= #..# #.#.#   #
#.. ## ### #.# # # #.#.#.#.# #  # #.# #  # # #####
####    .# # # ## # ##.#  # ..#.#.#.o .#.#  . . .#
# ...### .      . ...    #. # # #.#.#.##   #.### #
# ## #. .# # # #.#.#.###. # . # # # #.#..# #...# #
#  # ### # ##.#.#    #. .##.#.#  .# # #### #.### #
## #. .    . .  ..##. .# # .   .#.. ..   ..      #
#   ###### ##.### # .#  .  # ## #.###.## ###.###.#
### .  .           # # # #   # .  . # ## #   #   #
#.  #.# ## #### # # # # #.## ##.## # .     # # #.#
###    .     ..       = .       #.# # ## #. .#.# #
# # ## ## ## #.################   # # # .  #.# # #
# # #. #. .  #  ..  . .    . .. # #.#  #.### # # #
#.#  #  # ## # #.## ## #.###### #. .# # .   .  . #
#...## #.# # ..# # .#  #. ....#   #.# .# ### ### #
# #.#  .   . # #  # #.## ####   # # # #.     . . #
# #. # # ##.# .# #   .     .. # #.#.#. # #.#.# # #
# # ##.# # # # # # ## ### #.### .     ##.. ..#   #
# # #   .           .   .  ..   ### #.#  # #.# # #
# #  #.# ## ## #.# # ## # # # # # ..  .# #.# #  .#
##################################################
