################################
# . .# # #  # # # #.# # # #.# ##
### ## # ##.#.#.\   ..  ....   #
#              .## #.#### # # ##
##### # ####### # #  #   #   # #
# .          ...#  #o# # # # #.#
#.## ## #######.# # # #  # # # #
#.#=    .    .. #  ..  # #   . #
#.# # ## #.# ##.# ## ###.# ###.#
# # # #  #     .# #.   . #o#%  #
# # # ## # ##.# # ###### #.### #
#.# #  # # #oo  #.     .     # #
# #.####.## ### # ## ## ## #.# #
# #       .   # # #..#. # =##. #
# # ###### ## #.#. # ##  # . #.#
#.  ...      ## # # #.#.## ## ##
# #### ## # #       .       =  #
# #  =# ## #.##### # #### #.####
#  ##  .        =.# #..  # #   #
# #   ## # #.##.#.#  #.# # .## #
# ### # # # ## # # .#    . #.  #
#...#...    .  .. #  # # #   # #
# ##. ##### ### #.#.# .# # ##  #
# ###     #.  #.###.##   #  .# #
#  ## #.##  #     .  # ### ### #
# #   .## ## ## ### #        . #
#.# #.#         .   # #.##.### #
# # # . ##.## # # #. #.# #..   #
# ### #.# # ##.#.## ## # # # # #
# .  .          .       .      #
#.# # ## ##.# #.# #=# ##.##.## #
################################
