#######################
#.  #  . # #  ## # # ##
## ## ##.# =#  o   #  #
#      ##  # .# ##  #.#
####.#.  # #.### # #  #
#    #.###= # ## #.## #
#### #.    # o      # #
# .  ## ##   ## #=# # #
### #. . #####   #  #.#
#. ## # #   ..# # # # #
## #. # # # # #.# #   #
#..# #   ## #.# #= ## #
##  ### #  #  # # # # #
# # ##.## # # #. .. # #
#..        .# # ### # #
# ## ## # # #  .. #.# #
#  ## ##\#   ## #  # %#
# # o.    # #.#  ## # #
# #### ##  #  . #     #
#      # ###.##  # # ##
# #####   o  #  #= ## #
#    .  ##.#  # .#.   #
#######################
