############################################
#. #.    ...    . .....  #=# ## #.#.# #.## #
##.#.#.#.# ##.#\###.## #... .  o..   ..... #
# .. #.# # .# #.#.. ##.  ###.# ##.# # #.#.##
##.#   .   #.... .#  ..#.# .  # ... ... #..#
# ## #.## ##.#.##.# #### #### . # #.# #.##.#
#. . . ..o..    . . .. ..  .#.#.#.# # .  .=#
## #.##.#.#.#.####.## # #.# #=#.# #.. # #.##
#...  .# ##.#... ......   .. ...# ..# # .. #
# ##.#..   .  #.###.# ### # #.#.### # #.#.##
#.o . ## ## #  . .  .... .   . . ... .# # .#
#.##.#..  #...#.#.#.# ## ##.# # #.# #.  ..##
# . . #.# #.#   # .   #...# #.#.  ...%#.#.##
## #.#.# ...# #.# # #..#.#.. ..# ##.# #. . #
#..#..  #.# .. ....   #   # #.#..#. #.#.#.##
##.. #.## #.# # #.#.#..#.#  # .#..#.#.##.#.#
#. #.# . . .  ...# .=.#. ## ..#. #  #. ... #
## #.####.# #.##.## #. # .#.# .# ## # #.##.#
#  # .. ..   ..  ... .#.#=# #.#.  #.# o    #
####.####.#.# #.#.#.#.#  .. ...# #..#.# ####
#... ... =  ..#. . .  .#.#.## #  .#.   ... #
############################################
