#####################################################################################################################
#.#..    .   .. .     .   .  .   .       ..   # # ..    .# #.  #.  # #  # #  ...#.#  ...# . # ..   #.#... #.# #. #  #
# # ##.#### # # #.# ## ## ### # ### ###.### # # ######.### #.#.# # # ## # #.# # #. ##.# #.##. ## # #.# ####.# ## # ##
#   . .  .# #.## #   #..#.#  .# #  ##. ## ##.#  . .   .  . ...   # # .# #.# .# ##.##. # # #.#  ##.##.# #   .# .  # .#
#.# #.##.#. #. ... # ##   .## #  # ...#   . . #.##.## #.##.# #### .#.# .# #.# . ... # #  ..   #. .   #  # #  # #.#.##
# .# ## #.# #.#.# #  . .#.# ## ## .###. ##.# # . #.#.#  #.##. .. #.# ##.# #.##.## ###.#######. # ###.#.#.##.##.# ..##
# #    .  #.# ##.#.# # ##.  ... .#.   # ..#.#.# #..#. #.     # # #. ..#.#.#.    # .  . .  ..#.## # # # # ...#..#.#..#
#  # #####..#.     #.# #  ### # #..# # .#.# #  .=# # # .##.#.# # # # #..#.#.###.# ###### ##.#.# .# . #  ### ####.# ##
# #  ..   # ########.##.#.#.# ##.#.#  #.#.. ###.#  #..#.#. ..#.# # #  # #.#.#.# #.. .  # # # ..#. ##.# #..  .=..   .#
# ## ##### .  . ..  . . # #.#.  .# ## . # # . #..#.# ## ####.#.## .# #. # # # ## .#### #   .# #..#  .# #.#### ### #.#
# .     ..# ### #### ## # # #.### . . # #.# ### #. # = .  .. #.  # # ## #.# #. .# . ...#.##.#. # #.#.#.# # . . . .# #
#.# ### ##..# #.#.  .#..# . #..  #.### .# # #.. ###.#######.#.### .#. #.# #.# ## .#### # # .#.#..#.# # #  ### #.#.#.#
#.#..   # # # . #.## ###  #. .## # #. #. .# # # .  .... . ....   # #.#..  #.#.# #.#. ## . #.#..#.## .#.# #. .#.#  #.#
#.# # #.# #..## # #.   .#. # #.### #.## ### #.# ## # ## ## ##.##.#.#. # # #.   .  .#  .# #. # #. ..#.#.#  ##.# .#.#.#
# ## ## #.# ###.#  #.##.. # o ...             # # .# #. # #. .#.# .# #..# #=##### ##.##.# ### ###### # # #.#.# #. . #
#... .. ..# ##.# ## ## ###.#######.# ##.#######.##.## ###.##### ##.# ## #   .  .   .  ..  ...  .....=  # # .. ..# #.#
# ##.#.##   .   . .  . ..    ..   .  ..  .   .  .     .    .. .= . #..# #.########.#### # #.#.# ## ###.#..#### ## # #
# #.# #.# #.## # ##.# ## ## # ##.# #.# # #.#.# #.# ########## # # #  #  # #  .   .   ..# # ##.# .# # #.# #...     ###
#...  ..    ..# ##.# #.### # # ## #.# # #.# #=##.#.#... ...    #.# #. #.#..###.###.## #. #.#  #.#..#  .#  #.# ### . #
##.########.#    ...  .  .        ....... ...  ..# .## ##.# ##.#.  # #. # # ...# # #.  #.# #### ### ###  # ## #.# ###
#.#   ..  # # ################## ###############  .#   #.  # #.# # # ## # ## #.# #..#.#.... ...  .    .# #. ..# #. .#
# ###.### # #  . ..  .. ..  ..... ..  . .... ... ## ##.#####.###.##. .# #..#.#.#.. ##.## ### # ######.#  #### #   # #
#.. # #.# #.########.####### ##### ##### #######    ..       .... .# #. #.#. # .##.   .# #  # #   ... ## . .# # # . #
# ### # #.#.  . ..  . . .. . #  . ..   ..      #.# ## ###### ## # #.  # # .# # # ..## # .# #.  #.## #. #.#### # # ###
# #...# # #.## ######.#### # # ## ############## #.#    .   .#. ## # # .#.#  #.###.# #.#.# ##.#.## #.### #...  ..   #
# #.# # # # #. #    .. ...# #  #. # . ..  ..  .. #. ########. #    # .#.#..# # . # #..     ..        .  .##### ## ###
# # # #.  # .#.##.########  .#. ### ## # ##.####.#.#   ..   .##.###..#  # # .# # #  ### ## # # # # #.# #..  .# .# ..#
#.....### # # .   ..      #.# .#  ..#..# #..   #.#. ## ##### #.... #..# #  # #.#.# #      #.#...# # #.# .####.###.###
#.# # ..# # ## # ###.###.#  ##  #.#  ##.## ### #.# #.  .  .#  # #.#. #. #=# .#.# #  ###.### ## # ..    #.#.. .   .# #
#.#.#.#...#..# #  .# # #  #  # # .# #    .. ... .## ##### #. ## .# # ##.#.##.#.##. #   . .  .   ##### ##..#######   #
#.# #.#.# # # ...##..#.#.#. #.. # #  #.# ## #.##   .....##.#.#..#..#  # #  # #.  # # # # ##.##.#.......  #        # #
#.# #.###.#.##.#   #.  #  #  # #. #.# ##  #.#..#.# #####.# ## ## # # ## # # #.### #.# #.## #.##.# ## ###.#########.##
# # #  ...# .#. .## .# . #  #  =# # #.# .# .# #.    .   . .   . .. #.     .   .  .   ... . . .. . ...    . .  ...   #
#.#.# # # . #.#.#.### #.# # ## # ## #.### ##.#.###################. .####.# #.#.#.##.#### #.#.# #.## # ## ### #.#.# #
#   #.# #.#  .      .. ...... .. ...   .   ... ..  ....  .  .      # #   #  #.#  # #.  .# ## #.# ##.# ## # ..# # ..##
# ##.# ## # ## #.###.## ### ################################# ##### .. #.#.#.#.#.#.#.###   . . .. ....  . =#.#.# #..#
# ..     .#  #.#  . ...# .#.#   . . ..   .. . . ...  ..   .   #.  .#.# # # ..  .. .# .  # #.#.# ##.# # # ##. #.#o#.##
#.### ### #.#.##.#######.#.#.############## ###################.####. ## ####### ## ####.# # # ## # # #.##.#.# #.#  #
#   .   #.#.     .  ..  ..   .    ... .  .. .    .   .    .    .     #     . .    . ..   .      . ..   .   .   # # ##
#########.#####.################## ############################ ####  #.### #.#.# # # ##.#.#.# #.# ## # #.#### # # .#
#. .  ...   .  ..   . ..  .    .  .  ....  .  ..    ...  .      .  ..# .#.# ##.##.# ##.##.# # # #.## #.##.# .#.#.#.##
# #### ############## # ### #.## ## #####.# #.#.# ##.# ##.# ## ###.#. #.  #  #.# .# .... .#.#. ...  ..  ..##.# # # .#
#..   #..  .. . .   .#  #  #.  .# .#  ..# #.#  #.#.. #   #.#. .  # #.#.###.### ## # # ##.#. .##.##.## #.# .# #.#.#.##
####### ########## ##.##.#.#### #.## ###.#.# # #.####.#### ####.##.#.#  .   . .  .# ## ##.#.# ##.## ##.#.### #.# #  #
#.. .... . .. ..  .. . .  . ... .. .  .. . .. .  . ..    .. ....   #.######### ### ... .. . .    ... .       # # # ##
##### ####### #.##.### # ### ##.#### # ##### ## ####.# ##.## ## ##.#.   ..   .. ..# ##.##.## ##.# ####### ## # # #..#
#....   .   .# # # # # #   #.#.# ...# # ...# #. # ....    #.. #..#.#.#########.###.. # # #.#.# #..   .. .# .# .. # ##
#.# # ## #.#.#  . .#  ##.#.# # # ### .##.# #..#.#.# ## ##. # # .# .# # ..  . #.   #.#  .   # # # #### ##  #..# #   .#
##.# ## #.##.# ### #.#. .#.. # # #..# .# # # #  ## #.## # #. ##  #.# #.##.###  ##.#..# ### # #.## . #..#.## ##.# # ##
# .. .... .  ....#.#  ##..##.# # # ## # ## #  #    ... .#  #  #.## # #.#.## ##.#.## #  # #.# #. . #.#.# .. .  .# #  #
# # ## #####.####  # #...#   ..# #    # ..   #. ####### ###  ## # .# #.  .  . .   .  ###.# # #.## #.#..# ##### #.#.##
# # #  .. .#. ...# #  ## ##### # # ##.######..#.#..... .   #.# ..# #. ## ###.# ## ##.#   . ..# .# # #.#  .   # # ## #
## # #### ##.## #  # #.        . ... ..    # #   #.# # ## # .##.#  ..#.# .o.# #..#.#..# #.##.#.#   .#..#.#### .# ...#
#    .  . . . #  # # # # # ## # ##.##.##.##...#.## ## # #.##. #..# #  .#.#.#   # # # #.# # #.# ## # # #  . ..# # # ##
### ######## # ### # # # # #  #.#.## # ### #.##.#.. # #.# ...# .#  #.# #  #.#.#    .     .  .# ...#.# .# # #.# # ## #
#.  . .     . ..  # .#.# #..#.# ..   ..  ..  #   # #  #.# ##.##  #.#..   ##.#  ##### # ##.##.# ####.#### ## ##.#  ..#
##########.### ##.## # # # # .# # ##########  #.#.  # # #  #  # #  # ### #....# .  . ###   #.#.. .    .  ..  . # ####
#. ..   .# .  # # .#.  # #.## #.# .... .   #.##  #.#  ..  #..## ##.#.... ## #. #.###. ..###.  ## #.# ## #.#.##.#    #
# ## ###%#.###. ..#. #. .   #  .# ##.## ##.# #  #. .# #.#..#.#.. # # # #  # # #  #.  ##..  # ## # #.## #.## # .# #.##
#..#.# ##  #  # #. # #.# ###.# #.## # ### #.## # #.# # # ##.# #### #.#.  #.. .#.# ##. # ## # #   .. . .  . ..#.# ## #
# ##. .. #  #.#.#.# ... ..  . . . ...   . ... ...  .    ..... . .. #.#.# ..##  ....#.#. #.#.# ############### .#.   #
#.# .##### #. # #. ### ## ## ### # ##### #.# ### #.### # ##.#.#.## # .   # .# ### #  .#.  .. . ..            #.# #.##
# ##.# .    # # # #    #.#.    # #.#.. .# #.##  # #  # # #.##..#.#.# # # # ##.#    # ## ###.# ################ #. # #
#  #  #### # .# #. # #.#  .#.## =#. ### ... ..# #.# # .# .    #. . # # # # #  # ##.#.#. ..#.#.. . .  .... .  . # #  #
#.# .#. .  .#.# # #.#.# ##.### ##.### # ####### # #.## ## ###..#.# #.# # # .#.#.##.#. # # #..# #.## ### ## #.#.#.## #
#. # # ### #  ..# .  . . .  ... .. .  . . .  ..... . . . #..  # ## # # #.#.#. #. ....#..#.#.# #\# ## .#.#..##  . . .#
#.# .#.# #. #.#   ################### ####.# ##.## #.# # .###.# .. #  ##..# #.##.#.# .#  ## #.#.#  #.#  .#. .# # #.##
# .# # . # ##.#.#.#..  .  .....   ...#... # #.#.# # #.#  # .# # ## # #...#... .## ## # .#   # #.# #  ## #. ## .###. #
# #  # # # ...# # # # ###### ##.#### # # #. ..   ....  #.##.# # #  #.#.#  ###.# .     # .## ..    .# .. .#  .#. .  ##
#.##.# # . #.## # # #   . .#.# # . # #.# #.#.## ##.## # .  .#.#.## # . # # . ..# ###.# .#.# # ###### ##.##.#.#.#### #
#  # .# ## # #  #.# #.#.# #.  ...###.### ## ##.# ##.## # #.#  # .#.#.#   #.## ##.# # ##.# # #  .    . . #. ##  .   .#
# # .#  . .#. #.# # # ## # ##### #.  .  .   ... .       .#..# #.#  # # ##.# #.# .# #  ..# #  ##.# ##.##  #   # ######
# ###.##### ### #.#. .    .  ..#. ##.# # ##.## # #.##.## #.## #  # # # . ..   .#.# #.## # #.##.## # # ..## ##       #
# ..  ....     .. ##.########### # #.###.# #.## # ## ##.#.##.# ## ##.### #### ##.#.# #  # #.#  . .#. ##.# .. #.## ###
####.##.###.#.#.# .    ...      .  . .... .. .  .  .......    . ..... .# #. # #  #.# .#...#..#### # # #.## #.#  #  .#
#  ...# # # ..#..# #.#.# # # # # #.##.# ###.## ## ##.# ### ## #.##.# ###.#.#.  # #.# ##.###.#..   #.. #  ## ##.# .#.#
###### ## ##.# ## #.#.# #.# #.# #.## #.## ##.### ##.# ## # #.#.##.## #   #. #.##.#.# #. #    ##.# # ##. # ..   .#.###
#.  . ..   ..  . .  .  .... .....  ... . . . ... .  .   .. .. .. ...  ## # #..#  #.#  #  ## # #.# .  ##.# # ##.#....#
# ## ## #.# #.# # #.###.##.## ###.##.#.##.#.### #.# #### ## # # # ##.#.. ...#  # # #.# .#.#.# # #.# # . # #.# ..#.###
#. ## ## # # # # # #   #.# #.##..#.# # #.# #   # # #    .# # # #.#.# ###.###  #. # # ## #.#.# # # #. ##  #.#.# # .# #
# # .. ... .   . ..# # #.# #. .# .   #...# #.#.#.# # #.###.  # #..... .# #..#  #.# #  # # # # # #.. # # #.  .  .#.  #
# .###.##.### # ##.# ### ### ###.## #.###. #.#.  #  .# ... #.. # ###.# # # #. #  ..#.##.# #.#  .# # #   .# # # # .# #
#.# .# #  #.#.#.# .. .. . ...  ..   .  . # #.#.##..#.#.#####.##  . # .##.#.##..# ##  #    #  ##.# # # #.# # .#.##.# #
#.# #...# #.# # .# ## ##.## ##.#.######.#  # #.# # ### #.     .# #.#.#.  # .  ##.#.#. # #.#.# ..# #=# # # ..#. .#.# #
# #.##.## #.# # #  # #.# #  #...#...    .#.# #.#. . .. #.### #.. #.#.# #..### #. #.# #  #.#.#### ## ##.#.## ## #. #.#
# #    #. # #.# ##.# . # #### #..######.#  #.#..######.#   #  ##.. # #.# #. .. # # #  # # #        .    .  . #. #...#
# # ## .# #.# #  # ..#  ..    ..#     .  #.# # #.. ... .####.#. .#.  # # #### # .#.# ## # # ########## #.## #..## #.#
# # #. ## #.#.#.#  #.########## # #####.#   .   #.## # #  . . .# # # # #.   #. # # #.#  # # # .   ...#. .. #.#.#. # #
#   .# .    ..#  # #. .. .    .      .. ## #.# ## #  # ##### #.#.# #.# # ## # # .. #. #. .# # # # ## # # # # #.## . #
# ###..#.# ##.# #.   ###.#.# # #### ###  #.#.# .  .#.# .  .#..## ###. ## # #.  # ### #  # #.#.# # .# # ## #..#  #.# #
#   .#.##  #  #..#.#    . # # #.  ..# ..## # # #### ##.#####.# .     #   # ##.#..#  ..#.# #.# ##.##.## . . # #.## #.#
#.## #   # .#.#.#  #.#.#.#..# # #.#.###.  .#.#...  .    .     # #.## #.# #. . ## ### #. # #.#   .      ##.#. # #    #
# # # ### ##.## .#.#.#.#  # # # #.# . # ##.# ############### #.#  #   ##  ###..# . # ##.# #  ########### # # #.#.## #
# #  . ..    .. ## ##.# ### #.## #.# #   #.#..   ...     .. .#.##.## # ..#  . #. ##. .#.#.  #  ..   .    ..  . # # ##
#..##.#.##.# ##.#. .   .   . .. .   ..# # . ## ##.## ## # ## #  #  #. ## ##.#..#.. # ##  ##. ##.##.#.# # #.# # .....#
#.#.##.# ## ## # # ###################.#.# #.# # #.##.## #.# #.#.# #.# #. ### # .##. #..# #.## ## # #.#.# ##.#.# # ##
#      .    ..  ..  . ..  . . . .    . .   . . . .  ..   ...       #.#  .# ..  # #.#..# #   .  .  . ...    ... ##.#.#
# # # ## #.# ##.###.#### ## ##.## ####### #.# ##.## ##.# # #.#### #. # # .# # #. #.. # . ######.########.##.##. .   #
#..#.# ## # #..   # #.  #.# #  # .    .  # # # # #  # # #.#  # .# .# # #.# ##. # # #..# # .   ..    .  .  #. #.# #.##
#.# ..  . .  # ##.# #.##  # #### ######.##.#.# ##.### # # #### # ##  #.#.# .  #    . #   #.# ########### ## # .#. # #
#..##.# ### # . #.# o.  # # . .  ..... ..= ... . .... . . ..  .    # ##    ##  #.###. #.# # .   . .  . #.#   #.#.# .#
# # . #.# . ## # .#.# ##..#.###### ####.###.## # ## ########## ##.#. . # #. # #   .  ##    # ##.##.#.# # .#.# .# ##.#
# #.# #   #. #  # #.# #.#.# #      #  ###.###.## # . .    .  ..#  .# ##.## ##.###### #.#### # #.# # # #.## # # # .. #
#  # ##.# #.##.# ## #.#.# #.# # ##.  # . .        ####### #### .#.#  .. ..   .. .. .  ..      ......      ..    ### #
#.# .. .    .      .#.#.# #..#.#.# #  #.## # # # #.  . . .#. # #   # ### ##.## # ##.#.# # ####### #############   # #
#. .##.#.### ######    .#.#.##.#.# # # ##.# # # #.# ####### # #.#.#  # #.# .. # ##  #..  #   . .#.#      .  .  #.#  #
# ## #.#.# #   .. # #####.#.#. # #   ..       ....  =... .     . = #.#.## #### . .# ####.### ## #.# ##.# ## ## #. #.#
#.#    # #.  ##.#.# . ..  #  #.  #=### # ############# ##.##.########. ...   .#.## . .. . . . . # ###.#.# ##.# #### #
#. # # #.# #.#.# #  #.###.# ##.### #. #.# . .    . . ## .# #.# .  .#.#.##.## ##.# # ##.## ##### #. ...  . .    ...  #
#.# ##.# #.#     .#  ## # #.#.  .   #.# #.## # ### #. #.##.#  ## #.#.#.#.. # #. # #.  # # ..  # # #.# # ## ##.#######
#   ...# # # # #.#. #   # #.# ## # #  . # ..# # ...#.# ... # #...    #..#.#  .# # # # #.# ####. #.#  #.# ##.#  .  . #
# ###.#.#.# # # #.#  ##. .# # # .#  # # #####.##.###  #.####.#######.# #.# ## ..# # # ..#  ...# # # #..    .  ##.# ##
# #  ....... .  .  .# #.##. #.###. #..#.   .     .. .# ...    .....  .     .  #. .#.# ##. ##.## # # ######.##.#.  ..#
# .# # # ### #### # .     # #. . #  #.##############.######.##.################ ##.##.#.##.### ##.# . . . . #..# #.##
# #.##.#.# # # . .#.#.#.# # # ###. #..  . .    . ..  .. ..   ... . . .  ..   .. .       ... .  .  #.#######. .#..#  #
# #.   #.#. . #.# # #.#.#.#.#.   # # # ## # #.#.## # #.#.# # #.## #.# #.## ## ## #.#.## ##.# #.# #. . ..  . #. #.# ##
#####################################################################################################################
