##########################################################################################################################################
# . . #   # ##   . .#.  # #..#. #  .. . . #.. . # #  .# #   #.# #.#.. #..# # . ...# .# ##. #  .  .# ..#. . ..#   ...#  .## # #.   .#.#.  #
## # # ## #   #.#.# .## # ## #.# #.#### #  .##.#  .# # . #.#... ...# #..#  .#.#.#..# #  = # # #.## #.#..#### ###### # ##. .. ..#.### ###.#
#  #    ....# #.#.. #  . .   #.  ..#   .#.#.#. ## #  ## ##   ##.##.# # # #.##.## # # # #### ### .. .  # #.   ..  .    ..###.## #. .. .   #
# #  ##.## #  .  # #. ## ### .##.#.#### ##. .## .   #   # .# .#.. #...     .    ..   #.# . .  . ##### # ### #.##### # #   #....#.####.##.#
#  #...#  #.# # #.  # .# ..# #.# .#    . ..#   #.# #. #..# # #  # #.## #.# # # ## #### #####.###.  .  #   #. # . . ##.# ##.### #.....#  ##
##.#.# # ## #.#.#.### ## ##  #   #. # ##.##. #.#  #.# # ##.  .#   .#   # #   ##.##    . .. . . # #####. #.  #..# ##  ...#  .   #.# # .# ##
#. ...#    .. . #. . ..  # #. ##. #.## .. ##.#...#.  #  # .####.##. ##.# ..#  ... # # ######## .. .... #..#.## ## #.###. ## # #....#.# . #
#####  ## ## ## #.# ## ## .# #  ##.  #.## ..  .# .#.# #. #.  .  # ##.# # # # #.##.#. #.. .     # ## # # #    .      #...# # .# ## #.# #.##
#..  .#.#.  . # #. #   . # # ##  ## # .#  ## #.# #  .   # # # #.#.... ...    .# ..# # .## ### ##  ..#. .. #.########.##.# # #   ...      #
#.###.#  .## #  .## # ##.# #....#  .##..#. # #.#.. ##.#  .### # # ###### #.###. #.  ### # # ###.# # # ### ..#.   . .. .   # .# # ## ##.# #
#.# #.####.#.# ##   ...# #.# # ##.# .#.##.#  # #.#. #. ##  . ## #.  .   #. #...#..##.... . ..    .#.#...# # # ### ## ##.# . # #.# #. # # #
#   #    #.## # # # ##.# #..  #   # #  ... # #.#.# #  #   # # . #.## ## ## ###..#. ######### ##.## .##.#.  ... . #.  # .##.#..#.#...#..#.#
#.#.#.##  . . .  .#  ... # # #. ### .# ###.  #.# #. ## ## # #.#.  ..#  ..# . # # ##.  .. .  # ##  # ... # #.#.# #. #..#..# # ##.## # # # #
#.# # #.### ### # #.## #   .. #.#...#. # ###.## .# #.#    # # #.#.##..# #  ##..# ## #.##.### ..  #  # # #..# # #.## # .# .. .   .     #..#
# #.#   #. #  # #   # # .# # #. # ## #  .. #.  #.. .. #.#    . .  .# # ..#.  #.#.  .#..  #.# ## # #   # #.# ..   ..  ##  #.# ##.#.#.# .# #
#.#  ## ##   #.. ## .  #.# #.##.#..#  .## #. ####.# # . ..# ####### . # ##.###  ### ## # # #. # . ..###.  # ##.# ## #.##. #. =  ##.# ###.#
##  # # .  # # #..# #.##  .. .  ###  # .#.=# # # .#.# #.#.#.   . . # #  . .#.  ## #.     #.#.# ####.  ..## #.  #.# # ....# .#.#..#    . .#
#.## .# ## #.###.# # ##.# #.#.#. . # . #. # ##.##.#   #  .# #.#.# # .# ### # #  . .#.#.# .  .#...  ##.# .#  ##.      ### # ##.  ##.#.# ###
# . .## #..     . . .. . #. #  .## ### ##   .  .. # #.#.# #  # # .##   . #.##. # #. #. .# # #.## ##.#  ## #. #.## ##.#.#.  . ##.#...#... #
#### ...#.# # ## # # ###.# #. #  # ..  .#.## ####.# #   #.# # .. # ..##.##...# .. ## #.#  #    .. . #.#.  # #  #. ## .   ### .  .# # ## ##
# . .##.. #.#   ###.# .# .. # # #  ## ##  ## . . #  # #  .#  # ##  #. .. .## #.##. # # ###  ## #.###   ##  .##. #.. # # #. # ## ## o..  .#
#.## ##.#.#.#.## #  #.#. ##  .#  # #   .#  .## ##.#.#.###  # . # ##. ##.# #  #.#.=# .#   .#  ..=. . #.# #.## #.#..#.. #.# #. ..#.. ###.#.#
#  # . .   .  ..=. ##  .#.###.##.## ###  ##  #..# .##  . #  ##.. .## .#.##  # .#.#. ## # #.## ## #.## #..   .  #.## # # # ## ###.## .  #.#
#.# .# #.# ## #.##    #.#.. # .#.  .. ###  #  #.#.#   ## #.#   ##..# #   .#.## # .#. ..###   #. # ##   ####### . ...#... .. .. . ## ## #.#
## ###.##.#.## # # ## #.# ## .#.# # #.. ##.# # =# # # .. # # # .# #  # ##.# .. .# # #.#... #.##..  .# #...  .. ## # ..##.## ## #  .  # ..#
#. . .. ...... . #.# #. # #.#.# #    ##.  .#.#.#  .## ## # # #.#   #.## ## #### #.  #.# # # .  ##.###   # ## ##.# #.## #.# # #.# # # # #.#
# # ##.# ### ## #    .#.# # # #. # # . ## #. #..# # .    . #.# .# # ... . .  ..  ##.##. # ## ##.# # ..# .## #. .. .  . #   .   ##.#.#  # #
# .# ...#.  ... # ###.  . . .. # # # #  # #### #  #.# #.#.#  #.##..#.## #.# # # # #.  # #..#. ..   ##.# #... .#.# ##.#..#.# ##  . .  #   #
# # ##.#.# # ## #   . #.#.# #.# .. # ## #     ..#.##.##.#..##.  .# # #  #.#. #. # . #.  # # .##### #.....#.## #.# #.##.#  #  .## ##.##.# #
##  .#..  ##  #   ##.# . .# # ## # #  #.#.#.# #..     .   # .# ## ....# #. .# #..## ### # # #.  .#.#### #.#.### # #   . #.#.#  .  ###. # #
#..#.. ##  . # # #  # ### # # . ...# #. # # .  ## #.## ## # ##.   #.# #.# # #.#.# #.. . ## ## ## #  ..      . .#. .## #   ##.# # # . # # #
###.## =.#.# #.# ..#      #.# # #.##  # # .#.#..##.# ### ## . ## #  .#. # #  .  . #.###   . . . # #.#### # ###  # ## ##.# .# #= #. #=# .##
#.    .#.# ###   #.# # ## #.# # #    #  # #  ##.     . . . .## .# #.###.. # # #.##  # .#.#.##.# #. #   # #.#.. ##.#  . .# ##  #.## .##.#.#
##.###  #..   .##   . #....#..#. # ## # #.###  ##.#.# #.###.  .#.    ## # #.#.#    ## # ##. ..# .#.# ### #.## #... .## ##....#  . .#. .# #
#..# # #  # ##  # ### ##### # ## #... #.#. ...## . # # #    ###.# #.# .  #  #  ##.#  .#.#  #.#. #       .# ..# ## #..=#.  ## # # # ###.#.#
##.#.#### ##.#.#  #.#   ...  . . ##### .  #.# #.#.# .. .#.#  ..  .. ##.###.## #  #.## #. .#.#.# ####.###.# #   .# . #. .## .. #. .    .. #
# #  . #.# .  .##  . .#.#.# #.##.    .# #   .....##.#.#  #. ## ## ##.# .   #..## #. # # #.#        #...# #  .##.#.# .##   .# # #.##.## # #
#.. ##     ### .###### # # # #.#.######.# #.#####   #.## ##.#.#.... .#.###. .#.. . # ...#  #.##.# #.##  ..##. # ##. # ..##.# # ..#.# ..#.#
### # # ##.# ### .  . ..   .. .. .. .   # #.#..  #.##.  .  ...  ##.# # # #.# ##### ## #.## #.#. ## .## # # . #=  ##.# #.#. #. ### .  # # #
# .... #  .  .  .## #### # ##### # ####.... #.##  #   #.## #.## . .#  ## # .......  ..  ...#  #   #      # ## #.#.     =.# #.#. .### # #.#
#.# ## # # #### ##  ... .##... #.#.     #.##..  .## ##.   # #  #.#.  #.   .## ## ##.##.# #..# ### #.#.#.#.....#..### ## #   ..## . . # # #
## # #.#.# #o .   .## # #.### #  # ## # #.  ##.##.  # #.##  . #  .##.. ####  # # #.# # #=# #. . # . # =# # ##.# # .  ##.#.## # # ##.#. # #
#. . #...#  # # ##  .#.. ..   ##...  .#  .#.#.    # #.# ## ###.###.# ##    #   # # . #  # .# ##..##  # ..  # .# #.##   . # #  .... .#.# .#
## # # #.#.#..# # .# . ### ###   #.#.##.## # # #.##.# ...  # .   ... #.# #. ##.#  #.##.### # #.## ####.###...##.###..## #   # ## # #.# # #
## # # #.   #.# .#.#.###.#.. . # ##   .. . ... ....  ##.##. .## ### #  #.#.### ##  . . .#  # # ..  .  .# #.# #. . .#  #.## #.#  ... .#.#.#
#..#   ### # ...# .#   ..#.###.#. . ### # ##.## # #.# ..#. #.   ..  .#     .#  .. # ###### #  # # ##.#... ..  #.##.  # ...   # #.# ##  .##
## #.# .....# #.## # # #. .#.#. .#.#=.    #.## #  #.### ## #.##.# # ##.#.# # #### # #.  #  # # . . .=  ### ## #..#.#  # ##.#  #  #  .#.#.#
#  # #.### #. # . .  #.# # #. .# . # ##.## . ...#.#. .. . .. #... #    . # .=.  #. .. #.# #..##.# #.# #  . #  # ## #.###.#.### #.#.##.. .#
##.# ##.. .##.## ###  . .# ..# . #.#.. .. .###.## .#.# # # ##.#.#   ####.#.#.## . # #  .  .# ..# .## # # ## ###.#  # ##. .     .#    #.#.#
# .#..## #.     ## ##.##.#.# #.# ##.## ## #  # # .#.# # ## ## #  # #   # .  # # # #.# # ##.# ## ##...#   #...   .# .....## ##.#. # # #   #
## .#.. ##.# ## .  . # ..#.#     .    # #.#.#...## .  .... . .# #. ##.# .# #.  .. # # ### ##.     ## . #  #.###.#  ## # ##.# # .## #.  # #
## #. #   .# # .##.# #.## .# ### # ##.# #   .# # . ### ###### #. ##  . # . #.##.# #  .... . #.### .. #.# ##  . ..# #.# #. .   #.#.##.#...#
#  ##.####. . #.# #  #.##.#  . ..#   ... .##.# ### # \.#   .. # #.  #.#. #.### ##  #### ###. #= #.####.# #  #.###.# .    ## ##  #  .  # ##
##.        ###  .  # # .   ## ## . #.#.#.# #.# ..#.#.#..###.# # # # #.## #. .=..  #...# ..  #. ##.#  . # .#.##  .  .####  .# .# #.#.#..  #
# ######## #.# ####  ..## # #.####..  ..   . . # #. #.### ##  #  #. #  # #.## # #.## #  ### .#.#. ## # # ##   #####.#  # #.. # .#. #  # ##
#. . .   . . .  =..# # .. #  . #  ### ##.##.# #..# ##. .. .#.# #..# #.#  #.# # ##..# .#.=.# #.  #. ..       ##.... #  #..# #.  #.# ## #.##
# ###.# ###.###.## #.# ##.. #.# .#.  # # ..#   # . # .###.#.    # # #.####  .... #.##.# # # .# ##.#### # # # #.# #  =# .#. .##    .. . ..#
#.  ##.# . .  ..# # .#..# # #. # #.#.# #.#.## #o.####. .#..# #.# .# #  ..  ####.#  . .   . # # #  #.. ..# ##.#.# #.## # ## #. ###.#.### ##
# #... . ### ##.   ##.#  ##..#.#.###.# # # .# ##.# # .#  #.#..# ## .#.## #.   . ###### # #  ## .#. ### ## # .#.# #  . #      # .    #. ..#
#. .#### #.### #.#...  # . #  #. .. . .. # ## .  . .#  #. ## #.  .# #.#.#..### # .  . .# #.# . # .#. #  .  # #.#.# ###.####.# .## ## #####
#.## .   . .    #  ###.# #   # .#.# ##.##.##..##### # ## # ..# #.##.  .  #  . . ### ## # #..##.##.#.#..###.  .# . ..       #  #.     .  .#
#.   ### #.## #. #.#   . # # .#.###.# .#  . #.#.  # # # ..## # # # # ####..## ##. .  .. .#.# #  .   ## # . ## #.#.###.#.##..#.# # ## ## ##
# ##     . #.  # # .#.##  # # #    .#.#..## # # # # #..#.# .. ... = . .  # #  ## ## #.## #.# # ## #. #.# #..  # . #  ### #.#.#. # .  .#.##
#...### ##. # #   .#  ## ##  ##.# #  #.# .# .##.#   #.#....# #####.# ##.## .# ..  # ... .#  .. #.  .#. # .#.###.# ## .# .. .  #..## #.#  #
# ##    .# #.##.### #. .   # .. #.# ##.## ..##.   ##.. # # # . . .# #.#.# .#. ##.#..#.# #.##.## # ##.## ##.##. .#  . #. # ## #..#  .   # #
## # # # #.#   .#. ...## #.#### ..     .# # # .## # ####.#.# #### .  .  # # ##.#. ###.### # # .....  #.   .  #### # ### .# # ###  ## # .##
#....# .#. .##### ###.# ##..    ### #.###.# #.#  .. .   ..  .  . # ##.### . .# # # .   .   .. # # #### # #.#.  ..#.# # #  ..    #  .# ##.#
#.## #.###.#.    .#.# #.. # ###.#..#.#     # #..#.## ####.#.#.# # . # .. .# # .# ###.# #.# # #### #. . .#.# .#.#.# #   # ##.#.# # ##. . .#
#..# #. ## ##.# #.     ## #.# # ##  .#.### . .#.# # .. . # . # .# ## # #.#...#.#   #= # .#.# ##.  # ## #  # # .#.#.#.#.#. # #.. # . #.##.#
###..#.#.. .## #.##.#.#. .   .#. .# #.  ..###.#.  #.## # .# #.##   #  ## .#.## ###. # .#.# #. ..##   #  #... #.#.#       #. ..#.  # #    #
#  #.# #.#.# . . # .## .#### ## # . # # #  .#.# # # #.## #   .. # # .#   # ..  . . ####.  ...##.# # #  # .##   #. #.##.# .# #.#.# # ..## #
##.#  .# # #.# #  # ..# # .=#. ## #.#.# #.# .## #.## .   ## # # #. #. ##  # ##.### ## ###.#.#  .#.##.#.### # #.#.#  . #. #  #..   # ##.# #
#  . #..##.##..# # ## # ### ##  .. .# # #..#.# ##  . # #  # # #.# #.# #. #o #.    . .. .. #. ##       .  .   # # ##### ####.# ## # .##.# #
####.  #.. . #.# #  .#. ..#    ##.## .#.## #   .  ### # ## .### # # #  # ## #.### ## #.## # #  #.##########.#..#. .. . . # . .. #.# .    #
#. .## #.#.#.# # .# # # #.# ##.#..# # #.   ..## # . ..  . # . .#  # # # ..#  .# # #. # .#.# .#. #  .. .  .#..#  #.#.#.## .# # ##    ## ###
#.##  ..   # # #.#..#.#.##..## .# #.#..##.#.## # ######.# # ##. # # #  ###..#.. # .# # ## .##.# # ####### # # # ##.#.#.#.#.  . ..#.# .#..#
#    ## ## # #.#  # #.. . # .  #... # # .#  . .#. .... .# #.  # # ..  #... #.## # #..# #  #.    # # ..  # # .. .=    . #.#.# ### ## #.#.##
#.## #   # #.#.## #.# # ### ### # # #..#.# # #  #######.#.# ###   ##### ###.   .. .#=.##.#. #.#   . #.# #.#.## #.###.# #.#.#.# #... #.# ##
#  #. #.#.=#..  ..#..# .   .    #  . .# .#  .# # . .  .... .#   #. .      # ####.## .#... # .# ###.#.##.# #.# #.. . #  #  .# #.# ##  .# .#
#.# .#...#. # # #. # ## ## #.# #..## ###.# ## .. # #### #.# .# ### #.## # # #. .# # ## ## #.#..  ..     # . # .## #. #.. #..#..#..# # .#.#
#   # #.## ## ## #.#  . ## # # #.## # ##.#.# # # #.  . # .#.# ..## #   ##   ..#.  #..  .  #.#.#.# ##.## ##### #  #. # #.###.## # ##  # # #
## #   .   #        ##.#... #.. .  . . .....  #. #.## #  ##.#.#     .## ..###. ## ####.##...# #.#   #.    .    .#.##...# #.. ..     #....#
# ##.# # #. # # ## #    # ## ##.######### # #.#.#.#  ### #. .  ###.#    ##  . # #  .....  # ## # # #  #####.# #.. #.## #  # #.# # # ##.#.#
#= . ..# # # .#  .# .#.###     .....   . ..#.# ##.#.# # #.#### #  .# ## #.#.# . #.##.#### #  ...  ..# #.  #.### # #..... #.  #  #.# ...# #
#.## #.#.#..#. ##..##   #. ###.# #.# # #.#.. .  .  .  .. .    #..#  . ..#. ##.# ..#   . ## ########. . ## . .  ##.# ## # ##.# ##  # # ##.#
#. ..#.... #  #. ##.##.## ##..#  #.#.#.. #.### ## ##.## ###.#..#  #.# # # # ..# #.#.#.#. . .  . .. .# #.#### # #..#  #..     .. #.# ###..#
### ## ###  # .#..  ..##  # #.# # #   ##.# #.##.## . ..#  # # # # # .   #. #### # .# #.#### ##.#.##.   .       #=##.# #### # ## .....  #.#
# ..# .   #. #. .#.##   #. .   ....#.# ..# #..#.  ## #  #.  #=...#. # #.#.## .. . # .   .. # ##.# #.# # ##.###.        ..#.  # ####.## ###
# # ##.# #.# ### ## ##### #.#.### #. ## ## ##..##. .## # ### .## ##.# # #.#. ##.## #.#####.#.   ..#.#. #.#.# ## #.# ## #.# #. ... #  #. .#
# #  #.# # #.    .    . . #  .#.##.#.  .# . # # # #. ..     # #   # # #    # # # . #.#. .# # ## #.#.#.#. # # ... ###.. #. .# ## #.#.#.####
#. .#  #.....# #.# #.## #...# ..    .###.# #= ..   .#### ##.# ##.#   # .#.#. # # ##  ## #..#.#.## # #. #. . # ##  # ## # #. .#  # ...    #
# #. #.  # # # #.## #.## ## # #.#.#.## #. .###.##.# #..# #..... .. #  #.#. # #.#. . #    #.   . ..# #.## #.#  ..# . .  #.#.#  ### # #.##.#
#.# ##.## ##...#. ......  . ##..##     .##...#   ## #.###.#.# ###.# ### # #. # ### # .## ..#.## ##  #.  .# ### # ##.# ##.### #  ...  ## ##
## .... ..  .#. ## ######## .  # . #.### . #  .#   .#  #....... ..  .. ...##.#  .. .# # ## #   .  # #.##   . .##.      ..%. . #.# ### .  #
#. ## # # ## #.## .  . .    ##..## #  .#.####.#  ##.# #  #.###.##.# #.###  #.. ###.#. #.#  .###.###    . # # #.. ### # ## ##.# # #... ## #
##   ### #.# .. ..#### # #.#. #..  # ##  # # #.##.# #  # ## ... .  #  # . #.#.# .#  #.#.#.# #.# # ..# ## # # ##.## #.### # # . ..#.##.#. #
#  ##.#.  .. # ##.#. ## # # #  #### # ##  .      ..  .# .  # # # # # ## #. . . .#  # .# ..# #..#  ## .# #.#   # ... . .  ..  #.# # .#. # #
# # .   ## # . .. ..#  .  #...# ... ...# ### ####.##.#  #.# .## ## ##..# ## #.# ### .#.#### #.#.# # ## .. .#.# ##.## #.#.# #.# # # ###.#.#
# # # #.# .#.## #.# #.### #.# #.#.#### . #. .   ### #.# # .#  ..  . #.# . ..#.#    #.#..    ..#.# .  .#.##  # ..# #. .##   #..# .  .#    #
# # # #.### # ##.#  ..#...#   ....   # #.# # #.#. .... # ##.# # #.##  #.####.   ## . ###### ### .#### # # ##..# #..# #.  ###.#.######.## #
#.#  .# .   . ... # #=# # . # # ###.#.##.#.#.##.#.#.##  . ...#. # # #.# .  . ##. #.#.....     ..#.  ..# .  .#.# # #..###.  .       .  #.##
# #### .##.####.#. .# ##.#.# # .  #.. . .     ...#  # ## ###.  # .    # ## #.#  ##  .## ####.# #  ### .##.##.. ....#.. . # # ###.####.   #
#.. ..# .#  .  .. # #.   . # # ##. ###.#.#.# # #..#  ..#  .# #  #.#### . ##.###.. .#  #.  ..# #.#  . # # .#.# #.#.#.## ## ..#. .#    .# ##
##.# #  #######.# # #.####.#.## # #. ..#..#.  #..#.##### #  #. #     .# #. . # ## ###.  ##.##.#.# ###. .# .... .#= . # #  # #.#  # ###   #
#.. ## #.#. .....##.#.. .  #      #.## ###.# #.# ...   . # #  #.# #.#. .#.##..   # # ## .  .. . . . .# # .# ## # .##.# .# ### #### . .# ##
##.#.. .  ###### #. #.#.## ###### .# # ..#.#.# ..######.##  ##. .. # ##   ..####.#..   .# #.### ###### ## # # ..#.#...#  . . .  ..# ### ##
# ..# #.#          # # ### ...   .# .# # # #. .#......  . .# #.####.  .#.## #. # # ######  #.  #..  ....#.  .# #..# #..#.## ###### #..   #
##.###  # ## ###.# .   .# # ######.# #. #...### # #.#.##.# #.# #.. .## =# #.  #......... #.# ##  ######.# ##..  # #  #.# #.##.   #.# #.# #
## ## # #   . . # .# # #  #.#.  ...  # ## #.#.    # ### #.. .   .## #  # . # #.# #####.##. #.# ##....   # #  # #  # ##.#  .  # # #     #.#
#. ...#. #.#.#.# ### #..#.  .### ###.#  . # =.## #.  .  ######## #  .# # #.#. .  #.  ..###  . ..  ##### # .# # ##  #.  .# ##=# #. ##.#   #
## #### # #.## ..#  ..#. ## ## #.#. # ####..#  #..# ###  .   ..#  # #  #.. .## #.#.###. # ## ## # # .. . .# . . ..#  ##..#.#.# #.#.###.# #
#.... . ....   #.### #. # # .  . # #. . ..# # # .#  #.# #.# ## ## #. #.#.# #  ## . # # #   # #..  ### #.##.#######.#. # ## #   #...  ..#.#
## ## ##.#.#.## . .. .## ..# ## ## # #.# #  # ## ## #   #.# #.  # #.#  ..  .#    # #.#.# #     ##. ..## .   =      # #..     ##  #####  .#
## #.# .#.# ...# ##.# ..#.#  # .    . .. .#   ... # ######.# ##.# ##.# #.###. ### . .#.# .#### #####  .##########.# . ##.##.#..#  . .. # #
#  # ##  .##.# #.# . #.#. ##  #.##### # ##.## # ## .  ..#   . .  . .   .    # #..## ## # #   .. # .# ###     .  # .# #... #   # # ## # #.#
##.#....# .  ... .# ## .#...# #. .. .## .   .#.# ##.# #  ## ## # # # # #### #.## ...#  # . # #.##.##..  ##.## ##..# .## #.###... ##.##...#
# .#####.#.### ##.# #.#.#.##.#..#.## #..#####.  ....#  .# # .# #... ...... # . #.# ### ..# # #.#     ##.##.# #. #..#.  .    # ####  #  #.#
##. .  .   .. ...  . .#  .#   # # #  .# .  .  # #.#. # # . ##  #.######## # # # . #.# # #.#.## ## ##.#.  ..#.## . # .#.# ##.#.   ..# # # #
#.####.#.#.## ####.## # #  .##  #  #.#. ## ###.#.# .# ...#.#.#  . ...    .. . ###..   #   .  .  #.#.  # ##  .. .#.## #. .  # # ### #.#. =#
# ..  # #.# #.  .  ##.#.# #.#.#  #.#  # ..    .. #.##.### .#...## ###.##### #     ##### ## # ## #.###.# #. ## # # .# ### #.  .#. #.#.  ###
#.# ###  .   .##.##   #.#.#. .  #   # # ##.# ### #    # .#..## #  .  ##   ..# ###.  . ..#.#  #..#    #.  .# ###.#.#.  .... ##.#.#  # #   #
#  #. . ######.# #.# # ##. .#.## # ##.. ..  ... .##.#   ##.#. .# #.#. ..# #.#     ## #.#.  ####  .## #.###....  ##  # #### # .# ##.#.# # #
# #  ## .    #. #.  # .. ##  .....   #### # ## # .. # #.#.=.##.##.#.### ##.## # #.#. # # ### # ### . . # .#.##.#   #.#  . . # #.  .# # # #
#.. #.#### ## # ##.##.### . ## # #.# #    .# ... # # .# .##     .   . . ..  .#.## ##.###.    . .   ## ###   .#. # #..#.#.#.#  # ## #.  #.#
#.#      .   .. ......#.### #  #.# # . ## # ##.#... # #.## .## #### #.# #.##   # .   . . # ####### # #.# # #.####.##.### ## #.# .  ###.  #
### ##.#.#.## ####.##... ..# ### ### #       #   ####   ..#  .# . # ..#.##.# ##.##### ####.. . . #    . ..## .     . .  . ....# ##.. ..# #
#  .  #.#.#.. #   ## ###.# .. ...    #.## # #..#     ## # . ## # # .# . =.  .  .  .. .# .. ## ##.## ## ##.# .#.#.####.# ####.#  #.#####.##
#.## # .# #.# ### ...=   # # #.######.# # #.## #.#.### #..##  .  .##.####### ##.## ## # ###.# ##  .#.#  # ### ## .   .   .   ####.   . . #
#  . # #.. # . .#.###.###  ##  #  .   . .. . .....     # #  # # ##. .#    ..#  . #.   # .   #  ..# #.  #  .     .### ##.##.## . . ###.## #
#.###. # # ##.#.# ..# #  # . # ###.#.## ##.## ###.## ##.#.# # ## #.# ######.##.##. # #  ##.# #.# #. #.# ### ## #    . .  .. . ## # . . # #
# . . #.  #   #...# #.# # ## #.. ..  #.#.#..  .   #  #  #. . .  .  #.    ... ..  # .# #..#.    ##. #   . ...# ## #.### ## ### .#.# # # #.#
###### # ## #  ##.### .  .   # ##.###  ...# #.#.#..#.# ## #.#.# # # ##.## ## #.## .# . .#  #.# . #.#.##.###.#  . # .    ......#  # #.#.#.#
#  . ... . #. #   ..  # #### #.# ## # ###.### .#  #. .    # #.### #  # ..#.# ##. # .# #  #.#.#.### # #   .# #.# #.##.# ## # #.##. .#.#   #
### # ## #.###.######## #   ##..  . ..  .....#.## # ## # #  # .   .# #.##  .....## #  #.#..  .   .. . # #  .# ###.#.##  # ##.#.####..  ###
#.#  #.  # .   .. .  .  ###.#..#.## #.# # ## #.  . #.# ##.# # ### ## # #. ## ##.....# ## ####.#.#.## #.  .#.... .  .   #..  . . .  .## # #
#...#..#..#.# #.# # #.# ..  .#.. .....#  .  #. ## # ..    .  .# . . .#  # .#   ## ## . ..  . .   # .. #.#  # #.#.##.# # .## # #.##.#.  . #
##########################################################################################################################################
