##################################################################
#   .    #    .. . .  # # #..     . .       #.##.#.# #..# #  # . #
# ## ### # ## #.##.## # # #.#.# #####.# ###.#    #.#. #  .#.#..###
#   # . .# . ##.#  .#.# # # # # #....  # .#.# ###.  #.. # #  #.#o#
###  ##### ##.  .#.#  # # # # #  ##### ##.# #... # ## ## #=.#  ..#
#..# .. .   # # #  .#.# # # #.#.#    #..  # #.#### #   . .# # #.##
## ####.##=##.#  # ##.  #.# # ## ###.###### # #...  ##.#%# .# ## #
#. . .###..# .#.#  #. ###.#  # .  .      .  #.##.###   # ## #.   #
## ##    #.## # ### # #   ###  ### ###.## #..    . . # .#...#.##.#
# ##o ###. .# # ..  # # #  . #   .# ..  ###.##.## ### ## ## #.#  #
#...# # .#.##.### ##.# ## ### ####.###.#    # ## # .# #.    . .###
# #.# .#.# #   . #   ..  ......  .  .  #.##   .. .# #.# ##.###   #
# ##  # ....#####  ## ######### ## ## #  ..##.### . #.# #.##.#####
#. #.#.###.#  .  #. #..      . #   # #.# #### . # ### . .= .     #
# ##.  . =.# ### # # ##########. ##  #.  . #  # #.#   ## #=### #.#
#    ## # #  #.# #.#.  .   ... #.#.# # #.##.#  ##.#.#.#  #.#.# ###
# ##.#.# # ### # # # ##########. # . # #. . #.#.  #.#.# ##.#     #
# .#. \.  ..   .. ..      .  . #. #.#.. #.##. # # # # #.#.  ##.###
##. # # #.# # #.## ## ## #######.# .## #. #.#.# #.#  ## .# #. .  #
#.## # # # #.#.##.#. ## #. ..  .. #  # ## ..# # #.# #  .# #.######
#.  . ... .. .   . #.  .# #### ### .#.#.  ###  ## # # #.. ...  . #
#.## # ### #.## ##  #.#.#.#. .# . # # # #.  .##. .#  ####.## # ###
###.  #.  #   # #..#.#.   ### ##.##.# #.###### ## #.#=#. #.# # #.#
#. #.#..#.##.## ##  ..# ##   ... .  #. #      . ..# #.  #..# #.# #
## #  #.# . #.   # #.#..# #########  #.# ### #.## # .## ##   ##  #
#. # #   ###. # # .## #.  .  ..  .#.#. #.#.. #.#  # # . . #.#.#.##
##.#. #.#.. #.#..# .  . #.##.###.#.  #= #.## #  # # # ## #.# ..  #
#. #.#.. .##.#..# # ### #. # # #  # #  #.  ..# #  #.# # ## #### ##
# ##.#### .#..# # # # . ###.## ###. ##. #.### #.# # # #  . .  . ##
# . .     # .# #    ###.      .   #..  # #. ...     .  ### ####. #
#### ###.### #.# #.#..  #.# # #.# # # #    ########## # .  .  # ##
# .  . .###    ..# #.##..# # ##.#.#  # # # #  ... ..# ######### ##
# ###### # .#.##.#.### # #.    .#.# ## ###. ###### #    ....     #
# .   . ..# # #..# ..  # ###.##= #.        #    . .###.### ###.# #
#.#.# ##.##  # #.#.#.# # ..# # # =#.### ###  #.####.  #.  #   ## #
#.#.# ..#  ###.#.#.#.# #.#.#.#.. #  #  #. .#.#.# .. ##  #. ## # .#
# # # ##.# # . #  #.#.##. # # ### #  # ## ## ##.##.#.## #.#..  # #
# #.#.. . .# #..##    . .#..... . # #.  .  . .  .. .. . #.#.#.#.##
##.# ####### ### . #######.#######.  # ## # #.##.#.##.# #.# #.   #
# .  . . . .     # #     . #    ..#.#.#.## ###  ## #.#. #..#. ## #
#.########.###.### # ##.#.#  ##.# ##   .  .##. #. .# ## # ### #..#
##....    ....#..  # # # # ##.# ##.###.## # ..#..# .  #.#. ##..# #
# ###.####### #.##   .    ..    . .  .#.#.#.#  #. #.## .#.#...#..#
#.#. #   .. # #.#.##.####.##.### # # # .# ##  ## #.#  # #..##  # #
# .#.# ### # ..##  .# . #.# .#. ##.# .#.# . # #  # ##.#.# #.  ####
# ## # #.## #.#  # # .# #  #.##  ..#.#..# ###  #  .   # #. ## .#.#
#   .  .    ..# #o.## ##  #.. #.## # ## #. .. # ## ## #.# # #.## #
# ##.#.# ##.#.#  # =#.  #.## #...# #    .# ##..   # ##  #. .#..  #
#..#. # # # # # #..##.#.#  # ####.# #####.#.# #.# ..  # # ## .# ##
### .#...   #.#..#.. .## ###..  . .   . . .. .###.# ##..#  .# #  #
#  # ### #.#  # #.### ...=  .# # #.##.##.##.## . .# # #..#.#.  #.#
## #   #.#.###  . ...# ###.## #.# ## # ##..#...##.## .#.#  ## # ##
## #.##  .#. # # ####.#   #.#  ..... ...  # # #. ..#.#.. #  #..  #
#  #.### # .# .##. .   ##.#.## ##.### #.#  . # ##.#  .# #. ###.#.#
##.#. #..## ##  # ##.#  #.#.  #.#.#.# #.# ### ..  ##.# .# # #. # #
#  #.# #. #   .## # #.### #.# #.# ..# .#.. .# ###  # .#. #   #.# #
## # # #.# #.#.   .  ...  #.###.#.### #.#.##  #.# # .#..# # # .# #
#   .#.# #.  #.#.##.###.##.     #.# . # # # # #.#  #.##. .# ## # #
# ## #.#..# ## ##.###.### ##### # .##.# # . # ..#.# . # ##  .#.#.#
#. #o# ###.#     .   ..    ....   # .   # ## #### ## ##. .# ##.# #
#.# .#.. . . #.#.## #.#.### # #.#.# # # #.  .        . .#.# .  # #
# ##.### ##### #  #..# #. .#   # #.# #.#..# ##.# ## #####.# #.#. #
#  #   #.#   .## #. ## ## #.### . ... ..# # # #.# #.#    .##.# # #
### ###.# ### # # #.   =    ...####### ## #   # .  .#####      . #
#.    .  .. . ..  . ##.## ##.#.# .... . . .##.# # #     #.##.# #.#
##################################################################
