################################################################################################
# #..... .#...   ....# . . .  .# # .. .....# ... #.# #..# #   . .    ..   ........ ..# .#.#.#..#
# # ### #.# # #.# ##. ## ##.##.# .#.########.### # # #.## ##########################.# ## #.# ##
#.#.#.## ##.# #.#   .#.##.##.#.#.#.   . .  . .. . .. .... ......  . ... ...     . ...#..... . .#
# #  ....   .#.# #.# #. .o.. . #.########### ### ##.##.#.##.# #.## # ##.#.##.#.##.# # .# ## #.##
#. ##### ## # ...    ######### # .  . ..     ...# ###.#.#.## #.##.# ## #.## #.##.#.#.#.##.##.# #
#.#..  #.#   ####### .  ....  .#.###.## ## #.###.  ..  .. .... .. ...   .     ..     .. ..   ..#
# ####.#..#.#...  .. ## ##.# #.#.#..# # #.#.#. .# #####################.# ## #.# # #.#####.#.###
#.. .#.# #.. ####### #.## #.## # ##.# # #.#.#.## #  . ... . .    .   .# #. #..# #.#....  .# #. #
# ####.# .#.# .. . ..#. . . ...# .#.#.###.#.#  #. #.#.#.# ## ##.## ##.# # #  # .#. #.##.#.# #.##
# #. . #.#. .#.## ##..##########.#... . ..  #.## #.# .# #. .# .# .#.#.#.# .#  #.#.#.# ## .# #..#
#.# ## #..#.#.#  . # #.   .... ..# #.#.# ##.# #  #..#.# #.##  ##.## # #.#.#..## #.#. .. # # # ##
# ## #.####.# ###### ###########.##.#.#.# # #.##.# ##.#.#.#.# #.. ..#.#.#  #.#  #.# ##.#  #.# .#
#   .. . . .. .   . .............  .. .  ... .   #....# #  .# # #.#.#.#.  #. ##.# #.# #.#.# #.##
######.## #.## ## ##.#.#.# ##.# #.#.#.#.#.### ## .###.## ### . #. . #.#.#.##..#.#.# #.  . #.# ##
#  .. # .#.#..#. .#.  #.#.#.## #.#.#.# # ## ##.# #. .. .... #.#..## # #.#  #.#. #.#. #### #.# .#
# ###..#..  # .##.# #.#.#....#.#  . . ..  .... #.#### #### ##.## ##.#.#.#.# .##.# # #...#.#.#.##
# ..# #..#.# .# ##. ## .#.# #..## ## ### ###.#   ...# #..#.#  .... .#.#.#..#..# # # #.#.# #.#.##
#.##.  #.#.##.    # . #.# ##.# .#  # #..#   ##.#.#.#. # ##..#.#####.# # #.#. #  #.#.#.##   ....#
#  .# #..#..#.# # # ## .. . . .# .# . # ### .  #.#  #.# ...## # ...#. #.#..#..# #.#. ...# ## #.#
# # #.## #.#..#.# # . #.# # ##. # ##.#....#.### .#.#...###.#.. ###.##.# #.##.#..# # ##### #.# ##
## ## .#.##.#.##.##.### ##.# #.##..#. #.#.#.. .# #..# # .. ## #. #..# # #.#.. # # #.... ..#.   #
# .  .##..... . . . ..  .   .#.#.### ## # # ## #.# #.. #### #  #.# ## # #..# # .#..##.# #..## ##
#####.#. ####################..# . ..#..#.# .# #.#. # #.. ... ##.#.#..# # #.# #.# # # #.#.#   .#
# . .  #.#..    . ........ ..#. #.## .# ###.#..# ###..#.#.###. ..  .#.#.#  .. #.#.#. .#.#.%##.##
#.# #.##.##.## ############### #.# #.# ....  #.#....# .#.#. # ## ##...#.# # ##..#.# #. .#.#. . #
## ##.# ..   .. ..  ... . ... .#  . .## ### #..#.##.# #. #.#  .#  . # #.# ## ## # ## #.##.###.##
#.     ######## # # #.#.#.## # .####  # ..#..# #.# #...# #  # #..###. # #..  .#.#. ..  . .  .. #
## ## #. ..    # .#..# #.#.#.#.# . . ##.#. .## #    #.##.#.# .##  ..#.#.# #.# #.#.### # ## ###.#
#.   . #.#####.## ##.#.#.# #.#.# # #.# .#.#.#..# ## # #.. . #..#.# #. #.#  #.##.#.#. .#. #.#  .#
## ## # . . .#  #  # . # # # #. #.##..# #.#..#.#.#.# .##.#.#. # . #.#.# #.# ..  #.#.# #.##.#####
# #.#.#######..# ##..##..#.#.# #. ...#. #...##.#.#..#. # ##.#  #.# ...#.#  #### #  .#.# #....  #
#.#.#..... . #  . .# ..#.# # # #.###. ##.## #.##.# #. # ..  #.#   #.# #.#.# ..# #.## ## ##.### #
#... .######## #####.# #.#.#.# .#  # #  ........ .. #..#.#### .# #. # # # # ### # # . ..  ...# #
## ##.#.....  . ... .    #.#.#.#  #. \# # ##.#.#.#.#. #  #.. .## ##.#.#...#.... #.#.### ##### ##
# #.#.############## ###.#.### ## ## # # ##.#.##..#.# .# ####.# #.###.#.#.# #.# #.#   #  .... .#
# .  . ... . .    .   .  .. .  .    .  .   .  .. #....#....    . ..   # # .#.#..# #.# #.###### #
##########.############ ################## ##### .#.#..###.##.###.# # # # # . # # ... # #. ..# #
# .. .    . ...  .. . .. ... ......     . .   .# #..# #..# # ##.## # .# #..#.##.# ###.#. ### #.#
#.####.#.## ## ## ## #####.# ###.# #.#.###.####. .#.# # # .     . ..#.# #.#  #. # #.  #.#....#.#
##...#.##.#.#  # #..#  . # # # #. #.#.# .#.#...# ##.# .. #.#########  # #  #. #.#. #### ## #.# #
#..# #... #..# . .#.#.### .#  .#.#.   . #  #.##..# .# # #...  ... . #.#.# # .#..#.# .  ..# # # #
##.###.## #.#.#####.#.#.## # #.#..##.## .# #.# # ## # # .# ########.# # #.##.## #..##.# # ##.###
#  .. . # #   .. .. . ...#.#.#.# ## #.#.#..#...#  #.#.# ##.#.  .. .##.# #... .. #.#.##.... ....#
# ## #.#. #.############ #.# ##.  .  . . #o# # # ##.#.#   ..#.### #...#.# ###### .#. .# ####.###
###.## .# #.. .  . ..  . # # . # ## #.###  #.#   #  #.# ##.#.#..# #.#.# # # ..  #.#.##..#. #.#.#
#      ##.# ##.#### #### ..#.#.# #. ###..#.#...# =#.# # .  . #.#  # #.#.# #.#.##     .#.#.# ##.#
######.#..#.# #.. # .  ..# #. ##.##. ..#.# # ###.#. #.####.###.## ##..#.#.#.### # ##.#   ..    #
#  . .  # #.#  .## .## ## .# # . .# #.# .#.# #... #.#.  .# ....     #o#.#.#.......#...#.#####.##
########.# #.##.# ##.### ## # # ##.# # # ### ###.# #.#### ###########.#.#.#.# # #  # #..  ..# .#
#     .   .  .    .    .... .  .. ....  .. ... ..  . ....     ... . .  .#.##.#.#. ##. #.#.## .##
###########.#########################################.################# #.. ....#.#..#..#...#  #
# ....  . . .. . . .    . ... . ....  ...   .. .  ....... .....  ...  ..#.##.###   #  # ####.###
#.#.#.## # ## # ###.#.##.# ##.##.### #####.# #.### ##.# ##.#### ###.### #. # . .#.#. # ........#
# # # #.  ## #..# ## # .#. #.#...#.# #.. .#  # #.###.# ##.. . #.# ### # # #. ###...#..# ### ## #
###. ..#.#. ..#.#... .# .#.#.#####.##.###  #. . . ...... #.#.#  . . . #.# ##.  .#.#. #. . .  # #
#...# #   ## # .# ####  #. # . .   .... # ##.## # #.# # #. #. #.#.##.#. #. # ## #..#. #.# # #.##
####.#.#.#.  ##.# #  .#..# # ## ##.#.## #.# ##.#.# # #.#.##.## #.##.#.# #.## #.#. #. # .#.#... #
#.. . ...# #. # #. #.#  #  #.#.#..#.#. .#. .. . ..  . ..  ..  .. . .. # # .. ...#. #..#.# . # ##
# ##.### #.# #. #.##.##.## #.#.## # ###.# ###.##.#.# ####.##.#.# #.# #. #.#.# ### # ## # ###.#.#
## # #.  # #. #.....   ..#.#.# o .#.. ..... # # # ## #. .# .#.# #.#.# #.# # # #...  ..   .  .  #
##.##.##..## #  ### # ###..#. ###. ##.### # # #......## #  #. . ....  # #.# #..## ##### ##.# ###
#..    . #..  #.#.#.#  . # #.#  . #  .# ..##...# ###... .#..#.# # ###.#.# # #.#.# #. .  #..#.# #
##### ##..## #..# # # # ##.#. # #.#.#.# #...#.#. # #.####  ##.##.## ### # # # #.# #.### ## #.# #
#. .# .#.# #. # #.#.# ###..# #.## ## # #..#.#..#.#....  .#... .  ..  .. # # #...#  ##.#..# #.# #
#.##.###.. # #.   #.#....# #.# . . .. ..#  ## #...## ###.#.### # ## ### #.#.# ##  # . #.## # # #
# . .....### ##### #.####. # #.##.##.##.# # .  # #.. # #.# #.### # ##.#.#.#.#.# #.#.# #.#  #. .#
##.## ##. .    .  .. ..  # #..# #.#.# ### ### ##.# #.#  .# #  . .# ...#=# .##.  #. ##.#  #.# ###
# # #..# ################# # #..   ...  . . #.#  ##. # #.#. # ##.# ###. # #.  # #.# .   #.##.#.#
#.# ####.#   .... ... . ...#.#.### # ####.###  #...#..## #.#. .....   #.#.. # # # #.# #.... .. #
#.    .  .#.##.###########.# #.#..#.#.. # #...# .#.#.#  .#.#.###.# # #  # ##.# #.  #.#..#.#.##.#
### #.## #.# ##. . . ... #.# #. # .  #.#  #.#  # . #  ##.#..## # .#.. #.# ... ..#.#  .#.# ##  ##
# .#.  #  .... #.####.#### # #.#..## # .# #.# ## #...# ..#.#. . .#..# # #.#####.#. #.##.# . #..#
##.##.# .# ## #  #     .   #.# .#.#..# ##..##.#.. ##.#.#.#.# # #..# #.#.# #.    #.##.# .#.## .##
#.. .  #.##.##.#.######### #.#.#   #.# # .# .. #.#.. .#.##.#. ## ## #.# # ###### .#...# #.  #. #
###.#.#.... . .   .   .. # # # ##.## # ##.# #.# #.##.#   . # # .... #.#.#...  ..# ##.#.#.#### ##
#.#.# ##.## #.#.#.## #.# #.# #. . #..# .#  ## #... . # ###.# .## ###  #.#.## #.#. ..    .   . .#
#   #. # #.#  #.#.  #.#.#..#.#.## ###  #..# .. # ### #.#.# #.#.. # .#.#.#.# # # #.##############
# #.#.##.# ###.#.####.# ##.#.# .  .  #..#.# # ###..#.# #.# #.#.# ##.# #.#. ...= . ....   .... .#
### #... .=.... . .......# #.#######.#.##.## # ## #.#.##.#.## # # #.#.#.#.#.##.####.## ##.######
# .. .##.##.#.######.## #  #....   .. . . . ..  .   ....  . ... ... ..# . #. #.# .# #..#..#... #
###.#. # #.#.#.... ..# # #.# # #.# ### ##### ########.## #.###### #### .#.###.#.#.##.## ##.###.#
#.. # ## . #.#.##.##.# #.#    # #   .#.#  .. #. ... # # #.   ... .#.  # #.     .  .  .  . .. . #
# #.#.#. ###.# #.##.##.#.#.# ## #### #.###.## ####.#.##.#.########.# #  #.#.## #####.###.##.####
### #. # #  .#.# ..  ... #... .. ..    . .... ..  .  .  .....   . .  .#.#...#   .. # #.. .  # .#
# ..# #    #.# #.## # ## # ####### ######.##.##### ###.## ##.#.## # ##..#.## # #.##.  #####.## #
### # ##.###.#.### # #.#.#.#    . #. .  #.#...   .#  #.# #.##.# ## ## #.#.. .. .   # #  .  .  .#
#.  #..# #.. .. .. .... . . .####.##### #..# ######.#.... . .    . ...# #.## # #.##. .# # # # ##
###.#.#  #.#.##.##.#.#.#.# #.  ....   # #.##.  ...   # ##.##.#.#.#### #.#  ##.#.##.#.#. #.#. #.#
#.# #. #.##.  ### # #.##.#.######.##### #.# .### # ###.  # #  #.#.. ..#.#.#  . ... .. ##.## ## #
# #.#.# ...# #..... #.  .# . ...  .  ...#  #.#.#.#.#.. #.#...#  # #.#.# #..####.##.#.#   ...# .#
# # #. #.##..# # ##. # #.# # ###.#.### #. # .# ..#  ##.# ####.#.## ##.#.# #.   .# # ..#####.## #
#.# #.## ..#.#..#.# ##.# # #.# ##.## #. # .# # # #.# #.#   . .   .. .. .# #.# #....# #   .#... #
#.#.# #  ###  ### # #.##.#.#.#... ..  .# .##  ## # # . .# # ##.## ###.#.#.#..## ###...## ## ####
#.  # .#.#   #.  .   .. .#.# .#.## # # .#.#. #.. #.# # # .# .#.#  # ....#.#.#   .  # #. .. ... #
################################################################################################
