###########################################################################
# o . .#  #  .  .     # #....# # #  . # ## # # # # # # # ##.# #     .# .# #
# ##.# # #  # # # ## # ..### # # ####     .    .  .       . #.# ###### ## #
# # #.##  # #..## #   #.#.  . . .  .  ################# ###.# #  .   .   .#
# .  ....# .# #....#.#  #.########### #    .    .  .    #.# # #.## ## #=# #
###### # ## #  ## # . #.# #    .    #  ## ############# # ##  # # #   # # #
#.   # #.=#.# # .  # #  # .# ####.# # ## # .  .       #    .# # # #### # ##
#.## # #.#  # # #.#.  # # #. #    ##  #    ###########. # ##.           . #
#.# # ##.## ## # #.#### #. #  # #.  #. #.#.   . . .   #.#   # # ## # ## ###
#   .           . ..    #### # #.###  # ## ###### #.##  ####   # ## ## #  #
## ##.####.# #.##.## ##       .  .  # #      ...# # . # .   # #.   . .  .##
#.   #   #. # ##.#  #.# ## # # ## ##   #.# # ##.# # ### # # #  # #######  #
##.#.# ##  #     .#.# # # # # #.#  .#.#  # # .# #.# # .  ## # #. # .   # ##
#  ##  # #.#####.## #.# # # #.# ..# # =#.#.### # #.# ##.#  .# ##= ###.## .#
##   # # .    . . . # # # #.#..## # #.##.# ..   .   ..# # # #  #.#       ##
#  ##  ### #####.###. # # #. .# . #.# #. #.#### ##### # # # # #  .#.## # .#
## # #   #     #    # # #  ## # # #.#. # #  ..#  .  #.# #  # . ###.#.### ##
#. # # ## .# # #.#.#  # # #.#.# # #.# # ##.###.##### #.# ## # #      . . .#
## #.#.# ## # # # #.# #.# # # ## # # . . .            . . # # #.# ### ## ##
#.       ..=          # #% .#. =    #.########.#.#####.#.## # #.# #  # # ##
## ####.## #####.# ###  #.# # ##.# ## #  .   .# # .    # #  # # # #.#   . #
#  #    #.     # # #. # # ### # # ## ..# ## ## . ## ## #  # # .#.##.#### ##
###.#### ###### #.## ##=.    .  .   # # # #   #.# #  #.# #..# #  .   .. .##
#  .   .       .      ..# # ## # # #  #.. . ##  #.  ## #.## #  #########. #
## ## ## # ###.# ### ##  # ##.#.# # # # ### # # # #.#= # .# # #          ##
# ##.## #.#. # #.#.# #  #..          .#  .#   # # # ## # ## #. ## # ## # ##
#. .    . # ## # # #. # # ### #.#.#.#  #### ### ## # ### # .#.#  # ## #.  #
## #.# ## #   .#   # #   ## ### ## # .# ... .  ..  . .   .# #. # #  .  # ##
#.# # #.# # ## # ##   # #. .   . .. #. # ######### ##### # .#.#  # ####. ##
# #=#.# # ###  # # # ## #.## ## ## ## #  #    .  #.# . #  # #  # # #   # .#
#     .      # #   # #  # # #.# #  #   #.# ##.# ## # #.# ##.#.#  #  #.#  ##
###.## ## ###. # ###  # # .  .# .#  # #.## # #.## # ##.# #  # ## # #   #. #
# .#  .# . . # # #  .#. # #.#.# #  # .#  .  .   .. .   .  # #. # # ## #  ##
## ####.#.### # # ### # ## # # # ## # ##################### # # .# .   #. #
#. .   .   .    ...    ...      ..     .                  . #  # # ####  ##
### ## ##.### ## ## #####.################################# # #  # #   #  #
# # # #.### ###.#. #   .#     .  .  ..      . .. .   ..   # # ## # ##.##o##
# # ..   .       # # #.#  # # # ##.# ### ## ## # # # ## ###.#.          ..#
#   ############## # ## # #  # ## # ## ### ##.#   # # # # . #.#############
#.# # =    ..     . .  . .# #  .     .    .   .# #. # . # #\    .. .    ..#
# # # # ############ ##.# #. #.##.# ## #.## ## #  # # # # # ### # # # ## ##
# #. # #     .  .  # # #. #.# .#.# ## # # #.# ##.## ### .##.# #  #.# ..# .#
# # # .# ## # # ## # # ## #. #.# ....   .   #.   #..    # . # #### .# # .##
#.#  # ## ##  ## # # #. # # ##  #.# ## #### #### # # ##  ## # .  . ##  #..#
#.# #    .  #    #.#.# #  # #  ## # # ##  #   .#. # # # #.#.###### #.## ###
# #  # #####.##### # #. # # =#.# .# #    #  ## # #..    #.#       .     ..#
# # # .            #.#.#  #.#. .#.#  ### ##. #.#  #####.  # #### ## ## ####
# # .#### #.# # ##.# # .# # ## #  # #      .#  # #     .##  ...# # ##  #. #
### #    #  #  # # # # #  # .#  #.# ## # ##  # #. ##### # #.### .    # ## #
#.  ## # .#.# #..#.# #  # #.#. #  #. #  # #.#  # #.   #.#  .#  # ## ##  #.#
###  ### # # # # # # #.#  # ##. # #.#  #   . # #  # # # #.# #.# .#  # .# .#
# #.# .     .      # #  #. # # # # # ## ##### ##.#.##.## #.    #. #  #.=# #
# # .############# #.# #  #   .  .  .           ....  . . #.###. ## ## #. #
# # #    . ..      # # .#..## ### ##### #.## ###.######## #.#  # #  # ..# #
#    #########.### # # #. ### #. # .  # # # #  #.       # # .# # .#  #.#  #
# # # =.   ...# .# # # ## .# # # #.### #.##.#.## ########.# ## # ##.##  # #
### .########.## #.#.  .# #. .   .  . .   .      #       .# .  # #. #  ## #
# = #  .   .#. #.# # # #   ### # #.# ########### ######## #.####  # .# #  #
### .#.#####  #  # #  #.# #   # # #     .      #       .#.# #    # ###  # #
# # #  .   .#  # #.# #..#  # #.    # ## #.#.# #  ###.###  #  ###.#  .  #  #
# # .# ###### ## # # .# # #  ## #### # # # # #.# # ### ### .# .# #.#.#  # #
# #.#  ..   . #  # #.##.#  #  # #    # # #     # .  .     # ## #. # ## #  #
#.# ######.## .#.# #... # ## ##  ### # .   ## ## ### ### #.    # # .    # #
# #   .  # # .#  # #=###  #  #  # .  .## # #. #. #  ## #  # ###   # ## # .#
# # ## ##  ##  # #.# #..#. #. #  ###.# ###.### # # #   o # . . # #.# #  # #
# # # # ##. #.#    # ##.#.## ## ## #.#  .    .   #  ##.#  # ## #..   # #  #
#  .# .   .#. .#.#.#  # #.#       . .# #.# # ###.#.## #. ## #  # ####. ## #
###  ###### #.# ## # # ... # ## # ##.##.#  .## # #  .  # #   #.# . . #    #
# # #.     ...    .. .# # #.##.#.# #  # #### o.#.# ### #..# # ## ####  ####
# # ##.###########.#.# #  #  .  ..   # .   . #.# # # ## ### # .  ..  # #  #
#.#  #.#          .#    # .## ### ## # ##.## #.# #         . ### # ##  .# #
# # #. ## ##.##.## # # # .#...  #  # .#.### ## # .#.## ## # ##.# # # # #  #
#    #  #  # # # # #.#  #  ##.# # #. #.  .       # .# # ## .. .#  ## # ## #
#.# #  #  # .    # # # #..# . # # .# # # # # # #  # .     #.## # #  ....  #
###########################################################################
