####################################
#  . .## #.    .# #.. ..# #.# . ## #
#.#.# .....#.#.#  #.# #.# # # #. . #
#..o#.## ### .# # ##.##.#.# #.# ## #
#.#... . .. .#..... .o.  .#...#.# .#
#.# # ##.# # #.##.# #.###.#.#.#.  ##
#.#.#.##. .#.#.#... .... ..   # #.##
#  .#...##.# #. #.# #.#o##.##  ..  #
# ## ##. ..# # #.#.# #..#%..# ######
#.. ..  #.##.  ... .. # .# ##  .. .#
#.##.##  .. .# ## #.#.##..# .#.#.###
#.#  #. #.##.#.# #. #. # ##.# # ...#
#. #.#.#...# # # .# # #..#..#. .##.#
# #.#.# #.# .#  .#  .. #..# #.#....#
#..     . .#.=.## #.##. #.  ..  #.##
#.# ## ## ## #..#.#.. #.  ## ##.##.#
#..# ..## #..# ##.=.#.### #=#    . #
# #..# . .#.#....#.# # .#.# .# ###.#
#. ## .####.# ##..## ..#..# #.##.. #
#.#### . .....#.#.  #.# #...#. . # #
##### #### #### #.#.  #.#.#.#.#.#. #
# ##  ..  .... . .#.#.....# .. ..#.#
#  ..##.##.##### #. .# ##. # ###.#.#
##.###.#   ....... # #....##.# . #.#
#..   ...### ### #. ..#.#.#..#.#.#.#
#.#.# ##.#  #..#.. # #.. . #..##...#
##.## = . #...#.##.#..# ##...# . #.#
#o..  #.#.. #.    . .#...# ##. ##..#
##.#.##.#.##.# #### ##=# #.# ##. # #
# #.#  .. .... =. .#  ....  . . #.##
#. .# ####.# #.# # #.###.#.##.#.\. #
#.#.# ... #.# .# #. .  ... ...## # #
# #.  ###. . # # # # ## #.#.## .  .#
## ##... .##.#.#.#. .## #.# #.##.#.#
# .   #.# .. . . ..# ....   ..... .#
####################################
