##################################
##  #  # #..  # ## ## ##.#.#.#.# #
#. ## ## #.## ..o .     . ..    .#
##.. . o #.# ## ## # ####### # #.#
# .## ##.## %#  # # #.. .= #. ## #
## #.# ##..#= # #.# # ##.#.#.#o  #
##..  .   # .## #. .#.# \# #.# # #
# ## ## # #.#.o. ## #. # # ..# #.#
#..   .#.   ##### # ###.## #. ##.#
######.## ##.  .        .  #.#  .#
#.   #..# #..### #### ###### #.#.#
##.###.# # # #   #. .# ... ...##.#
#...  . .. #.# #.#.# # ## ##.#   #
# ## # ####.# # ## ##.#.##=##=##.#
#.# .#  ...  . ..  ..    . .  . .#
# .#. ## # #.# #.#.# # # # # # # #
##################################
