###################
#.  . ##. = .  .. #
# # #. . ##.#####=#
# # #.##.#      . #
#....  .  \#.### ##
## #o##.#.#. #  # #
##. .  # # #. #  .#
#  ## #  .   #. # #
##     ###### # # #
#. #.# ..   ... # #
##.## #### ## # #.#
# .   .o% .   =. .#
##.# ## ## ### ## #
##.#  #  .    .   #
#    #  #.# #o#o# #
## #  #=    # # # #
#    ## #.#       #
## #  .  .# #.# # #
###################
