##########################
#..#.## # ##.#.##.##.# #.#
##.  .. % .... o  .. ... #
##.##.##.## # ##=#.#.#=###
#. #.# ##.#.##.#..#.o#. .#
## .. ..........# .#.#=#.#
#..##.# #.#.##.##.# .# ..#
##   #.## #. #.#..##.# #.#
#..# #......#.. #. #. .#.#
## # .#.#.#. # ## ##.#.#.#
# .#.##.# ..#..#.......#.#
##.# .  #.#..#..#.##.#.#.#
## #.# ##.#.##.#.#.#.# # #
#  . .o.  . # .#.....  #.#
## #.#.## #.##..## # #.#=#
## #..  #.# .#\#.#.# # #.#
#. ###.##.#.## #...#.#...#
## ....   ..#  # #. .#.#.#
##.## ### #.##.# ###.#.#.#
#  .. ... .  ....  .. .#.#
# ####.## #.####.###.# . #
#=.... .  ..#..     ...###
# #.# ##.## # ### ####   #
#o##.# ## #.......#. . # #
#  ... ...# # # #   ##...#
##########################
