#####################
## #.#.##.##.#.##.# #
#  .. .=.. ........ #
#.#.##### #.#.#####.#
# .# .  #.# #... .#.#
#.#..# ##.#.#.#.#.#.#
# .# ###..#..#o#.##.#
# ##. . #.#.#. .....#
#.#..#.#=.#..######.#
#..# .#.#.#.#. .....#
#.#..#..#.# #######=#
#.##.## #.# o....=#.#
#.......# #.#.##.#. #
####.####.#.##.## # #
#...o.....#.. ....# #
###.#.#%#.#.#.## #..#
# .#.# #..##.##.# #.#
##...# .#. .......#.#
##.###\##.###.###.#o#
#..... .. #. .. #.#.#
#####################
