##################################################
#   ..#     #  #.# .#o###.# ##  #           #.   #
# # # # # # .#    #    #   .   ## # ###.###  # # #
#  # #  # # # # # # ###  ### # # ####      #    ##
# #    ## # #       # ##    #  #  #   # ##. #.#  #
#   ##    #  # ####  .  .## # # #   ##   ##  #  ##
#.#.   ##  #   #    ## ### .# # # #\ # # .# #  # #
#. #.# # ## ## # # # .#   ##  # .  .#   # .# #   #
# #  # . # .. #   ###   # .## ## ## # #o #    # ##
# ##  .#  .##  .## #  ##  # #   # ##.  ### ##  # #
## . #  ## ####  .. # .  ## # #.#    # #    .#.  #
#..#  #  #  #  .# # # # #       . ## # ..#.#. #.##
##. #  ## .#..# .     #  # ## ####  #. ##   # #. #
# #. #   # # ## # # #  #. #    . # # #  # ####  ##
# # # # #.   #.. #  ##  ##. ####    . # .## # #  #
# # #   ### ####  #   #  .##.    ### ###        ##
# .# ## .. . # # #  # # #   ## #      # .##.#.#  #
##     #.##.# =  ## # #.# # #   # ###   # # #  # #
# ##.#  #   # # #...     #    #   #  =## ...# ##.#
#  #  #. # #  ##  # ## #. .##  # # .# # ## # .   #
##   # # .  .#   ###   # # # ## # ##     #.# # ###
#  #. .### ## # # #. #    # ..     ## ##     #  .#
# #.#.#.     .    #### ## # # #####  .# .# #   # #
# #.  #.###### # #     . # # .     ##   # ## #   #
# #.#        #.### # # # .   # # #.  # #  .  ## ##
# #   ## # #.#     #   ### # .#.   #    .# #  # ##
#.## ##.#  #  # ##  ###  ## #  # # ## ## #  ##.# #
#   #   .####. # ##..  #=    #  #    # # ###     #
# #  #.#= .### #    ##.  # # .# ## ##  .     # #.#
# # #   # # # # ## #  ##. .# #   #    ## # #.# . #
# . ## #   .#   # #  # . #     # # # #   .# #  # #
# #  #   # #  #  . # # #### ## #. #  # # #..## .##
#  #  ## ##.# #.##    .  # #.##. #  #  . ##    # #
### #  o        ##.# ## # .    # # #. ##   # ##  #
#.    #.## # #.# .## .#. #.###  .  # #.  ### ## ##
# # #    ..  # ##    # # #   # # ## # ##      .  #
#  ..# ## ##    #.###  # .# #  ##       .## ## #.#
# ## #   #   ##  #  .#   #   ##   ## # #.# #     #
#      #. ## #.#. .# # #.  #    # #  # #   %.## ##
### ## ### .    .#       ##.#.# #. #    ## #   # #
#  ..#  . .# # #  ##.# # .  # #  #  # #. # # #.# #
## #   # # #    #   ## ## ##    #o# # ##  .# #   #
#  # #  .#   ## # #     # .##.# # . #   .#   ## ##
# #  ###   #..  #  #.# ###   #   ##   # #  ## #  #
#  #   # #  ###   ## # ### ##  #   ##  # # ##  # #
# ####.# ##    #.#   #. #..###   #    ## #    # ##
# ##..    # #####  #   # # .# # # # #    ### #   #
# .  # ## #    # ##.# #  ..## #   .   # #  . ## ##
## #   # .  ## .     #  #.#     # #.#     ##     #
##################################################
