###############################################################################################################################
#  # ##. .   #. ## #   #   .# # # # #   # ## #          ### #    #  .#  #     #  # #  # # # #.  # #.  #    #   ##  # # ### #  #
##.#.  # # # .#  .  ##   ##..    .  .## #.     #.# # # #.#    #### # ##  #.## ##.. ..#. # # # #.#.=## #.### ##  . #    .#    ##
## # ## ###  # ## #.. ## # ###### ### #. # # ## # #.# #.  #.# #   ##    # .. . #.# #.#.# .# ##  # # .         # #. ## #   # # #
# .. ..  # #  . ## ##  #.#        #... #   .##     .   # # ## ### . .# #.### ## .# # # ## # .  # .#.# ## ####. ## # # # ##.   #
## # # # #.. ##.     # #  ### #.# # ###### #  .###### #.   .  ..# # #.. . ... .# .#.#     # # #  #  # .#    #.#   # # #   # # #
#  . # # # #.  # #.# #. # . .# #   .   #. .#.##    .#.#.#.##### #..#.# # # ## ###   . ###.# ## # ##. ## ### #   ##  ### ## .# #
## #..# #. #.## .# ###.#  ##    # # # # .##   #.# #.# # #.#  .  # #  # ##.#  #### ### #.#  ..#.     # .   ## # #   #  .. o#  .#
#### #   #   # # #   .  #  . ## #.   #.# # # ### #   ..# .# ## #   #    #. .# ##   .#.. # ## # ###.# .####.   .# #  # # # #.# #
##  .  ### ### # # ### #.### #  # ## # # . . ##   #.##.# # # # # ## .### ##.  . # #  ##.# .#.# #     #     ## # .# # # ## #  .#
#. ## # .. ..   .# #  #o ..   ## .#   ..## #.. # # # ##  # .. . #  # =    #### # # ##  .  #   #..#### ### #  .###  #       ##.#
## ## # ##.####.#.  #.  ## # # .# ######  #. ###   . .# #. ##.# . # # # #.  .# # #..  ### #### #..  ..#. .# # .  #. .# ###.# ##
#    #.## .... # #.#  # # ##### .     .  # # #.  # ## # #.# ## ###.. #  ##.# # #  .##  . .  .   ##### # #.# # ## # # # # #.   #
####      ## ##. #. #.     #.#  #### #####.# #.#..# .# #  # .    . #= #.  ## # #### # # ### ##.#.. .. #  # .##.#.# # # #.#.# ##
#  ## ####.#   .#. # .######.## #..  #.    #  .# # # # #.##### # ##  # ###       .  . ##..   # # # # ##.#  #.# #.# ## #  # ## #
# #   #.  .  ## # # #...      .# ### # # ###.# #.  # #   .#.   #.#.# # . ..# ## # ## #  #### # . # .#..  ##  #.# .      #.  . #
# ####.# ###  #.      ##.### ##       ##. .  ### ##.  ## #. ## # #. .  ####.#  ##.  # # .   # # ###  # ##  #\  . ##.#### ## # #
#  .  .. # #.###.# # # #.   # # ### ## .# ##.   ##..# .#  #. # .# ## # #... # #   # # #.### #. . #. #     #  # ####.   #     ##
#.# # ##   .### ## # # .# ##  .  . #  # #. .# # # # .#.#.#. #  # . #  # # ##  # # # #   #.#.#.##..#  #.# # #.#  .# # #  ## #  #
## #.#.### # #   . ## #     #.# ## ## # #.# ###  .  # ## .##.# ##.# #.  # ## # # ##.# #     . #.## ## ..## ## # #  # # #   # ##
#. .  . .  #   # #  . ## # # ##  ## . .   #    # ##.. . # .  ..     ##.#    .. #   ##.##### ###  . ..## .   # #   # # . # ##  #
# # # ## # ###. # ###.... ##    # . ##.##.## ###  #.## ## # # ###.## .   ## ### ##    . . #  .  #.## ## # ##  # ###.###  #. ###
#. # # ###   # ## # ## #.# .# ###.# # .#   .##   #  # # . ## # . .#  ####  #      ## ### #  ####.# #  ..# # # #        #.  # .#
##.#     ..# .# .    #. # .#     .#  #  #.# .  # ##.    ##.. # ##  #   .  # ## # #### . .# #   ..  ### ###      #.#####.### #.#
# ..## # ## # ## # #.## # #  # ## .# ## # .# # # ..# ## ..## ..  ##.# # #   .# # .## ### #.# ### ## . # #  ##.## # .. .    .  #
# # ##.#.#.. # #. #.    .  #.#  .##.  .#  #. ##  #. #. #.#  # #.#.#   #### # # #.#   .   #  #     # ##.  #   #     ####.#.##.##
# # .. #.# ###.# #. ### # ## ### # # ##o#  #   ## ##  #   .#  #=   #.#  #  #     .# # ## # #. ###%    ## #.## #### #.  #.# #  #
#.# #.#    .   ..###  # #..   . # .###  . #  ##    ##.#### ## # ##. # #.  # #### ## ## ### # ##.### # .         .   #.#.    # #
# # ##. ## # ### .  # # .# ###.# .#  . ##  ##.# ##.  . .   .# ## ##    ####..  . .  .. . ..# # . .## # ### ## # ## #  ##.#.# ##
#. #   # ## #. . ##   # ## #    #  .##.#. ##  # # ### # #.##.      ### #.  ### #### ## ##.#  # ### # # #.. # # # ## #    # . .#
# #..# #    #.##  # ## #   # ##  ## #  # #   ## #. ..# #.#  ### # # . .  ##  # .   ## # # # # .      # # ## .     #  # ##. ## #
#.##.#.# ## ## # #  #  #.## #   ###  # #### #   .# #    .  #..  # .### #    # # #.#.    #  #  # ### #...# .##.# #.# ##. #.#   #
#.   .###    . # ##  #   ## # #  #  #.  .# . ## ###. # #.##  # # # # #  # ##      # ## #  #  #  #. #. #  .# . # #  .# .## ## ##
## # # #.## ##    # # ##  . # # #. #####..# #  .##.## # .#.#.  #  #  .### ## ##.# #      ## # ### # ## .##  # #   # # #.  . ###
#..#   ..# #  # ###.    # ## #..# # #    ## .##    ..  #   . #.  # .#. .   . ..# ..# # #  . .    .    ##  ##  ## # . #..###..##
# #..##.##.##  ##.  ## ##    .#   . ##.# # #   ## # ## #.#=#   # ##.#.##.# # # # #. .  ## ## ### ##.#.# # .  #.#. #.# #.  .#  #
##. #        #    ##   #  ## # # # #   .. =  ## ##. #  ##.## # .# . .## # ##  # .  # ## ##.##.  # .#. # #.## # # #  #. #.# .#.#
#. #  ## # #.# ## #  # # #.### #.##..## #.### #   # .#      #.##.##.#   ..  ##  # #. ...   . .#   ### ..#.#  #.   # ## .  #  ##
## # # # # #.#.  # # ## . . .  #   ### # . .#.## # # # ## #     .  #  # ### #. ## # # ### #### ## ##  ## # # ###### .# ### .# #
#   #  #.#.## # #   ...# ### # # # # .  #####    #  # .  # ###.### # #.#.    # #   #   . #    .  #   # #    .   .  ##  #  .#..#
## #.#=  # .  .#.## ###  #  .#   ## .##.  ... ##   # # # .    #  #. ## # # #.  ## ## #### ##.###  .##  ## # ## # #.  # # ###.##
#  #  ## #.## #    #...# ###.# ##. #. # ## #### # # . #.# # # # # #.#   . # ### # #   . #   #  # #. .#... #...# #. #.### #   ##
##.#.#.. #  # # ###.# ##    #  .# #..# .# #.     ### ##.# .. ##   #. # ####    =#  ## #   ### # ## # .###  ## #. # #     # #  #
# ..  # # .# #. # # #....##  # #   # ##   # ## #..#  #. # #.# .# #..#. ..  #### #### .# #    .#.#  . #  # #  #  #   #### # # ##
# ####  .#....#     # ### # #.  ## #  # # #  .#  # # .# # #  #.#  # ###.# # .     . #  #  ## #   # #  .#. ## ## ## #  . .#.#.##
##     #  ## ### ## ##   .. ## #     #   #. # #.#  # #..  #.#  # #  .  . ## #.# ## # # ## ##.##.# # ## ##      .  ## # # ##   #
#  ####.###.. #. .# .# ## ## .  # ### # #. # ##  # #.#### # # ## .#.# # #. # ##.# #..# .   .#.  ...   o  ## # # #  .## #   .# #
## #  .  . ###. # #.## # . .# ##  ..  .  ##    # # #   . # #. ..#  #..# ## #  .    # # ##.# # ## # ###.# # #  # # ## .  ## ## #
#. .#.# #.##.  #. #      ## ##  # ### ## ## ## # # ####.## # ##  # ##.#  . # ## # ## ### #=  #= ## #  .# . .# ### #.# # # . . #
## #. # ..   ##.# # ## #. #. ##. ..     #  . #      ... #. .  # # .   .#.#=  # # #    .   # # #  . ###. ##=###..  . # .#.##.###
# # # # ## ## # ## #   ## #.#.#.## ## # # ## # #.##.##.# ## ##... # ## # .#.#  .   ## ### . #   # # .##. # ##  ## ### #       #
# .    # #  # #    .##  # ##. #  ## #.# .. ##  # . #  #.     ### #  #  # ##   # ##.# #    #  ### #=#=  # .# .# # .   #  ## ## #
## ##.#   .##.  # ##.### # #.#  #    #  ##   #.# ## # ## ## #  ..#####. #   # #. # #.#### #.# . .   ##.#.# #.#  # ## # #  # # #
#.#   # ### .## ## #     #.  ### ### #.#   #.# #   . .. ###  # ## . #  #  #  #  # .#.     .  ## ###    #.  # # # #.##  # #.  ##
# ###.#   .# ..    #### ## ##          ### .#  # ## ## # #. #..# ##. ## #  # ## ##   #.#.### . #. # # # .### # # #  ##   . #  #
#. .   .### # ## ## . . .  #. ########. . # # ## #  # .  ###.#  . ..# #.####. #.  # # ## .  ## # ## ## # .   # # ## .  ###.# ##
## # # #        #. # ## ### #   .      # #. ##   .#.# #.#      # ##. .     .# #.### #    ##  #   #   #. ## # .#.    ## # . # .#
## # # # ### #####   #  #. .#.# ##### #  ##  .## # #  # ## ## ### ## ###### ### #   ##.#. #.#.#.# # ## # . # ## # ## . # # # ##
#  ###   # ..# .#  #  # # ##  ##     # #   # #  .# . #   .# .#.#      ...       # #  #  #.#  .# #.. .   .##      #. .#  # ##  #
#.#    ## # #  # .# # # #  # #   ##.#. .# # # ## ## #..# ### . # ### ### ### ## ##.# # #. # # #. ####### # # ### # # # #  # .##
##  ##     #  # ##...# . # #. ##  #   ## #    . #  # # # .##.# #.# # #. #. ## #  . # #### # #  #.  .     #  .# #.#.##  #.#.#  #
# #  # ####. #  . .## #.##.# # #.#  #    # # # ##.##   #.#  # .  #   # # #.    # # #.. #  #.#.## #####.## #### #  #.## # #.## #
# # #..    # ####.#.#.   . .   # # #  #.#  # #      ##.# .#  #.# # ##    #### # .# .# #.# #.###.  .  #         # #.    . #  .##
#. .# # ## .    . #  ## # # ## ## .## ##.##  # ## ###.# .#  #.# ####.# #   .  ## # # .# .#    .#.###.# ## # ###. #.# ##.##.# ##
##.#.#  # ## # ##   ### ## ## #  #.  .  .  ##.#.#.#  ..# .# #    #...# #.# ##   #. .#. .#  ###.# #  #. ## #    #  # # #    # .#
# #   #    # .#   ## #  .    .. # ## # # ##   .     ## . #    ##.# ## # # #   ##.##   #  # #.#.# # ###. .#  # #  #  . # ## ## #
#  .#  ## #. # ##     # ##.####  . #. ##.   # # #.## ### ## ## ##   .      ## .  . ## # ##.  # # #  #  ## #  # # # # ## #.# #.#
# # #.#  # ###    # ### #  #   ## ## ## ###  #.### .    # ...    ## #.# ##..# ### #     # ##.# # # # #    # #  #   # #..#.  # #
# # ### #     #.#    .   ### # .#    #  . . #   ## #.# #  # # ### # #.##.  # .# # .## #.     #.#  .#  ### #.# # ##..# ### ### #
# #     ## ### =# # ### #  . # # # # # ### #  ##    ## # # #.     #.#  # # .#   # # #.# #.## #   ## .#  ###  ..   # .        ##
#. # ## .. #  #. # .#   #.## #  .# #  #   . #  # # #     # ## #### #.#.#.# ## ##     #  # # ..###. #  # .  .###.#  ## #.# ## ##
# # # .# ### # #  # ## # .# ## ## #  #  ### #.#.## # # #  .  ## .    .#  # # .  # #.# #  # #.#.  # # # ### #  #.### ### # #   #
###  #       #  ###. #.###   .   . #.##..  #  . . ## ## ## ##  # ##.#### #  # ## .#    # .    # #  #...  # ##.# . # ..  .#.# ##
#.. #  # ### .#.   .# ...# ### #.#= #  ## #### # #     .. #  #   ## # #  # ## #  # # # ### #.## ## # #.#   .# ##### ## ##.   ##
## # ## ##.# ## # #.# # ## # #  #  # #    .# ### #.### # #.#  .##  .   # #  .  # # # .#  ## ##   ..  #..## #.    . . .#   ##  #
#.  . . .  .   ..#   ###  .#   ###   # ###    . .  . ##  #.. ##.# # ## ## ### ##  ..# .#  # .  ###### .# ## ########## ##   # #
#.## ## ## ##.##  # #.# .# .##. # # ### . ###### # ##  # .##   ..###    . .  .  # # #.# # ## #   .  ####         .   .  . #.  #
###.  ## # ##### ## #. .#  # # #  # ## # #     # . .# #  # ### #  # ### #####.#  ##.#  .#.    ##.# #  .  ##.## ## ### ## #.# ##
#  .##...   # #  #  .## .# # #.##   ..   ## ## # ##.   #    . #  #     .  . ## ### ## ##. ##.## #  ## ### #. #   #    ##      #
# #  # ##.###  # # # #  #     #   # # # # #   # .#  # ## ### #.# # # ###### .   .     # # . ##.  ##  =    . ## # # ###  .### ##
## ##.#.#.   .# .#.# ## .## ##.=#   #.#    .## # #.## #.  .#   .  # #     # # # # ### # # #.#  #. . #.# # #.#  ##    ##.# .## #
##. .   #.#.## #.#.# .# # #.  # # ## #.# ##      .#     # ## ## # #. # # # # # #.       # # # #  ##  #  #.#= #   ## # #.##  . #
# .#.## # ##  .. #.  #    # # #   .  #  # # ## # #  #.####   ..#  .# #  # .    # ### ## # # ##.# # #   #  ## ### .    #  . ##.#
# ##  # .  . ## # .#  # # #.#  # # ##.#     ### ###  #  #  ## # .# # #.#  ### ##  .#.  ## #      #  .####  #  . # # ## # #  # #
###.##.# #### #  # # #   # # #..###. . ## ## ##  # # ## .# # #  # .# #  #       # ## ##   ##### # ## # #  #  ##. #   # .#  #  #
#. . #  #  .#   ##   ###. .  . # # # #   #     #...# . #  #.  ## #.#  .#  ##.## # # # . #      #   #.#  #. # #  # ##  #  # ####
# #### #.# #### #. #   .# ### #    ...##.# ### # ##  #.  # ##     #  # ##. # .  #   . #.#.# ### #.#    #  # # #.  .  #  ## .  #
# . .  .   ## #  #  ### .#. #. .########.#.    #.# ##  # .   .# #. ### .##  ## #.# # # .## #      # ##  #   . # # ## # #  #.# #
### ##.# # .. . #  ##   # # .###  .   #..# # # # #.# .# ## ##. #. #   .#   ## #   #   #. ..# # #.## #. #.# ##=##. # .# # #### #
#   .#.## #.# # .### ## # # #   # #### #   #.##  # #.## ##. # # .#. ## #.#      #  # ### # # ##  # . # # ##    .# .# .  . #   #
#.### . #  #.# #.            # #        .## #  #   # #.    #   # ##.  .# #### # ..#..####   . .## .#.# # .# ##.#. ####.# #.####
#.#  # ## #. #  #### # # ### # # ## ## #.  . # ##.#   .#.# ..##   # #.##.   ##.#### #.## # ###   ##.## ##.#   # #  #  ##.  .  #
#  # # #...#.. #     #  #  #.# #.# .#  # ### #    .# ##.## ## ###  . #. ## #  . .       . .#  ###  .    # # # #  .###   # ## ##
# #.   ###.#.#..# # #.# # #  # #.##  ##. #.# # ##.# .  .  # .  . #.# ## ##.#.## ### # ## # #.#   ## # #  . #  ## #.## # #.. # #
#### ## .. . #.##   # #  ..#.#  . . ## ###    #    # ## #.##.# ## ##.   .  #  ###  # # # # #..# #  #  # ##  # . # . .    #.## #
# # .. ### ##    .##  # #.#  #.## #.     ..# #. #.#  #  # .###.##   # #.# #. #    #. . # # # #  # # #  .. .#.## # ####.#  .#  #
# #.###  #  # # #    ##  # #.  #. # # # ##    # # # # ## ## .. .. #### ##  #=  ##  .### #. . .#   #.# #### #   # #   .# ### # #
# #..  # #.#  # # #### #   # #  # # #  ### # #   # . .  .. .# # ##  #  .  #  # #  ## .. # # #  ## # .#  . .  ##  ..##    ...  #
# # # #  #..## # #. . .## #  ..#  #.# # #  ## # # .## ###.# #  #  .### ##  # #  # #  ##   #.#.# # # # .# ###  # # # # ### # ###
#.# #  # . # ..   ## #.. #  ##   ## #.   #  ..  # # .....#. # #.# # ##..# ##  # #  #  #.##. #. ..    #.#  . ## ###  . #  #. #.#
#   .# # #  #.###  #.# ## # #.# #..  ## ##### # . ####### # #.       ..# .  .#.# #### #.  #  ## ##.#.#.#####..  #. ##. #  #   #
## ##   ## ## #  ## ##   .#  .  # #.# ##.#  ###.#.    .   # .## ## ## #####.#      #.# # ## # ##  ## #      .# ## # # #  #. # #
#  # # #  .    # .. # # ## ### #  #  ..#.. #.   # ## #.# #  #.    #  # #  #  ##.#.#    .    .    #  . # ### #  # .  #.# # ###.#
##  .# # #####..## #  #.....   ###. ##.# # # # #. ## ##  .#..#.##  #     # .#  .    ### ## #.# #  ## ##   #  ## # # #.#... . .#
#.#.#   #    ## #. # # .## # ##  .# #.#  ...## ###.    # # ##.##.# # ## #  ###.## # . #. # ##.## #  ....## #.   #  #  # # #####
#  . # # #.#. .   # ..#.#. #  # #.    # # ##..    # ##.# #        #  ##.###.# . #  ## # #.  .  .# #.###.   #.##  ##  #.#      #
#### . #    # # # #.### #.#  #.# # ##. .##   # ## #.#..# # ######. .#      . .###.##.   #.### # #   #. .# ## #  #  #  . # ## ##
#    #. ##.##.#. #  . .  ### #..  . #.##  #### #. #### # # #    # ###.# # ## #  ..#  ##  ## . #####.#.###    .# # #  ##  #  ###
# ## . # ##.  .# ## ## #. #.  ######..# # .    ##.  # .#.  #.## #  . . ## #   ###  # # ##..#.# .#. ##     ## # .# .#  # ### ###
# #. #.#  .##.### .  .. # ##.#      #     # # #  ### #. ## #  #.#.### #  .## #    #.      #    # # #.##.##  .##  #.# ## ##   ##
#=# #### #   #.#  # ##.##  # # # # #  ## ## ## #       ## #  #  ..   ## ##  . .###. ## ## .### #    . # . # #   #   .#   .#.# #
# #  #   # ##   # #   #. #  .# ##  ##.# #  .  .  ##### #    # ###.##   . # ##.#.   #.# #  # .    ##.## .##   # # # #. #.##    #
##  #  ##. .# ##..# #   #  #.#  .#  # # # ##.###..  .#. # #.#  .  #.## # #. ## # ###    # # # ####.. .#  # ### # . # #     ## #
# #  ## ### #   # ##  ##.# # ## ## #  # #  .#   # ##  .# #..# #.##  .  # # #   . .  ## ##  # #   . ## . #  #. # # #.#.# ##  # #
# . # .   . # ##  . # #  . #. ##   ##  . .# # ##.# . # #  #  ### .# #.##    #.# ## # # ..##   .# #.# ##  ##  #.      . ..# #  #
## # # ## ###   #.##   ##.# #   #.#  #### # # #  # # .#  # ## # .###   . # #.#.  #   # ##   #### # #.#.##   #### # ##.# ## ## #
# ## #. #.#   # #.#  ##  ## #.###.##    #      # # #.## #    .#.# # ### ## .. # #..###.# ##..   #.     .  ## # #   . ##.  #  ##
#      ## #.##  # ##.#  #       .   ###   ### #  #.#..  # ####      # .# .## #  ## #  .#   ## #  # ## # # #.  . #### #  # # # #
##.## #  ##.# ## # #  # . # ## ## #     ##. # .# # #.# #  # ..# # #.##. #  # ##  ##  ## .#.  # ## ## # #   ####     # # #=#.# #
#  #  ## #.     =    # #### .#   #  #.#    # .##   # ## # ## #   ##  #.## #  ..#  .# #.# # ##  #  ..    # #   #.#.# #   #     #
## ##    .# #.## # # # #..  ###.# #  .## #. #.  # #  .    .# #.##   ## #  .#.# ..#.# .   # ###   # # #### # #.# #.##  # # ## ##
#. .# #### #  # ## #    ###. #  # ..# . # .#. # # .# ## ## #  .   # #... #.# . ##   ## ##  .#  #   #  ..  . #. .   .#.#.#. #  #
## #. .  . # #  .   #.# # # #  #  #  # # ## ## # .# # #  # ..#### ### ###    #.# # # # .####.##.# # #.# # #. # # ## ## ## # # #
#.#  ## # ## .# ## #..# # # # #  #  #  . .      #     .### #    # . .   .#.### #.  #..#      .   #  . ##.# ##.  ### . .  .# # #
#   ### #.   # # # # ##      #.# .## ## ## #.##.  #.##    ##.#### # ## ##. .     #.## # #.## # #.####     .  ### #  ### ##   .#
# #  #  # # #     . .   ## #. . # #  .    #   #.# # .# ##  . #    #..# #. # ## # .    # =#  ..#  . . ## # ##  .  . #   . .# # #
###############################################################################################################################
