##################################
## ## ##.#.## # .# #   .# .  #.# #
#.  .. ..o ..  .## . #.#..## . # #
# ##.####.### # #  #.# ### #.#.# #
#.    .    ...  .#  . .= ..  ....#
##.## # #.#.# ##   #.#.# ###.# # #
#  #    ... #   .# ##..#  .  . # #
##.# # ## # #.## #  .# # #.###. .#
##.## ##.#.## ##.# ###.#.##   .#.#
# ......  \  ..  ..#. .    .##o .#
# #####.## ##.# ## #.## ###.##.# #
#  . ..  . .  .. . ..    .... . .#
###.##.### ###.#.#.# ## #####.#.##
#. .. .. .. .   . .... ..  .# #. #
# #.###.### ### ## ##.#.# # #.#.##
# .... . . #..   #. .## . ..# # ##
#o# # #.## #.# #...#.# .## ##%#..#
#.  ###.#. . #.# # .  # ..#...#.##
#.#.. .  # #   # # # ## #.###.#.##
#..####.## # #  #  # .. #.  # #  #
#.# .     .   # .#  # #.#.# #. =##
## # ###.#.# ## ##.#.#.## #.#.# ##
#  .......  ..     .   .  ..  .. #
#.# ## # ## # #.# ## ### # ## # ##
# .= # #.## #...#.   #.# #.#o.#  #
# #=##.# ..   #  .#.# .#. . #.#.##
#. .  .. ##.# # #.#.=#.#.# #. ...#
###.## ##.## # ## #.## # #  #.#.##
#.  . .. .=...... . . .# . #.##..#
#.#.# #.# ##.# # ##=##  .#    . ##
#.## # # # ## #.#.## # ## ##### ##
#. . ..   .    .. .      .  .  . #
#.## # # # ## # ## # #.#.#.# # # #
##################################
