######################################
# . # ##    # # # .# # # .  .#   #.# #
# #    o=##.#.   #.#   #.#####.###  .#
# # # ##  #. ## ##  ## # #       . #.#
#  #  #  ## #  \  .#.   .  # ## # # ##
# # #. #=  ## #####  # # # # #  #    #
## ..# #.# #. #. . #  #.## ## # .# # #
# ## # # #. #. #.# # #    . . .## # ##
#  #  ##  ### ## .#.## # # # #       #
## # #  .#. . # .#     # ### # # ## ##
#. # # #   #.## #  #.##= .   #  #    #
## #  #  #.##    # # # ##%# ## #o#####
## # # # #  #.## # # # # # #= o      #
#. # # ### #   .#  # #     ### ##### #
## #     .  ## # # #  #### .    .   ##
#.   ####### # # #.# #  ..# ## # # # #
# ##     .  .  . o  #.#.##.# # ## ## #
# #  ##.##=#.## # #      .   #    .  #
######################################
