######################################################################################################################################################
# . ## # #.# ##.##.# ##.#..  .#    .... ..  .. # #.# # ##.#.#  . .. ...  ... .##...# #.#.. .. . . .... ..  . . .......  . . ..... . ... . .     . ...#
#.#..  ... ....  . ..  .. # #. # ## ##.# # # #.   . . ..     .#####.#.#.#.# # .. #... ...#.## #.#.#.## # ##.# #.#.##.#.#.# # #.# # #.#.##.# #.#.### ##
#.#.##.#.#.#.# #.#.#.#.## #.# ##.##.##.#.#.... #.#.##.##.#.##.#..  ...#.#.#.# ##.## ##.#.#. . #.##.# .  ... #.# #.. .  .. ...... .... . .... #.#  # ##
#.. #..  ..   .....   . . . =. . ..   .....# # #. . .. .#...#...### # .  ...... .. . .. .  ##. ...   #.## #... .  #.# #.##.# #.#.# # #.# # #   ..#.  #
#.# . # ##.#.# #.#.#.# #.#.# #.#.#.## #.##.#. .. # ##.#...#.. #..  ...#.## ##.# ## #.#.#.# ##.#.##.#.#.## # #.# #. . .... ..... . .#  .#.  . #.#  #.##
# ..#  ##.#.#. ..#.#. .....  .. ...##.... .. #.#.## #.#.# # #.# # #.# ... . ..# ##.# ... .. . .......     ..  #.#.#.##.# # # # # #...#...#.#o#.# ##.##
# #..# ... ..#.#..   #.##.#.##.# #  ..#.##.# # ........   .....   .. .#.# #.#      ..#.#.#.##.## #.#.# ##.#.#  ...  .  . .. ..... .#   #...... ... ..#
# ..##.## #.# .. # #...  ...  .. ..##. . .. .. # ##.##.##.# #.## ## # ...  . .#.##.#.# #.#.#  .=##  .##   #.# ## #.# #.#.#.#.#.#.# . #.#.#.# #.##.#.##
#.#. . .  .  #.#=#.# # # # # # # #  . ##.# # # . ... ..## # #....  . .#.# #.# .... ....  ...#.#... #. ..#.#.  ##.... . .. . ...   .#.. ....  ..#  #.##
#.. ##.# #.#.  ...  .#... . .. # #.##.#.##...#.#.##.## . .. ..#.#.#.#.# #.# #.#.## ##.## #.#..  ##...## ... #.   #.# #.#.##.#.# ##...# #.# # #...#.  #
# # ##.##.#.# ## # # . # #.# #....  .  . ..#    . . ...# # ##. ..... ...   . .. ......... ..# #  ..#.##.#.# #.##.# ..# #.## #.# ## #.... ....# #.##.##
# . . ...  ..... ....#.## #.##.#.#.#.## ## # #.# #.# #.  ..#..# ## ##.# # #.#.#.## #.# # ##. ...##.#....  ...  #   #.. ..  ...  ... .#.#.#.#.. ......#
#.#.##.##.#.# # #.##............     ...... .#.# #.#.# #.# ## ## ## #.#.#.#.#.# # ##.#.# ##.#.#..  . #.## #.# #  # #.#.# ##.# #.##.#.#.#. . .## # #.##
#.. .  . .. .   .... # ##.#.# ##.#.# ##.##.#...  .. ... ..  . ..  .. ... ... ... ...    . ......##.#..  .   ...#...  .......  ......  ...#.#....   . #
#.#.## ## # # #.#.##  . ...... . . . ... ... #.## #.##.# #.# # # #.## #.# #.##.#.#.# #.#.## #.#.   # # ## # # ##.# #.#.# ##.#.#.##.# #.#.# #.# ## #.##
#.. ##.# ##  ......  #.#.##.# ## #.#.## ## #.#.##.# ##.#.#.#.###  .. . ...# ##...# ..  .  ... ..##... ... ..  ....  .#.##.# # #.## # #.#  . ....#.#..#
#.# . ...   # # # ##.# . .. ... .... .  ...   ........ . .....  .##.##.##.. .  #.=.#.# # ##.# #. #.#.##.#.#.#.##.#.# ..  . . ....     .. # #.# #. . ##
#.# ##.#.##.. .    . ..#.##.# ##.# ##.# ## #.#.## # ## #.#.#.#.#.#.# # ##.#.## #.# #... ..#...##. . .......   ..  .. #.## # # #.##.# # # . ... .# # ##
#...##. ..#.# # # ##.#   ... .... .##.. .  #. .. . . .  .   .. .... .. .. . .#...#...#.# #..#= # # #.#.##.# #.# ## #.#  ... . ...  #.#.#.# #.#.## #.##
#.# ...# #  .. ..   . .##.# #.##.#.. .# ##.. #.## # #.## # # # #.# ##.# #.#.#..#...#   ..##  .#.  .. .....#.....  .  ..#.##.#.# ##  .....   .... . . #
#   ##. ..#.#.# #.## # #.#.# # # #.##.# ## # . ...  ..## ....  .  .   .. ....#  .# . #.#..  #..#.#.#.##.#.. #.# ## ##.#.##.# # #.#.#.#.#.#.#.# ##.#.##
# #.. .# #..#...#.#....=.... . . .... . ... .#.## # #..  #.##.##.#.## # #.# ##.#.# #. . .## ..##.#.... ...#... .  ... .  .  .  ... .......  .    ... #
#...##. ..# ..# . .#.#.#.## ## ##.## ##.##.#...#.. .#.##.. .... .... . .  ...  .... .# #.## #. .  .# #.##.#.# #.## #.#.#.##.# #.## #.#.##.##.#.##.#.##
#.#... #.#..#. .#.#..#.#..   # # #.# .. . . .# .# #. . ..#.## #.##.## ## ##.## # #.# #.... .  ## # .... .  .# # ....   #... .#  .. . ... .  ....... .#
# # ##.#.## #.# #.##.  . #.#..... ...## ##.#.#.##.. # ##... .. . .... ...  .  ...#   ..#.##.#..... # ## #.#.  ..##.#.#   # # ..# # #.#.#.#.#.# ##.# ##
#     .. .   ........# # . ..#.#.# # .   ... .  ..#.. #. ##.##.# # ##.# # # ## # . # #....  . ##.#.#.##.#.# #.#.  .... #.....#  ... ..... . . ....   #
#.#.##.#.##.# ## # # .   #.#.....#  .# #.#.#.# ##  .#..# # ......# .  # #.#.## #.#. .. # ## # #...    ... ....#.##.# #.#.# #.# #.# #.# #.# # ##.#.#.##
# . . .. . ..  #.#   # # #.#.# # #.#.# # ..  .  ..#...#...#.##.# ..##. ...  . .  . #.#  .   # ..##.# ##.#.# #..........  . ... .  .  . . .. .   ....##
#.# ##.#.##.#.#. ..#.. .... .....   ...  # #.#.##.# #.##.## ## . # ##.# # # ##.# #.  . # ##...# ## ..  . . ...#.##.#.# #.#.#.#.#.# # #.#.#.# # ##.#..#
#..   ...   ..## # # # #.#.#.#.#.#.## ## . .   ##  .. ....  . .#. ....  .   .... ..#.# .... #  . . # ##.#.#.#\.  .. . . .. ........ .... .. .    . .##
#.# ##.#.##.#..# #.....# ##.## # ##.##.#.# # #. ..# ##.#.#.# #.#.#.#.## #.#.## #.#. ...# ##.. #.## # ##.# #.# # #.#.#.# # # ##.##.##.# #.#.#.##.#.#. #
#......     #.#.   #.#. .. .. . . ....... .. ..##.#   ...... #. . . .   # ..##.# #.# #  .  .#... .... . . .... ..  .#.  . # #.#.#.#.#.## # #.....   ##
#.# ##.#.##.. .#.#. ...##.# #.#.#.# ##.#.# # #.# .. # ##.#.#.. # #.#.##.. # .   .. . . #.##  .#.##.# ## #.# #.#.#.#.. #.# .....  ...  ... ...#.##.#  #
#  .. .   . #.##.# #.##.... ...o .. #.##.# ... .#.# # #. ....#. ....   .#.  ##.#.#.#.# .. . #. .##.#. . ..... .  ...# #.# # #.# #.# #.##.# # ...  ..##
#.#.## # ## .  ... #.. .## ##.#.#.# ..  . .#.#.# .  ...#.#.#.#.#.#.##.#. .#... . = #.#.#.##.. #  . . #.##.# # #.#.#  . . . .. . .... .. .. ..# ## # ##
#.  ...##...#.## #.. ##. ..... .  # ### ##.#    #.#=#.#.. ....... .. .. #...##.# #... ...  .# . ##.#.# ##. ...#   # # ## # ##.#.## #.#.#.#.# #  ..#..#
# #.## ...#.. .  #.#.##.##.##.#.#.   ...##.  #.# .... .# #.#.#.# #.##.#. .#.  .  ..# #.#.##...#.## #.. .  #.#...# ... ..  ..... #. . #.    # .#.#.  ##
#.#.   ##...#.## ...    .    # ##.#.# # .  # ..##.#.##.#.#.# #.#.. ... .#.  ## #.#...#.#.##.#   .... #.##. ...#.# #.# ##.#.##.#. # # . #.#. .#.   #.##
#...##.  ## ##.# #.#.## ##.#... .  .   .##...#  . ... ... .. . .# # #.#...#... ..# #.....  .  ##.# #.##.# #.#  ..   . ..   ...  #. . #.. #.#. # #.# .#
# #.##.#.....  . . ..##. # #.#.##.#.#.# ...#  .##.# ##.# # # #.#.    .. #...##.#.  ..# #.##.#.#. .. . ...    .#.#.#.#.##.## #.#.# ##.# #  ...##  . .##
#  .. .  # #.# # # #....# . ... .. .    ##.  #. ..#  #...#.# # #.# #.## #.#.##.#.#.# # ..#..#.  ## #.## #.# #.#.# ... ... . .  ....  .. .# #... # #. #
# # ##.#.. . .   ..#.## .#.# # ##.##.##.. .#.  ##. .#. #.. . .. .. ...... .. .. ...  . #..# ..# .    ... ... ... #.#.#.# #.##.# ##.#.#.#    .##  ...##
#.#   ...##.#.# ##. . . #..## # # # ### ## #.#..#.#.## #.## ## #.#.# ##.#.##.## ##.# # . ##.# .# # # #.#.##.#.# # ..... ....  .  .... ...# #. . #.#.##
#. .##.#.## ... ##.#.##. # ....... ......# . ..#..   . . ##.# ##.#.#.#.## ## ##..#  . .#.. .# ##... .. .     .#.## #.#.#.# ##.##.#.#.#.# .. .## ... .#
#.#.. ..  ..# #  .......#  #.##.# #.#.# # .#.#  # # ##.#.  .. .    . .   ..    .#. ##.## ## ...  #.# #.# ##.#... ... .   . .  .        ..#.#.# ## #.##
# # ##.# ##... .## #.## .#  .  . .....  .#.#   #..# ##.# # #.## # ##.# ## ##.## .#...  ... .#.##.. ... .  ..  #.#.#.# #.##.## ##.# # #.#.. ..    .. ##
#..  . #.##.#.#.## #....## #.#.#.# #.# #    .#..#.... .. # ## .  .   ..   ..  . #..# # # ##.. ...# #.# #.##.#.=..... ......  .     ..... # # ##.#.#..#
#.#.##..  .. .  . .. ##. ............ . .#.#.#.##.#.## #......#.# #.#.# ## # ##.##.....  .  # ##...  .. ....  #.#.## #.##.##.#.#.# # #.#.# .. ... . ##
# #. ..# #.### # # #.## ##.##.## # #.# # #.#   ... .## # ##.# . #.#. ......  . . #.#.# #.##.#.## #.# # #.## #...# ##.#.## # # #.#.# #.##.# # ## # # ##
#.#.##  .# ##.## #......... ....... .  . ....#.##.# . .. ##  .#.. .#.#.# # #.## #   .    ....    . ..  . .  # # . .. . .. ...  . ......  .  . .  .  .#
# ... .# .. ... . .#.## ##.##.##.#.# # #.# # # #.. .##.#... # #.# # .# #.  # ...##.# #.#.## # ## # # #.# ##...# #.# ##.#.#.#.#.##.#.# #.# ##.#.#.##.##
#.# ##.#.## # ##.#....  ......... ........ ...  #.#..# ..#.#  . # ## ....#...##..  .. .   . . ..... . ..  # #... . .... . ..  ..  .... .. .. ..  ... #
#.#.## . . .. .  ..# ##.##.##.##.#.# #.# #.# # #. ..#  #.##.#.#    #.#.#...# ##.## #.# #.## # ##.#.# ## #..  .# #.#.# ## #.#.#.# #.## #.#.##.#.# ##.##
#. ....# ##.#.##.# #. . ....  ## #.# . . #... ..# # # ##...  .#.# #  ....#.#.......  ..  ..  . ... . #  ..# #....   ...  ..#... ...... . ..# #.#.# . #
#.#.##.   .    .. .. ## ## ## ..  .  # # . #.#.#... .....# ##. .  .# # #. ...##.##.#.#.#.## # ## #.# .# #....# ##.#.#.##.#...##.# # #.#.#.#. . #. # ##
# . . .#.##.## # #.# ##.##..  # ## #.# #.# # #.## ##.#.#   ## ###.#...   #.#.##.##.# #  .. . .. ##.# #.. .#.##.##.# # ##.#.## # #.#.##.##.## #.# #...#
#.# ##.# . . .   #... ... .##. ..  ... .  .  . . ... . ..#.  . . . #.#.#  .  . ... ..  # ## # # .   .##.#.#.  .. .. . ... .   .  .   .    .. . . .#.##
#  .. .. #.#.#.#  .#.##.##  . #.## # # # #.# #.# # #.# #.# ## ##.#.#.#.#.#.#.## #.#.##.# #.  .. #.##...  ...#.#.#.#.# #.#.##.## # #.# # # # ## ##.# .#
# #.##.# #.# .   #..  ..##.## #.##.#.#.# #.#.#   . .   ..  ... ... . ... .. .. ...  . . .. ## #...##.## # #.... ....#.#.........  ..... . ##.#. .   ##
# #. ......  #.#  .#.##..... ... . .. ..  .  . #.# ##.##.## #.#.# #.#.# #.#.#.#.##.##.##.#.## #.# ......   .# #.#.#...#.#.##.# ##.#.##.##.  .  #.## .#
# ##.#.#.#.#.# #.# #.##.## # ##.#.# #.##.# #.#.. .  . .  ....... ....#.## #.# # ##. #.. .. ... ...##.#.##.#. .... ..#. ... ..   . .  .. ..##.#.. .. ##
# ...  ..   ..  .  ..  ... ..  .  ..   .... .  ## # #.# #.##.## # #.# .............#..## ## # # # ## #.##.#.#.# #.#.# ##.#.#.# ##.#.#.#.#.## # # ##..#
#.#.##.# #.#.# # # #.##.##.# ##.##.##.##.# #.# ..   . ..  .. .  .   ##.## # # #.## .#  ...... . . . ......  ..  . . .... . ..  .  ...... . ...  ....##
# ##.. .  . ....... .. ..  . ...  ..#     .... ##.## # #.## #.## ##. ..# . .. ..#. ##.## ## #.#.# #.##.##.#.#.##.#.#.# # # #.##=# #.#.#.##.# ##.#.#. #
#....# #.# # # #.#.#.#.#.#.##.#.### ..##.#.#.# ..   . .    ...#  .. ## .#.# #.# .#. ..##.##.#.# #   .. .  #.#. .  . .##.## #...##..  . ..   ...... .##
#.## .  ..... .  ...  .  . # # #.## #.## #.#.#.## ##.#.#.#.# ##.#.#....#..... ..#..##  .   ..... .# # ##.#.. .## #.# .... .. #.  .## ## ##.# #.#.##..#
# .  #.#.# #.#.# #.#.#.# #.  . .... .  ... ....   . . . .  .....  ..## ##.# #.#.##.##.## ##.#.##.## # ## # #.###.#.#.## ## # ..##..# ##.#....#.=.  .##
# ##. ....   ..... ..#..  .#.# #.## #.#.#.#.##.## #.# # # #.# # # #  ............ . ...#  .     .. .....   .. ....... .    ..#.. .#.. ...# #...# ##..#
#.##.#.#.#.#.# # #.# ..#.# #.# #  . ...... ..# ... .#.#.#.#.# #   . ##.## #.#.#.##.#.#.. ##.#.##.## #.##.##.#.##.##.#.#.## #.# ##.##.##.#.##.#. .  .##
#.. ... ..  .. .... .# . #. .    ##.##.##.##  .##.# ....  ......#.#....#..#.#.#. .  .. #.... ... ...   .. ......... ..   ...  ...............  # ##.##
# ##.# #.#.#.##.##.#  .#.  # #.#.## ..  .... # ..## # #.##.##.#...  ## ## #.. . ## # #.#.## ##.##.# #.## ## #.#.##.##.#.##.#.##.#.#.#.##.#.#.####.   #
#.# . .  . .. . .#.# #...#.   ......#.#.# ## ..#....  . ..... #.#.# .  ... .#.#.....  ......  . .. .... . ..   . ..  . ......   . .. ... . . .  ..#.##
#..#.#.# #.# ## #  .  .#.. #.#.#.##....... ..#.#.## #.#.#.# # .  .. ##.## # ..  #.#.## # #.##.#.## #.## # #.#.##.# # #.# # # ##.#.#.#.## #.## ##.#.  #
# ##  .  # # ## ##.# #.  # # # ##.#.## # # # #.   ......  ... #.# #. .. ... #.#.. .. . . # ##.# ##.## #.#.#.# ##.#.#.#.#.# # # #.# ##.##.#.# #.##.#.##
#....#.#  .. .. .    ..# .     . .    ..  ...  ##.#.#.##.## #.# #.#.##.# # ## # #.#.## # . .. ..  .. .  .. .. .  .... ....  ... ...... . ..... ...  .#
#.##... .#.##.#.##.#.# #.#.#.# ##.##.#.# #.#.#. ...... ..... .... . ...  . . .. ... ..   #.# ##.## ##.# #.##.# # # #.#.#.#.#.#.#.##.#.#.##.# ## # #.##
#....# #......#.#  ...  .#.. ..##.# ... ... .  ## # #.# #.#.# #.#.# #.##.#.# ##.## #.# # ## #.# ##.# #.## # #.# ##.##.# #.##.#.#.## # # ##.# ..   .. #
#.##.# #.#.##  ..# #.# #. .#.#. .  #.# #.# #.#.  .##.##.#.#.#.# #.#.# ## # # ## .....  .  .    ..   ...  .. ....   ... ..  .... .. .. .   . .#.#.## ##
#  ... . ..   #.##   #.#.# .   # #.# # #.#.#.# ##  ....  .. .  ... ... .... ....# #.##.# ##.## # #.##.#.##.##.## # #.#.# #.###.##.#.#.#.## #.#.#.## ##
# ## #.# # #.# ....#.. ... #.#.#.# . . . .  .   #.##.# # ##.#.#.##.#.#.# ##.#o#    ..... . .  .     .. ......  =  ..... ...... ..  . . .  .. ...  ...#
#  ..#.#......#.##.#.#.# # #.....#.# # #.## ## #. ## #.## #.#.# # # ##.#.. .....# ## #.#.#.#.#.## ## #.## ## #.#.# #.#.# ## #.## #.#.## ##.#.#.# ##.##
# ## ....# #.##. ......  . ..#.#  .#...  .   .. #...    .   ...  . ..  . ##.#.#.#.##.  ...    . ... .   . .... . ...... .. .= .. ...   ....  ... ..  #
# .  #.#.  #.. .##.# #.#.# #.#..#.## # # ##.##.##.## # #.#.##.# ##.#.#.#... . # . .. #.#.## # ##.#.#.#.##.# ##.#.#.# ## #.# ##.##.#.#.##.#.# #.## # ##
# ## . . #. .##..  .. . ..   ..#............ .  ...... . .......#.# ##   ##.# ..##.#. .  ##.#......#.#..#.#.  ... .... .     .... .. ....... .... ...#
#.## #.#...#.#. ## #.#.#.##.##.# # #.# ## ## # ##.##.##.# #.#.#..     .#... # # ## #.# #. .. .## #  ..#  .. ##.# # ## # ##.#.# # # ## #.# # #.# # # ##
# ..  ...# #..# ## . # .. .. #...  .....  .    . ... ......  .. #.##.#.# ##  .. .....  #.##.#.##.#.## ..# # #......##. #.# # #.#.##.#.# #.# #. . . .##
# ## #.# #.  # ....#...#.# #. .# #.#.## # #.##.## ## #.# # ## #... .. ... . # #.#.#.## ... .   .......#......# #.#....#.. .......   .. ...... # # #..#
#. ... . ..#.##.##...#.#..  .# . .    .. . ..    .... .  .. ... ##.#.# #.## .  . ... ..#.##.##.#.#.# ##.#.#.#. . ..##.. #.#.## #.### ##.# #.#... .#.##
#.## # #.#.   ..## #  ...#.#.. #.#.# #.#.#.#.# ##.## # #.# # ##... . .. .. .#.#.##.#.#=# ##. ..     ....  ..## #.#.##.## ##.#.# # ##.#.## #.#.## ##..#
#..#.#.# ..#.## .. ..#.# # #.#....  ...#.#.#.  ## .... .  ...   ## #.#.# ##  ..   ... .. .  ##.## ## # ##.#. ..  ....       ....... . ...... ... . .##
#.#.. .  #.# ##.##.#.#.#.   . .# #.# #.    ..# ...##.#.#.#.## # #.#.#.##.##.# # # ##.# # ##  .. . . ....   # #.##.# # #.# # # #.# ##.##.##.##.##.##.##
#.##.#.# .....   # #..   #.#.# ...   ..#.##.##.##... ......   .  ... .. .. .  ..... . .  ##.##.# #.#.#.## # ## #.#.##.# ##.## #.#.#.#.# ##.#.# # #. .#
#......  #.#.##.# . .#.# ... ..#.# #.#.# # #.. ##.#.##.#.# #.##.## ##.## ## # # # ###.##.. .##.. ...       . .  . .... . . .    .   .  ..... .... # ##
#.##.# #  .#.##.##.# #. .## ##. .......  ....#.. .# ...#  .    .. =... .. ....# .    .   ##. ..# #.# # ## #.##.#.#.## ##.# ##.#.#.#.#.#.# # #.#.#.#.##
#....#.# #..    .#.# . #..... .# ## ##.# #.#   ##..# #  .# # ## ## ##.##.## #.  #.# #.##.##.##.# #.# ##.# ##.#.  . ...  ... .... ... .... .. .    . .#
#.## ..... #.##.#  . #.  # #.#.#. .. ... .   #.#..##.#.# #. .... . . . . .. . # ..... . ... . . .....   . ..  .##.#.##.#.#.## # #.#.## #.# ##.#.#.#.##
# ## #.# # #.. ..# # #.#.# #. . .#.#.#.#.#.#....#.. ..  .. # ##.##.# # #.##.#.  # # #.##.#.#.#.#.# # #.#.#.#.#.... . o... .  .  . .... ..... ....... #
#.  .. ......##.# . ... ... .#.#..  .... . . #.#. ##.## ##.# ## # ##.#.# ## # #.# # # ..   .. .# # #.#.#.#.#.# ##.## ## ## # # #.##.# ##.# ## #.#.# ##
# ## # #.##.##.#.#.# #.# #.###.# #.#.# ##.##  . #. . ..  .. .  ....... .  .. .........## ##.# #.. . .... .  .    . . .... . ..... ...... . . ..   .  #
#.#...... .. .   ....    .  .  . .. ..   ....# ##.#.#.# #.##.# #.# ## ## # #.##.##.##  . . ...#.## # #.#.#.#.# ##.##.# # ## ## #.# ##.# #.##.##.# #.##
#  #.# # ## #.##.# ##.# #.##.#=#.#.# ## #.##.. #..#.#.....##.# ..# ## ##.#.# ## ##.## ##.## # #.##.#.#.#.# # # . .## #.##.  .  . #.##.# #.##.#.##.#.##
# #.    .  ....    .. ... ... . ... .. . ... #..#.  ..#.#....  #  ..   .  ..... .    .  ..........   .. .  ....##..   .   # ## #..........  . .... ..#
## #.##.#.#.##.#.## # #.#.#.#.#.# # # #.# ##.# #  ##.## #.## #.# #.## ## # #.##.##.##.##.# #.#.#.#.# #.#.## ##.# # #.#.##.#.## #.#.## #.# ## #.##.# ##
#.   .    . .... ......   ... ... .. ..   .   ..# ... .. . .  ...... ....  .. . . ..  .. #...    # #.# #  ..  ... .... . . ...   #.... ... ... ..  ..#
#.#.# # #.# #.# # # # #.#.#.##.#.#.##.# #.##.#.#  ## ##.# ##.#.#.# ##.##.#.#.## ##.#.# # ..#.# # ..   .. # # # #.# #.#.##.#.## #.. #.# ##.#.#.## ##.##
# ...  .. .....      #.#..#.## # # # ##. .##.#..#.  #.##.# #.# . . .  . ..      .. #.# . #.#.#.# # ##.## #.#.# .  .......... .   # # #.##.#.##.# ....#
#.#.# #.#.# ##.## ##. . # .    ...... ..# ... .## #  ...   . ..#.# #.# ##.## ##.##.. . #.   .. ....  .....  . .##.# # # #.#.# ## #..   ....    ..##.##
#.. .. ...#...  . .  #.# .#.##.#.# ## # #.##.# ...  ###.#.##.#..  .. .  .  .  . # .# #.#.#.#.# #.##.# ##.## ##. ..#.#.#.#.#  . .  .#.#.##.## #.#.##  #
#.#.#.# #.  ## #.#.# # ## #.#.##.#.##.#.# #.#. ## #. .#.#.=#.  #.# #.# #.# #.##. #.# # ..# # #.#.#... ...##.#..##.... ....#.#.##.#..  . . . . ... . ##
#.  . # #.# . .   . .....   ....  . ....  ...#  #. # # .##...#  ....  . ..... ..##.....# ...... ..#.## # . . #. . # #.# #= ..... . #.# ##.##.# #.##  #
#.# #....  .# # ## #.## #.### ##.##.##.# ##.#..#..##.## .. # # #.#.#.## ##.# ##    #.#.# # # # #.#  ...  ## ##.## # #.# #.# ##.## #.#.#.#.##.#.#.##.##
#. .. #.#.#.# .... # . .# #.#.## . .... ... .# .#.  ... ## #.# #  . .. . . .  . ##..  ....  .  ..##.#.#.#.#.#.. ...  . .. . . .  .....   ... ....  ..#
# # #.# #...  #.# #..##..  .  .. #.#.# #.## ## #  # #.#.#... .. .#.##.#.## # ##.##.#.# #.# #.#.# .. .  ..... #.##.# #.#.##.##.#.#.#.#.#.# #.## #.##.##
#..... .  #.#.#.# ## #  # #.#.##..   ... .  ...## ..#.#..#.#.# #.#... . #  . #.......  ..# # #. .# ##.# #.#.##   .#.... ........ . . .. # ........  .#
#.#.#.#.#.. ... ...#.#.## ## #.# #.# #.# ##.##..  #.#.. #. ..... . ##.# .# #..#.##.#.#.#.......# #.# ##.#.#.#. ##  .##.#.#.# # #.#.##.#. .## # # ## ##
#... .#. .#.#.## #........ . . .=... . ......  ## .. .# .#.#.#.#.# ##.# ##.#.##   .. ....#.# # . ..... . .  .#.##.#.# ...  . ..... . .. # ##.# ... ..#
#.#.#   #.#.## # #.#.##.##.##.# #.#.##.##.# ##... # # #.## #....  .  .. .   ... # #.# ##...# #.# #.#.#.##.#.# . .. ..#.#.#.##.##.## # #.. ..  .# ##.##
#. . .#. ..   ... .. ......  .. .  .  . .  .. .## #. ..  ..  #.# #.##.##.# ##.#...#.#   .#.  ...   . . .....## ##.## #.# #. ...   . .   # ## #  .. .##
# #.# ## ##.#.# #.#.# #.##.#.# #.# #.#.# ## ##..  ..# #.# ##... .. ... #.#. ... #. .. ##.#.# # # # # ## ###..#.... . .    .# ## #.#.#.#  . ....# ##. #
#...... ... . ....  ..  ..  . ..  ..  .# ##.#..## # # ..## #.#.#.#.#.#. .  #.##.  #.#.... . ...# #...... .  ## ##.## # #.#.... .#.#. . .#.#.## #.##.##
# #.#.#.##.## #.##.##.#.# #.# # ##.#.#   . ..#    ..  #.. . . ...  . ..# # ##.#.#...#.##.# #.#.... ##=# #.#.#. #.# #.#.#.#.# ##. ...#.#   .. . .   ..#
# . #  ... . ..... .. ..  . .  ...... .#.##.#..##.#.#.. ## #.# #.#.#.# #    . ..#.#....#..  .  #.#.##.....#. #..  .. . .   ..#..#.#. . .##.# #.# ##.##
###...# ## ## # #.##.#.# ## # ##.# # # #.#..##.   ....#..#.. #.# ... ....#.# ##.... #.# .#.#.# .    . ##.#  ## #.#.# #.#.#.#  #.#  .# #. . . .... .  #
# # #   .... ..   . . .. .... . . ......  #.. .##.# #...#..# ..  #.#.# #...= .  # #. .##. .....#.# ##.##.## .. #. ...#...#.  #... # . . ## # #.#.##.##
#.#=. #.# #.# # #.#.#.#.##.#.#.##.## # #.#. ## .. . ..#..#...#.#. ...#.# # ## #.# ..#   .# #.#.#.#...  . ...## ..# #. .# . # ## # #.#.#.## # ... .  .#
# # #.##.## ##.##.##.##.## #.# ##.#.#.#.#.#.## ##.# #.#.##.#.# ..#.#.#.. # # ... .#.# ##  .. ... . ##.# #.# ##.# ..#.# . #   .....     .... #.##.## ##
# . . .. .....  ..... ....... . .   .....  .... ... .. . .. .  #   .. .#..  # #.#. . ....#.#.#.#.#  .   . .  . ..# # #.#.. #.## #.## ##.##.##.## ## .#
##.## #.##.# #.##.#.#.#.#.#.##.#.# #.#.# ## ##.## #.#.# #.##.#.#.# #.#.#.# # ## # #.#.##.#. .#.#.# ##.# #.# ##.#=. ..... #..  ..##.# ##  .   ..... .##
# .. .  . ...... #.##.# ...... .. . ....  # #. . . ...  ... .. . ...   .  . .   .. .. .. . #. .     ... ..  .  . ##.#.#.#. # ##.... . . ##.#.#.#.##  #
## ## # ##.#.#.#.... ...# ##.# #.#.##.##.#...#.## ## ## # #.# #.#.# ##.# ## #.#.# #.# ## # #.#.# ## # #.##.# # #... . . .# #.#..## # ##.##.  #.#..#.##
# ........ .. .. # #.## .. .   ... . . .  # #.. ..   . ..  . . .... ....... ... .. .... .   . ..  ... .. ..    ..#.#.# #  . ..#  ... . . . #.....# .##
# #.#.#.##.#.#.#.# # # # # # # # #.# #.# ##.## ##.## ## ## #.##.# #.## # #.##.#.# ## #.# #.##.## #.# #.#.#.# ##.# ##.#.##.## ##.##.#.##.## ..# #..#..#
#.... . ....   ... ......... . ..  . .. . .. . ..  .. ...  .... ... . . . ..........   ...    .   ..... .. .. .      ... .. . .......#..##.# # ..## ##
## #.# # ## # ## ##.#.#.#.#.# #.#.#.# ##.# # # #.#.##.#.##.#.##.# #.#.## ##.# # #.# ## #.# ##.#.#.# # ##.#.#.# # #.#.#.##.##.#.# #.# .#. ..# ..#.....#
# ............  ..  ........... ...  . #.#.## #...... ..#. .. . . .....   .  .#.#.# ## # #.. . ...... ##.#.# #  .# ..     .#.# ... ..## ##. .#  .##.##
##.# #.# ##.##.#.## #.#.##.##.#.#.#.#.#  #. ...#.#.#.##. .## ##.##.##.##.#.##=  .. .   ..  ## # #.#.#...... ...#. .#.# ## #..  ##.##  . #.#.## #.##.##
# . . .... .  . ..  .   ..  ..  .... .## . ## ## . . ##.#.# .. .... . .# ...  # #.# #.#### #  #.#. . .## # # #.# #  .     .#.# ## .. ##..  . .   .   #
##.#.# #.# ##.# #.#.# # ##.#.#.## # #....# . .. .# #.   ...#.## # # #.#..## # # . #..... . .# ....# #. ..  . #. .  #.#.##.##.# . .##. ..## #.# #.##.##
#.##.# # # # ## # #.# # ## #.##.#.# # #.## #.#.#.# #.#.##.## ##...# #..# ##.#. .#.. # #.##.#..#.#. ...##.#.#...#.#  . . .. .. .##... ##  . ......  .##
# . ..   .   .... . ... . . . ..  . .   .. .. ....   ....  ... .#. .. # ... ..#. .# #.#.## ##.# #.##.#.#.#.# # # #.# # ##.# #.#.# ##..#.## # # #.##..#
#.# # #.# ## #.##.## # ## ##.#.##.# #.#.##.#.#.# #.##.##.#.# ##.#.#.#.## ##.#. .#.. ........ .  ..   ..   .. ... . .. . . ....  . ...#..  .. ..  ...##
#.... . #.##.## #... . ... . #. #  . . = # ..#    .   .  . .. ... ... .    . .#. .# ## # ##.# # ##.#.##.# ##.##.## # #.## # #.#.##.#.## ##.# #.# ##  #
##.# ##. ....   ..##.#.##.## ..#..#.#.#.#..#.#.#.#.#.#.#.# #.# # ## ##.# ##.#  .#.# #.## .# ..#....#   #... ....  ...##........ .   ..  ## . . #.. .##
##.# ## ## #.#.##.##. ... .  #..# .......#.... #.# # . ..#.# . ...   .... .  .#.. .......#. # .#.#...# ..#.#.## ##.#    # #.#.##.#.# ##.   #.#...## .#
#..  . .## #.#.##.. .##.##.#...## # # # #  #.#... . .#.# .   #.#.##.##.# ##.#.#.# #.# ## ##.#.##.#.#.#.#.  ..##.#..#.##.# .... ....... .##..   #.#. ##
## #.## .   .   ..##..#.## # #.  .... #. #    .#.#.# #.#.#.#.  . . . . # #... . ...  ...    ..   . .  .. #.#. . .#. ..... #.#.# ##.#.##  . #.#.. ## ##
##.#.## ## # ##.#..  #. . .  ## #.#.#  .##.#.#. .#. . ..... .#.#.# #.#   ..##.# # #.## #.## ##.#.#.#.#.#.# #.#.# # ##.#.#.#.# ##.# . #  ##.#.#.# .. ##
#..   .. ..... .  ##. # #.##  .  . . .#. ......#.  #.#.# #.# .. . .... #.# ........   .    ..  ....# .... .... ... .. . ... ..    .# .#. ..   .. ##.%#
######################################################################################################################################################
