##########################################
#. # #       ##.##.##. ## # #. . .# #. # #
#.## #.# # ##..    .  # =.    # #  ..#  .#
# . .##.##.# .##.#.###  # #.#. # .## # # #
## #. .. . #.#  .# # # #.  .. # #  #.# ###
# . # ##.### # # .  .#  # ###.#  # #.# ..#
## # #  .  ...  .# #.###. #.# ##     #.#.#
#. #.### ## ## #.#.#    #=.   ...# ## ..##
## #  .  # #.#.#    ### #.##.##.#.  #.#  #
#.. ####.  #  ##.## ..# # # ## #.#.#..# ##
## #     #  #     .##.         =.##  #.# #
#. .###.#  #..##.##o.###.#.##.##.. #.# . #
# ## .#..# ## ##.   ##   ## ###.## # ### #
#.#. # .#   .   ###   # # #..   .  # .   #
#  #..#..# ####.# #.## .# # ## ##.#..## ##
# #.# #.#..   # #.# #.#  .#.# ...#.#.   .#
#     # #.##.# o#.   .. #.  ##.##. # ## ##
# # #.#..###.##.# #####   #.  #..# # ##.##
# ##= .#..#.# # #  .  . # ### .#..  .  ..#
# ..###.#.  .   ## # # #  .   #.#### #.###
###.#    ## # ## .    # ##.#.##   .#.#  .#
#   . ##   # .. # # # #. # #  . ## #.# #o#
##.##  # # #.## #. #.#.# . ..### ....# # #
# ..  #..# #.# .#.#.    # ##   .## ##.## #
#### #  #..# .#   #.# # # #  ###. #   . ##
#  .  ##.# #.## #\#.. ## ..#  .  # .# #..#
# ## # #  #.#.o  #. #.. #.#.## ## #. # .##
#  #  .  #. . #.#.#..###  . #.. #. .# .# #
#=#  # # .#.##  # # # ..# #  #.## #.##= .#
# .#.# # # #  # # #.##.#  # #. # ## .# #.#
#.#. .= .#   #.#%  . .  # #.##     .# .# #
# .###.#..##.  #.## ##.##..#  # # ## #.#.#
##.#... ## ..# #.# #  .# # # # .# #  # #.#
# .# ## # ### .#. . #### .   =# # ##.#.. #
# #.#.#.    .# # ##. .. .####  . ..   #.##
# ..   # ## ##.## #.####.#  ## # # # ## ##
# #.### #.....  #.. #.    #...#  .#. . ..#
# # . . . ##### .#.## #.#.#.# ## ## ######
# #.#.####   ..#..#  .# ### #  #      .  #
#  # . ..  ##.#.## ###. .. . .# ##.# ## ##
## # #.## #. . .   .. #.#.# # # .. #..  .#
##########################################
