###################
#.#... \ #.#.#.#..#
# #.###.#....#.##.#
#..#..#  #.#......#
#.##.##.#.##.######
#...o.... ........#
#.#.####.## #.#.###
# #.#....#..#.. ..#
#.#..#.#.#.#%.##.##
# #.##.#...##..#.##
#.#.#.o#.#.. .#. .#
# #.## #.##.## ####
# .... .....o... .#
#.#.###=#.# ##.##.#
#.#.#.## #.#.##=#.#
###... . .  ......#
#...####.####=#o#.#
#.# ..= ......#.#.#
###################
