########################
## #=## # # # # # # # ##
#    .o    .     %     #
## # # #.# # # # ## ##.#
#.  #.# ## ## # #.# #  #
## #.   .    ..   # ## #
##  # ########### ## ###
#  # #   . .  o #  . . #
## #.# # ## ## #  ####.#
#  # # ###=# ## # #   .#
##     .\ .       # ## #
## ## # #.####### #  # #
#. # #.#.    =  # # #  #
##      #.## # #   # # #
#  ###### #  #  #.# . .#
## #.     # #. #  ## # #
#.=# # ## #  #  #  #   #
##.## # ### # ##  #  # #
#.   .. .      .#  # # #
## ## ## ###.###. ## # #
## # ##.## #.# ##o# # ##
#  .           .    . o#
## ## # # ## # ## # # ##
########################
