##########################################################
# # # #.# # ## # # #.## ## ##.# # ## #.# # ## ##.#.## # ##
#   . .   .  .      .      .   .                         #
### ####### #### # # # ### ### ## # #### ### ## ##########
# #.#    ..#.   ## .# ##  .# # # #.#. .#   # # # . . .  .#
# # # # ## .# #  . #     #    ## # #.## ### .# # ## ## # #
#..  # # # #  # ##  # #### #.# . .    .    # #.# # # ##.##
# #.# .     # ## # #         ##### ### ## #  # #         #
# # ###### #  ..    ###### #     #   #  #. # # # #########
# # ..   # # # # # #     #   # # # ## .#  #  #.          #
## ####### ## # ## # # ## ##.## ## # # ### # # ##.# ### ##
#   . .      .           .     .      \ .    # # #  # ## #
#### # ##.## # # ## # ##.# # ##.### ## # # # #  . # #  o #
#.  #    # # ## ## # # ## # ## ## #.# # # #  # ###  #### #
###. # ##  #        .       .              #.#    #  . . #
#  .#    # # #####.## ## ## ##.#.## # # ###  # ###  # ##.#
###  #.#.#.# #   #   # # # #    # ## #   . #.# #  # # #  #
#   #  # # #  ##.# ###=# # #.## #     #.###   .# #  ## # #
#.#.## #   # # # #.# . #   #  #  # # #  #. #.# #  #    ..#
# .     ##.#.# # ## ## ##### ## # #   # # #    # #  #.# ##
######## # #.# .         .   .     # #  # ##.#.#  # #  # #
#..   ..  .# ### ################### ## #.    .# #   ### #
#.####.### #               .          #  #.# #  . # #    #
# #. # # #.# ### #### # ###### ##.#.# # #  # # #.#  #### #
#.## #   # # # o   . #.#       # # #  # ## # #   .#.     #
## # # ## .# # ##.##.# ### # # #    # #    # # ## # ##.# #
#    #  ## # # #   # #    #. # # # #  # ## # #. # #     .#
##.#.# #   # #.#### #  #### #  # #  # #.#  # # #.  .##.#.#
#  # # #.# #         # #     # #.# #  #. # #.#  # # #  # #
## # #.# # # ## ## ##..####.## # # ## # # # .# # ## #### #
#  # #.# # # .## ## ##..   .. .       # .. #   . .       #
## # # # # # #         ### # ### ####.# ##=# ## # # ### ##
#  #.#.#.# # # ## # ## # #.###.#.#  # #.# ## # #  #  .# .#
## # # # # # # ##   .#.#      .  # #  #.    .   #   # # ##
## #.# # # #     .# #  # ## # ##  . # #.## # ###. ### # ##
# ## # # # # ## # ## #.## ## # #####.# .#      .#     #. #
#      ## .#.   .     ..   . .    ... #.  ## # ## #.##. ##
#.# ##  .# # #.### # ######## # # # ##  #    # #  ##..#  #
# # # .# # # #  . #      . .#  #  ## ## # ##  . #  # ## ##
# #  # ### # # #### ###### # ##  # #  #  # # ##.# #     .#
# #.##..   # #    . .   .      # #  .# .#  . #.#  ##### ##
# # #. ### # # ##.# ## ## #####    #. # .# # # ##     #. #
# #  # # # # # # # # ###.# o   #.# #.##.#  # #  # ##### ##
#.# #. #.#.# # #   .     #.## ##..   #  o###.# ## #.. .  #
# # ##   # #  .# # ## ## # # .#  ###  # #   .# #   # ## ##
# #. # #.  # # # ## #  #    #. #   #.#  ## # # ## #  # .##
# # #. . # # # #    # #  # #  #  ##.  #    #.#     #  # .#
# # ## # # #  # #### # #.## # ## # # ## ##.#. # #.#  #  ##
## # ##.## # # ..  .       .       . .  #  # # #   #  #  #
#   .   ..   .# ## # #.# # # # # # ## #  #.#    # #  ## ##
## #.# #.#.#.# ## # #.# # # #.# # ## #  #  # # #.  #.    #
#  . ## #.#    .     .              . # ## #. # # #. ## ##
## #  .    # # ## ##.# ## #### ## ## #  .# # #    ##  #  #
# .#.## #.#  .# ## ## # # . .# #. . # # #  # .# #  # #. ##
## #  # #  # #   .  .   #.# #  #### # # ###  # #. #   # ##
## # # .# ## # ### #####  # .#  ..    #    #    #%=# ##..#
#     #.#               #.  #  ## # # # # # .## # #=    ##
##########################################################
