#######################
##o  ## # ##   . .oo#.#
#  #. . #   # #.# ## o#
### ###.#.##  # #  . ##
#    .. =..## ###.## .#
# ###=### #  =.  .# .##
# #  #  #.  ##=##  #  #
#   ## ##.## #. # #  ##
### #  # ## .## # #.# #
#   ## #.   # ### #.. #
### ..   #### . . # ###
#.##.# ##     # #   # #
# .  #.  # # #.#.# #  #
# # # # #  ##      ## #
###.# # ## . ## ##.   #
# . #  .. ## # # # ## #
# #   ## # .         ##
# # #.# #. # #.########
#.        # ##....\  ##
####.##### .   # ###  #
#     .  #.##.# #    ##
# # # # #  # % .# ##  #
#######################
