##########################################################################################################################################################################
#      . ...  . ... ..#....  . # #.#.#.#.#...#.   ...#.#..# # #..... ...#. ... .. #  #...# . .#..# ...  ...# ...#.#  ...   ... #...#  ....# #.#.#.##... # ##=## #.# # .. #
#.# ##.## # # # # #.#.#.# ####.#...  ... # #. #.# ##.# ..#..#  #.#.##.#..# #.## #..#.#.##.###.##.#########.#.##.#..# #########..##.###.####.# #. .. # ## .  . . # #.####.#
# .# #.# # #.#.#.# #.## #.#....#.########.##.# #.#.#.###.##.# #.#.#.### # #.##.##.#..# . . ....    .. . .#.# # .# #...  ... .# # .. . . ....  # #.##   .#.#.## #. #. .   #
# #. # #. ... .  . . . .# .### #.. ..  ..... .. . ....   ....  .......  .. .. .  . #..################.### #.####.############.##############.#.##.##.### ##.## #.# ######
## #.# .# # ##.#.##.#.#.# #  ..#.### ############## #.#.#.## ## # # ##.##.##.######..#.   . . ...   .  . ... . ...  ....  .  .. . .. .  .. ..      . ...... ... . #....  #
#. ... #.#.##.# ## #.#..## ####..#..#  . .. .  ... # # #.##.# #..# ##.##.#..# .....# #.#.### # # #.##.## #.#### ## # ## #.## ###.#.##.###.####.#.##.#.##.##.# # #..#.###.#
##.#.#  . ....   .... #. ....  #..#. ###.#.####.## #.      .  # ##. . .  #.##.#.##.#. #.##.## #.# #.#.#.# #.  .# #. #.# .##.# .#.# # ## # #=. #.##.#.##.# ## #.#. #... # #
#.#.#. ###############  #####.#  #..# .#..#...# .#=# ##.## ###  #..###.##. #..#.#.#. ##.. . . .... .# #.#.# ###. #.#  # #....# #.# # . .# .## #...  .....  .. ..# .#####.#
#.#..# #.. . .........#.. ..#.##  #.#.#. #. #.#.# .#..#..#   .#. #.# ..# #. # #.. .# #..# ##########=.#.# #.# .# #.##.#  ##.## # # #.#.# .# ..#.####.###########. # . ...#
# #.#..#######.#######..## ## .# # .# .#. # ###..#.#.#..#.#.#.#.#  .##.# # # .#.##.# ##.#.  . . . .=# #.....#.#. #. #.# #.#.#. .##.# ## ##.## #.#  .#. .     . .# ###### #
#.# ##.....  .  ..... #.#.##.## ..#.# # .#. ... #. #. ### ##.# ..#=# ..#.#..#.# #..#. #. ###########.#.####.# ## #### #.#.   #.#.\ .....    # # .## .# # # #.##.#. ...  .#
#.#   .############### . . .  .#.#..# ##  # #.#..# #.#........# #.  ## # # #.# .###..#..# ..... .. .       . .  ...  .#.#.#.#.. ########## ##.#.###.#..# ## #.##..##.#.#.#
#.#.##    ..      .. #.# ###.#.# ##.#..#.#.# .# #..#. ####.#.# ..#.#. .  #....#   .#. # #.#.## # #.#.#.#.## ##.#.## ##  # #  #.#  . .    . #..#. #...#.#    . ..#.#.# # ##
#.#.#..## # # #.# ## #.#.#. ## #..#.#.#.## ####.##.#.#  ...#..#.#..#.#.# #.## #.###..## .#.#.##.#.#.# #.#.#.#.#.# ##.###.##.##.############ #.#.#.#.##.##########....  ..#
# ## # #.#.#.#.##. #.#.#..#.# #..##.#  . . ....#. .# .#.##.#.#..## ## # ## #.# .# .#.#. #.  ..     .. ... .   ..... . . . . ..  ... .  .. .. . ... .  ...     ... ## ##.##
#. ..# #.#..   . .#  #.#.#..   #.# ..# #.#.###..## #.# #.### ## ..    ...  . .#.#.## .# #.## ##.#.##.## #.## #.# # #.#####.###.#.######## # # ##.#.#.## #.# #.###.#.#..#.#
#.#.#..#.######### ## .# .#.##.#..#.#.#.#.#.=# ##..# #...   . . # #.## ### ## #.# . .# .###.#.## # #.#.##.#.#.#.# # #. ..#.#.#.#.# .....# #..#.## # #.##.#.# ## #.#..#.#.#
#..# #.# ...  . .  ..#.#.#. .#.#.#..# #.#.#.#....#.#.#.###.# ##.# .#.#.#.#.#.##..# #.##.  .  ....# #.# # .#...  ..# #.#.#..#.#.#.# #####  # #.    ........ ... .. #.#..  #
#.# ...#.# ## ##.#### .##.#.#.#. .# # ... #..#.##. # .#. #.## # #.#. ..# . #.#..#.#=. #.#.# ### # .#=#.## # ###.#. .. ## #.# #.# #..  ..# #. #.#.#.##.#.# #.#.# #.#..#.###
#.####.#..#  # #.# . #   . ....#.#. # ##### ##.  # #.#. #. .. # #..#.#.#.#.#  #   .#.## #. ## ## #.# #    # #.  # #.##.#.# # ..# #.#.## #.# # #.# ##.#.# #.#.#.# .#.#  #.#
#... ..# ## #.. .#.##  #.###.##.. #.# ... ..# .##..# .#.####### .## # # # ##.#..###..#. #.#.  .  . #. #.#. # ##.#  ##... #..##.# #.## ##  #   . .=..   ... .... # . .# #.#
####.# #.#...###.# # #.# #.#.#.# #..#.#.# #..#...# #.#....=.    #.. . = . ....#.. .# .#.#..#.# # #.#.#. # #.  ..# #.. ## # ###.#==... ..#.#.##.## #.#=# ##.# #.# .####.# #
#. #.#.#..#.#.....   # #.#.#.# #  #.##.#=# .## ### #..# #.##.##. ###.#######.# .#.#..##.### # # ##.##.##.# ###### ### # #.# # #.########.#.## ##.###.#.#.##.# # #   .  . #
## #.# # #. #### ##.#  #.#.#.#  .## ... . # # .  ..#.#.#.##.# # #... #... .  .#. #.# . ....  ..     ..   ...    . . ..... ... .. .. .  ..... .....#...    ......# ##.#.###
#  ##. #.##  ..# # #.# .##.# ### #  ###### ..# ##.#..#   .. .  .##### ######.# .##.# ####.##.##.## ##.#.####.#.# ## ###.# ##.#.## ##.##.# # ## ##..# #.#.## # #.# #..##  #
##. .#.#..#.# #. #.  #.#...#. .# ##...  ..# ##.# #.#  ###.### #.......  ..  ..#.#. # #....#.#.#.#.# .# #...#.# .## #  #.#.#.#.#..#. #.##.#.#.## #.# #  #..#.#.#.# ###.#.##
#..##. #.#..##.#.#.# #.#.#.# ##. .# #.# ## .# .#.... ##.# #  .# ############### .#.#. #####.# ###..#.#.#.##..# #.. ..#..# #. .# ## ## .. .. ....#   .#.#.# .#.# #. .  # .#
## ..# #.## .  #.#.# #.##  #   #.#..#.# . #.##  ####....# .## #.#...      .  .  # .#.#.... .......# .#.#...#..# #### ###.##.###.# ....# ####.## # ###.#.###.#=#.# ##.#  ##
#..#.# #.   # # .#.#.# . #.# ## . #  #.####  # # ... # ##.# . # # #.#.#.#.# ### ##.#. ## #.######.## # #.##  #.... .. . . ... .  #.## .#. ..#.#.# .. . ..# ##.#.#.# #.# .#
##.#.#.# ## # ## # # # ##..#.  #.# .# .     # . ##.#.###. #.#.# .#.#.#=#.#.#..#  ..#.##.##  . . # .# # # # #  #.##=#.###.#.## # #...# #. #### #.#.###.##.#.. .#.#.#  .  ##
# .#.#.# #.## .#..## #.#.# #.##.. #..###### .#.#.#.#... # #.# #.#.    ..  .# ## # #..#.... #####..# ...# #.#.#.#.## ##.#.### #   #.# .##.#. . ##. #....#..#.#.# #..##.#. #
##.#.#.# #. . #. #...  #.# # #.#.#..#  .. .=#..#.# # ###  # #.# .#.#.##.#.#..#  # .#.#.###.#  ..# #### # #.#.  .   . ..#      #.# ..# .#. # #.  #.### #..# #.##.#.#..#..##
##.### # ##### ##.####  .#.  #.#. # .##.###.## #.#.#   .# #.#.#.##.##.##.#.#.##.# #  # #.# # ####..... #.#.#.##########.######. .#.#..#  ## #.## ...# .#    .. =# ##.##  #
#.   .....  . .........#. ##.# # # .#.# ..# .  #.## .####.#.# # ...  ... .  . # .#.#.# ..#.#.#....# #.#. # . .....  .  . .... #.#.  #  # #..#. .#.#.#.## ########  #. #.##
# # #.# #.#.#######.## #.# #.#.# ## #.  #..# #.#.. # #... #.# #.########### ##=.#... # ##..#.# ##.#.#  #. ## ### ##.##.###.###.  #.#..#. .#.# #.# # #.#..# .   . .#. #  .#
###.# ##.#.#. . . .#.#.# . #.#.#. #..###.## ##.#.###.# ##.# #.#.# ...   . .. .# .#.# # # #.# #. # ##.##  # #.# #.#.#.### #.# .#.#...# ##.#.#..## ..# #.#.# ##.# #. # ##.##
#...# .= #..######.#.#  ####.# #.## #. ... ....# .  ..## #.#.## ###############.# #..#.# . #.#.##... . #.# # #.# #.#.......# # . # # ..   ..# . #.#..   .#.#.# # .#.  ...#
#.#.##### .#   .. .#. .#. .. # # #. #.######## .##.#.#. ..... .. ..   ..  . .. . ..#.# ### #.#.#..######.# # #.#.#  ####.# ...#.#.  #.#######.##. ######.#.#.#..#..#.##.##
###.. ...#.###.###. ##  #### # #..#.# . .. . #.#.###. ### ## ##.#.# #.#.###.# # #.##.#...#.#.#.## #  ....#.# #   #.# .  .#.####..# ##. .. .  .. #     .#=# # # #..#.#.#..#
#. .##.###. ..# .#.#.#o#.... #.# #  #########  #. .. #...#.## #..# # #.##.## #.## #. # #.# #.#..#.# #.## #.#.#.## .#.#.#.#.#  . #  #. ########### #### # #.#.# .# # # #.##
### # #    #### ## #.# .##.# # #.##.  ....   #  #.##.#.#......#.# .  ....  ....  . #. #.# ##.####.##.# #.#.# # # # ##.# #.#.###..# .#.# . ....  ..#. #.#=#.#.# #. # #.# ##
# #... #.#.#.. .# .# #.# #.# #.#  #.##.#.#.###.# .#. .## ###### # ##.#### #.## ##.##.# ..  . ..   . .   .  . #.#...... . . ...  #.###.###########.##.##. #.#.# .#...#.# .#
#.#.## # #  ### ##.# # # ..#.# # ## #..##.#... .#..#.#   .... . ##.# # . #.##.#.# #. .##################.# #  # ############### . . . . ....... #  ....#.###.#.# .###.# ##
# #.# .#.# # . .   # # .####.# #.#. .#. #  ###.##.# ..### # ### .. #..##. ......#. #.#. .  .....  ......#. # #..  .. .  ... ....# ### ## #.# #.# .###### .      # #  .#.##
# ##.###.#..#.#.##.# # #..  .# #  # #  #. #..#.#. .#.#  # #.#. .####.#.#.########.#  # #.## ###### # ## ###. #.## ##.## # ## ##.# # #.# # . # #.#.#..  ..####.##..###.#. #
# .......#.# #.# ..# . #.# #.#.#.#   #. #.# ##. #.#.. # #.#.#.#.# ...#.. ..   . . ##.#.# .#   ....#.#=#.   #..##.#.# # # ##.#.# .##.###.#####.#.#..##.##.. ..#. # .   # ##
###.#### #.#   ###.###.##.#..#.#.## # .#..#.# .##  # #.  .#.# #.#.## #######.#.##..# #.### .###.#.#.#.#.#.#..#     ..# .... # # #....  . ....  ...#. #.#.#.#.#.#. ##.# ..#
# .#.. #.# # #  .#...# ... #.#.#..#..# .#... #.# ### #####.#.#..#.# ..=..   # #.#.##.# .. #.# ##.#  #.#.## #..#######.#####.#.# #.#.#.# # #.# ###..#.# #.# # # .#.# # #.##
## # ###.# ##  ##..# #.# ## .# # # .## #..#.#.   ......     . # #..#=###.#.#..#.# # ..##### #  # .#.# # ...#.# .    .   ....... .#.#.##.# # #.  #.# .#.# ##.##.#. .  ....#
# .  . . #.. #...#.# #.#.#.#.# # ## #  .#.#..# ##.###### #.#.#  # # .#.## # #.#.#..# #. ... #.##.#  # # ## #..####### #.#.##.##.#. .  .#.## ####  ##.# #. . ....#.#### # #
#.##.#.# # ### ###.### ###.# #.#. #..#.#. # #..#.#......#.#.#.# #..#. .. .. ....#.#####.###.... ..# #.# .### # ....  # #..# # #.#.##.#.# ...  .=# . .  # # #.###. #...#.##
#..#..##.#.#...  .      .. #.# #.#..#. .# #  # # #.##.#.# #.. #.# ## #.#.#.#.##.#..#.# #. # #.# ##..#.#.#... #.# ##.## ##.#.#.#..##.## .### #####.#####  #.## ..#..##.. .#
#.##.#. .# #.# #.# ###.#.# #.# #..#. #.#..#=#..#.### ##.#.### # ### #.#.# #.##.#.### # #.# .#.# #.#...#. ### #. #.# #. .# #.#.# #. . . #.  .#.  ....  .#.##.#.##..#...# ##
# # .# #.#.##.#.#.## #.#.# #.#.#.# .#...# # .#.#   .. ...  .. #  .. .   ..... .=...  .  . # # ### #.#.# #    #.# ... # #.##.#.#.###### #####.####.# ##.#... . ..#.# #.# =#
#  #.#.#.# ... .. . .. # # #.#.#. # .# # .# #..########## ##### ##.## # #### ### #######.# .#.. . #.#.#. ###.# .#.#.#... ...# #... .. ...   ... #.### #..####.# #.###.####
# #..#.#.#.###.# #.###.##.#. #.#.#..##..#.#..# ......   ... ..  #.#.# #.#. #...# # ..  ...#.#.#.# #.#.# #.... ## ## ##.######.#.#.##.##.#.##.#.#. . . .#.# ..# #.. ..  ..#
#..# ##. #.#..# #..#.#.. ..#.#.# .# #.###.###.###################.#.##.##.# ###.# ######## #.#.# ## ###. ### # .......  . .. .# .#.#.  # # .#.#.#.#### #.### . .#.# #.##.#
#.#.   #.# ##.. =#.# #.####..#.# # . ..    .......  . ... . ...... .   .   . .. .   ... .. . . ....... .# .#.# ## # # #.###.# # #. # # # ##.# ..# # ..#... # #.#  ## ##.##
#..# #.#.#. #.##.#  .# .. .#.# #..##.# ###=##.## #########.############################################ ##.# .## #.#.#.#... #.#  #.# # #  . #.###..## .#.### #.##.  .  . #
# # .#.#.#.#.. # # ###.####. #.# #..##.#. #.#. # ..  .   #. . ..  .... . .    .  . .  .. ........ ..  #. ..#.# . .  .#..# # #.# ##.#.# #.# #..# . #.#.## #   #..# #.### ##
# .# #.#.#. #.#.## #. .# .## #.#.##.#  #.#    # .######.# .#############.######## # #.######.##.#.#.##. # #..#.##.##.#.# #.#..#....#.# #.##.# .##.# . .. ### ###  .## #.##
### #.# ##.##.   ...## #.#  .# #. #.####. ### ## # ...# .# #. .  .     .. ... . .#.#.   .. #. #.# #.#.# #  # .# #. # #. ..  #.# ## # #.#   .#.#.#. #####..    ..#.#  .. .#
#... ..    #.# ###.#.# #.#.#.#.#.#.  .. .#. #. #..#.#.# #..#.### #.# ### ####### #  # ##.# #.#  #.#.#.#.#.#. #.   #..#.##### .# .#.#=# # ###    #.##.  #.#.#.#### .#### ##
#.##.##.##.#. .#.#.. # #. ##.#.#  #.#.## .# ..#..# ## #. #..# .# # #.. #   .   #.#.#  .#.# # ## # #.# # #..#.# ##..#.# .    #.#.#.##.# #.#  # ## .#  ##. .#.# .. .# .  .##
#.#..#.# #. ##.#.# ## .# # ..#.#.##. #.# # ### #.#.   #.#..## # #.#.###.#######.## ####.# #.#.## #.## #.# #..##.# # .# ###.##.#.#.. .#.#.#.# . ##. #.#.#.#  #####.######.#
# .#   ..#.#.# # #.  #.#=###.#  .# .#..#.#. ... =####.# .#..... .   ...  . . . . ...  ... ... ... ....#.#  # ...# ## #.# # #. #  ###.#.#    #.#.. ##. .#..#. ...#. ...  .#
# #..# # #.# ..#.#.##..#...#..##=##..# #  #.## #...  .#.#..#.#.########.### #####.#.##.### ###########..#.# .#.##  #.#.#.#= # #.#..#.#.# # # .### #..##  #. ## # .#### ###
# ###.#.#.. ####.#...#.#.#.#.# # .#.# .. #..# #  ##.#.#..#.#.#.#      # # .#.. . #.##  # ## ....   .  # =# #.###  ##.#  .# #..# .#.#.#.#.#..#...#..#...# .# # #.# #  ##..#
#.....   #.#  . .#.###.# #.#.#...#...###..# ...#.#.#.#  ## .##.# #.##.#..#..##.#.#  .#.# .#.####.##.###.# ..    # #. # ##  ##.# # . .# # ###. ##..# .##  # ... ....#  #.##
# #.#.#.#.. ####.#.#.. #.#.#  ##.## # .# #.##### # # .#.# .# . .#.#.# ####.## ## # ##.## ##.#..#.#. #.. .#.# # #  .# # .##  #.#.#### #.#.  .#  .#. # # #. # #.### ##.##.##
# ##.# # # #   #.#.#.#.#.## ##.#. #  #.#.# ... ..# . ##.##..##.#.. .  ...... . .. .  . . . .# #...#  ## #. #=#. #.##=#.#. .# .#   .#.# # # #..## .## # #.#.# #. ..... ...#
#...... .#.###.# ##.##  .  ... . #..#..#.# # #.#..## # ..#.#...####################.####.##.#.##.#..#...### .#.#..# .#. ##. #.#.###   ##..#.#.  # .....#.#.# ####.# ##.#.#
#.## # # # .     .    # #### ###. ## # # ##.#.##.# #. # #.. ##.  . ..... ..  ... .#.#.. # #.#     #. ##. ..# # .#..#.# #.#.#  # #  # # ..# ...#.# ##.##   .#  ..#..#.# # #
#.#  ##..# # #.#.# #.##... # . #.#  .   . =. . ..# #.#   #.# # ####################.###.# #.# ##.##.#.# # #. .## ###.#.# ...#.# ##.#. ##.#.##.# # #..# #.### #.#. # .#.###
#. # ..#.# .#.#.# # ## .### .##. .##.#.## # #####..#..# #..#.#.#.. .... ....... .. .. ..#.# .# #.# .#  ..#.#.#. .......#.#.#..# .  #.#.# ## #.# #..#.#.#.# .. #.#. #.#.. #
#.#.###..#.# ..    . .# ...#  .# #.## #.##..#.  .#.#.#  .# #.#. ##.### #.## #.#.###.### #.#.#.    # #.# ##.#. #.##.# # #.#. #.# #.#..# #..  # #.# #..# # # # #. #.#..#.###
# . . .#.#. #.## #####..### .##..#  .. ...#  #.###.#.##.#  ..#.# #.# ## # .#.#.##.# #.# # #..#.# # ..# .. .. #..# # ##.#.#.#..#  #.#.#  .#.# .# # .#.# #..##.##.# ##.# #.#
#.## ## .#.#. #.#  ...#.. .# # # #.# ## #.#.#.   .. . #.##.##..# #.# ...#.#.... ... # ###.#.# #..##.#..#.###..### #. .. ## .# # #  . .##..# #..##.#. #.# #   ......# # # #
##.##.#### .#.#.# #####.##.# . #.#.##.##.#...#.####.##...# # # # # # ## #..########.# ......#.##..# .# .# .#.#.. .#### # . #. #.####.# # #....#...## #.# # ###### #. =.#.#
#. . . ... #.. .  ..    #.## #.#.#.=. ....# # .#... ### #  #. .# # #..# #.# .. . ....# ## #.. .#.#..#..#..# . # # .. #. ##..#.#. ..#.#.   ### #.#..# #.#=#= ..  #..###.  #
###########.#############.#.# ##.# #######.#.#.#####.#.#.##.####.##.###.#.###########.## ##.###.# ##.##.#.##.#. #.####.#.. #..#.####. ##.## #.##  #. #.# #######  # . .###
# . ....   . ...  .. .   . .. .. ... ..... . ....  . . . .  ..... ... ....   ... .. ....... .  . .  ...  . ...# #.#..  ### .#.# #....#.. . .....# .# #.# . ..  .#  ###.#.#
###.##.## # ##### ####.#.##.##.# # #####.####.#.##### ######.#####.#.######## # ###.#.#.# #.#.######.# #####.#..#. ### . # #..# #.## #.## # # ## .#..#.# #.## ##  ##.#. .#
#. # ###.#. #.....# .##.#. #.#.#.# #.. #..  .# # ...#.#  ...#....#. # .. ... #.# .# .### # #.#. .. .#. #...# .# # #. ..#.#. #.#.#. #. #.### #.#.# .#=# #.# # #  #.#.. .###
#.##. . . #..#.##  #.. .# #  # #.# .##.#######.###.##. ####.####.#.##.######## ## ###.##.# #.# ##.# ## #.# # #. #. ###..##.#. # .### #.. ...# #.# #..#... ## # #  # ##.#.#
#  . ## ##. ##. # ##.### ..# # # #.#. ....... ... .  .# .. ....  #.....  ... ..  ... .. .#.#.# # #  .#  ## #..# # # ...#  .## # #.. ..### #.# #.#..# .##.#.  #  # #.#  # #
# ## .# # #.#..#.  .  ..#.##.# #.#..# ##.# # ##=#.#.#  #.# #=# # #.##.## # #.#.#.##.#.#.#..# #.#..#.#..#.. #.#. #..#.#..###.#.# ##.# #   .# # #.#.#.##.#  ## #.##.# .#   #
## #.#..  #. #..#.##.##.# #  # # #.#..# #.# #.##.#.#..#.# # #.##.##.###.# # # #.#.##.# #.# #  ## ##. #.# # #. ### #.##.#.  . .#. #.#..#.# # #.# # .. . # #.# #....# # .###
# .#.##.###=# .#. # . #=#.##.#.# # ##  .. . ...... .# #... ..   ..... . .  . .  ....    ...# #... . ##.#.# # #..   ....######.#.#  #.#.=#.# #.#.# ######.#.#.#.## #..#.# #
##.#. # #....## ## ### ##..#.# # #  ################  .######.##.# ## #.#.## #### # #.#.#.#. #.# ##.#  # # #.####.#.##... ..#.#.##.# .#.#.# #  .#=#. .  .# #.#..# # #. . #
#    #..# # #.  . ... . . #  # #.# #.  .. ..  ......# #....o.#.#.#.#.#.# .#.#. .#  #.# # # # .#.#.# ### ##.#. . #.##.#.### ##.#. # #.# .#.# #.#.# ######.#.#.#.#  #..#.# #
#.##.## # # ##.##.## ####..#..# ##.#.# # # ####.####..#.####.# ..# # .. # #.# #.#.#..#.. ....#.. .. ..... . .###.# # # #.. #. # # .# ###.# ##.##. .  ..#.#.  #  #.#.#..###
## #  #.#.#. .# #..# # .. ##.#. ...# #  ##  .  #  ..# # .. #. ##.## ##.#.##.# ##.#.#.####### # # #.# #.# ###.#  . .  # #.#..#.#..#.#..  ....   .# #.####..##.### .#. #.  #
##.#.#.# #.####.###.# ### #  .# # #. # #. .####. # ## #.##.# #.#. ...... .. .... . .  ... .#.# .#.# # # ##.# #######.# ##.###.#.# # ############ .# #  . #.  ...#.#.#..###
#.  .... .  .  . ..  ..    #.# # .## #..## ....#..## .# #. #.#...# ## ## # ##.##.####### ##..#.#  #.  .....  .   .... ....    =.   .   ... .....# # .###.#.#.###. # .# . #
######## ###.# # ##.#.# #.# =#  # .#.#.# # ##.##.#..# # ###  .## #.  #..# #.#.#  .  . .#.#.# #.##  #.#.## ##.##.# #####.##### # ###### ## # ##.# .#.#..#.# #.#  # #.#. ###
#..   .# #..#.# #.##.#.# ..# #.# .# .#  .# #.##. #.# .#... #.# #.# ###.##.# # .# #=#.#.#.#.# #.. .### ##..# . #  #....# #. .=# # . . # ..# ## #.#.#.#.#..# # #.#  #. # #.#
#.#.# #.. #.# #.#. .  ..#.#  #..#. #.#.#.# .. .# #..#.#.###  #.#=# # .   .   # #. ## #.# #.#.#.### #....#  # #.###.###. .###.#.#.### #.##..#  . # #=.  #.# #.# .# #.# .#.#
#.# ##.#.##.#.#.#.######...# #.##.#. #.#.# # ##..# ##.#. ..#...#.#. #.######.# # # ..#.# #.# # ..#..#.###.#    . . . .#.#. ..#.#.. #.#...# #.##.#. #####..##.#.#..# .# #.#
#.#.   #.  . . ... . ...# #  #... ##.#.##..#.#.#.#.#..#.##.#.###.#.#. # .....## .#.# #.#.#.# # ##..#. .    #.#.##.####   #.#.# #.## .# ###.##.#.#.#. ....#  .# .#.#.#..# #
#.#.##.#.# ## ##.####.##..##.# ## .# #.=.# ###.# #..# #.# .# #.. #..#.# #.##...#.# #.#.# # #.#.# #.######### .#.#.#  .#.#..#.# #.#.###.. ... . .#..#####. ##=#.##.#.## #.#
#.##.###..## #.#.#.  #.##..#.##.# # . ####...  #.#.# .##.##..# # ### # # #=#.##.# # # # ##.#.#.# . ... .  .  # .. #.#.#. # # #.  .   ..#########  # .. . #....   .#  #   #
#.. ... .# ..# #.#.# #  # #. .#.#  #.#... .#### .#..#   . .#  ##. . .....    . .. . . .. . # ## ############. ####.##.# #  #=#.##.##.#.  .  .   # .# ###.#.##.# #.# #. #.#
# ###.##.# # #.#.#.# # ##  # # .# # .#.### # ..#.#.#  ##.##..# . ##.# # ### # ## #.##.# # #.....   . . . . #.# ... ...   #.#.##.### # ##########  #.# .#.##.##.#..# .#.#.#
#.#.# #   ## #.#.# # # #..#..##.#.## #.#.#.# ###.# ## #.##.#  ## #.. # # =#.# # #.# .#.#.# #.####.#.####.#.#. ## #.#.##.# .#. ..  . . .. . ... .#.# ##.#   .....#.# #. # #
#.#.#. #.# ... . #.#.#  #. #. . # .# #.#  .# . . #.. .#.#..# # #.## #. ..##.# . ..# #. #.   .#  #.##. .#.##  ##..##.#.# ## #.###### ###.#.######. #. ..#.###.# #..#..# #.#
#.# #.# . ########.### ## #. #### #  # # #.##### .### #..#.#.#.# .#  ###.#..#.#####..#..####.#.#.#.# ### ..#. .#. . ..# .#.#.# . .. #..#.# ..  .#.#.###.   #.# .# # #  #.#
# #.#. # #.. ..   .. .  .  #.# .. ##.##.#    . # #  #.# ##.#...#.# .##.#. ###.#.  ..#..# . # #.. ....#. .##..# #.###.## # .# .### #..#.#.#.#.#.## # ...# ##..#.#. #. #.###
###.###.# ###############.##.#.##. #  . .# ###.#.# # .# #   .###. #......# .  ##### .#..#.##.#.##.##.#.#...# ## .. #.#. =#.# #. .## ##.#.##.##.#. # ####.. #.#..# #.#. ..#
#. .  ...... . .. ....   .  ..#.#.#..# #.# #.#.#.#.##.#..### #. .#..#####.###.....#.## ## # .# #.# #..## # #.. # # #..#.# ##.### # .#..  ....  .# #..... ##..# ##.# .#.#.#
# ### #.# ###.#### #.##.# ## ##.#.##.##.#. ..# #.#. # # #..= # #..#.#..  .. . ###.. ...... #.##. #.#.#. .# #.##.. ## #.. ..  .   .##.#.##########. ##### . #=#.#. #.#. # #
#.# #. # #. #.#  #.# # ## #. #. #. #.. . # ## .# #.## #..# #.##..## #.##.#### #...###.# ##.# ..# # # .##  ##.  #.#....#.## ###### #    ...=     ..#    # ###.##.#.#..# # #
#.#.#### ## # .# ## # .# .##  # #.#. #### .  # #.# . .# # ##.  # # .#.#.. ..# .##.#.## # #.# ## .#.# # ..#...##.#.#####.#   ... # .######.###.# #.# ####.# .. ..# #.#  ###
# # . .. . .#.#   ...# .#..#.#..# ##.#...# ##..#..### # #   .##  ##.#..# # # .#   #...  .. # # # #.#. ##.###.#  ..   ...##.# ##.# #... .. # .#  # #.#. ..###.###  #  #.  #
#..## ## ##.# .#=##.#. ##.#. .# #..# ## #. # # # #. #.#..###.#.#..#.# #  #.##. ##.# ###### #...  ..#.# .  .#. ########## ## ##.# #.#######.# #### #.#.##...# .. #.# #. ###
# # ###.# # #### #.#.#.#...#.# .#.## . . # #.###.#.#..#.#. . # #.#. #. #.## #.#...#. . .   # #.##.# ..##.#.#.#..   ..  .  ..  .  .....  .. ... ...#.### ###.#####.## ### #
#. ..   ... .  .   . . .#.#.  #.# #..# #.#  .      .# #..###. .#  #.# #= ...# .## #########...##.# #.# ##.##..#.###=# #.#.# ## #.### #### ### ###.. = .. ...  . . ... .. #
#.# ## #.###.##.##.# ## #. # #... .#.#.# #.###.###.##.#.#  . # #.#. #  #.#.#  #.#   . ...  #.#. . . .. .  .. #.#  ##.# # # ##.# ## # #. # # ## .# ### # #.## ###.###### ##
#. ##.#.#  ##.# # # #..#. ## .###.# .#.##..#..##.# #..# ## #.#.#. # ###.# # ##..# ###.# ###.. #.# ##########.# .#... .. .   ..#.. . .#.#  #. . ##...# .#.# #.#.#..... #. #
#.#   # ## .#.#.# #.#.# #.#. # ... #.#.  #.#.#..  ..#.#..###.#.#.#....  . ..  .#...  # #.  # #. .#...      # #.#..##.## # ### #.##.#.# ## .### # .#.# #...  . .# ##.#.# ##
#.# #.#. #.##.# # #.. #.#..#.#.## #  #.# # # #.#.#.#. #.#  ..##...# ##.##.## #. #.#.##.###.#  #.# .## ##.#.# # .# # .# # #. #.##.##. # .# #   ..#.#.#.#########..#.# # #.#
# #.# # #. # .##. #.# # ..#. .#.#. #.#.# #.#.##.# #.# #.#.##...# #..# #. #.#.# ##. # ...  .#.#   # .#..#.# # #.# ..### #.# #  ... .#.#.#.=#.##.#  #.#. . . . ..#. . ... .#
#.# #.#. #..#  .# #=# #.#..#=#.   #..#.#.#  ..  ... #.# .#.# ##.  # #...#..#.# #..#..# #.#.#..#.##.# ##.#.## #. # # ...#.#  #.#.#.# .#..#.#.# .##.##. #.#.# #.#..#########
# # #.# #  #=.###.### ## .# .#.##..#.## #..##.##.#.#  #.#  # # # # #.##.##.## #.##.## # ##.#.# .# .#..  ...  #.##  # # # # #. #.#  #.# #..#. #. #...# .## ##.#.# .. .   .#
## ##.#. #  #. . ..   . #..# #..# #.. .. #.# #.##.# #.#. #.#.# ..   .  .... ...  ...     ..#..#..#.#.##.##.# #.#. #. # # #..#..## #..#..#.#### # .#.#.#...  . .#.# ### # #
#.. .  .#  ##.#.#.######  #  # #. .#.#.## .#  ..... #.# ##.#.### ##.########################.#.### ###.##.#..#.##. #.#.#.# #..# . .#.#.#. . ....#.##.#.########...#  #.# #
#.#.# #  #.#  #.#.#.. .### # ##.###. #.#.#..####### #. ...      . ... ... ..  . ...  ..     ... . . ...... # #. # #..#.#. ..# #.# #..#. ######### ....    . .  # #. ##.#.#
##.#.##.# .##.##.##.###.... ... . .#.#.#.# # . ..  . .### #.#.## #.# # # ##.## ###.##### ######.# #.###.##.#.#.# .####.#.###..##.# #.#.#  o ... ..########.#.#.#.##.#.#.##
#     ..## .# ....  . #.############.#.#.# #.##.#####.#.##.# ##=# #.#.# #.###..#.#.# ..#.. ..  #.#..#.#.#.##.# ##  .. .  ...# ... .#.# .#######.#.#.. ...#. # ##  .  ... #
# # ### .#.#  #=##.#.# .# ..        .# #.# .## #..... ..  .. .... .. . . ....#.#. ## ## ######## ####.#.#.#.=#..=.### ##.## #.##.## .# #. .  .#.#  #.## # .#. #..#.## ##.#
###.# # #..##.## ##.#.# .## #.#.## #.# # #.#.. ..##.#.# ##.#.# #.## #.##### #. #.# ....   ....  .   . #  ..# ## # #  # #.# # .#.##.# . ######.#.# ##.#...# ##. #.#.  #=#.#
#...#.#. #.  .. .... . .#  #.##. #.# # # #.#.#.#.#.#..#.#..#.#..# .#.#. ..#..#.#..## #####.##.##.#.##.#.#.#.. #.# ##.# # .. #.#.... .## ...... .#.#.  #.#.  #.# .#.##..#=#
# # ..# #.#.##.##.### #.##.#  ..#..#.#.# # #.# #.#..#.#.##.#.#.#. #..# ###.### # #.#.#... . #.# #.. #.#. #.#.#. #  #.#.#.###...## ##.#.######## # ## ##.#####. #.#...#.# #
##.#### # .#...#. #..# . . .#### ###..##.## #.#.##.##.#. #.# #. # .# #... .....# # #..##.# #  #.##.#..#.## # ###..#. . .....# #..#.#.#... ....  #  ###.. . ...## # ### #.#
#. . ..  #..##. #  #..#.# #.# . ..  .# . .  ... . .  .#.##.#.# #..# . # ##.### #.#.# #. #  .#.. .# .#.#.. .#.. .#..#.# #.### . #.. #..#########.#.#  . ##.### #..# #... .#
#####.# ##.#.###  #..# . ##..####.## .###############.### #.#.# #.##.# ## ##.###.# ##.# ####.####.### #####  # #..#.#.##.. .#.##.##  #...  . .. #.##.# #..  #..# #. ####.#
#   #.#... .  ..#..#  #=#.  #... #.# #     . .   ...#.  . .   . =......  . . .   ....  . .. . . .  . ..... #.#. # #.  .. ##.# #  # #..##.### ## # .# # ##.##..# .#.#.....#
# #.#.#.##.## ## .#..##  ## #.##.# #. # #.#.## ##.##### #o# ##.##########.######.#.## ############## ### ## ..###  #.#.#.#. # ## #.# #.#...#..# #.#..#. #.# #..# ##.######
# # # #.#. #.#.## ##.#..#.#.#  #.#.# #.#.#.#.## # #.#.#.##..#.#.  .. ..  #.. .  # #.. #... ....  .. #.  #. #.# ...#. .#. ##.#. #.# # #...#.#.#. # ###.##.##.# #.. .......#
#.#.#.# .# .   .#. #.##.#.#.#.## # #.# ..... . ...#.#.#...#.# #.#########..###### ###..#.## # ##.##..#.#..#.. ####.###.##.###.## #.#  ###.# #.# #  .  .... ... #.##.#.#.##
###.#.#.# ######..# ..#.# #.#.#.##.#.#########.## #.#.#.##..#. ..  .  .. # #.. .... ..#..#.#.# #.#. # .##.## #    .... =. ....# .#.# #  .. ..  .#.#.### ##.#.##..# ##.##.#
#. .. #.   ... .#. #.#..# #.# ... .# . .. ..  # #.#.    #.#.# #.# ###.#.#...##.#.## # .#.# .     .#..#... .# # ####.#########..#.. # ###########...##.###.#.## #.#.. ..# #
# # # # #.#.#.##  #.  # . #..##.##.#.########## #..##.# #.# #. #.##.##.# #.#.##.#.### #   #.####.#  #..####  #   .#.#.  ....#.#  ##..   .. . ...# #  . . .    .. .### # .#
## # ## ## #.#.##.##.#  #.# ### #. #.#.. ...  .  .# .#. #.# #.#.. .    . . #. ..  . ...# # . ..# .#. #     #.#.###. # # # #.#  #...# #.##.#.# #.#..#.#### ##.# # ##.# .#.#
#. .  ...... ...   # ## # #..# # #.# #.# #.###.##.##  #.#.#.# # ##.#.#####.##.##.###### # #####.###.##.#### #.##.### #.##.### ##.## #.#.## #.#.# .#.#.. #. #.#.#. . # #..#
###### #.#.## ### #.....#.# #  ... #= # #.#..#  #. #.#. ..#.# # #..#.....#..## .#..... . .  ... .. ...... .. ... .  .... .   . .  . ...=..   ...#.#.###.### #.## ## #. # #
#.... # # ## .#.#..####.##...###.#.# #  . . #. # .## ## ##..# #..#.#.# # #.#.  #.#.#.#.##### ##.#.## ##.#### ######## #.########## # ###.#######. # ..  ...... ..# .# #..#
#####.  ..  #=# #.#...#   # #.   # #.#.####.## ##.#    .#.# # ### # #.# ##. #.## # ##.# .  #. # #.#.# ..#.  #  ..    #.# .  ..    # #...#.......#..#.##.#.#.#.##. ###. # #
#. .. ## ###.. .# ##.# .##..#####  # #. . #..#..# .# ## #.#.#......  ..... #.....# .#  #.# # # # ## ####.#.## ########.# ########## # ###.# ###.#.# # ## #.# # # #... #  #
## ##.#  ...# ### .#..#.###   ...#.#  #####.#  ##.#.# #.# # ##############..#.### .## #.##.# #... .....  .   .. ..   ..... ...     .... ..# # # # #  .  . . ...  # ##.##.#
# #...#######.#...#. # ..## ## ##..# #..   ..#.#. #. .# # #.... . ..    .# #. # .#.# . . ..#. ############.#.# ##.#.#.##.# ###### ##.# ## #.#.#.# #.##.#.##.#.## #  #..#.#
# ###. ....    ##.## .#.#. . #.###.#. #####.##. #.#.#.#.# #.############## ## # #...#.## # #.#. . .. . .. # #.#.#.# ## .# # .  . # #..# # # #.. #  # ## #.## # #.# #. # .#
#....#.# #.## #....# ## .##.#.# ##.# #  .  ....#..# #.#.#.#.... .. .. .. . .  . .#.# .#.#.# .# # # ##.#.#.# # #.# #.. #.#.#.## ###.####.# ##.####.#....  ....... #. # ## #
#### #..#.# #.#.#.# ....#.. # .. . . .#########.# #.###.#.#.### ## #.##.#.## ###.# .#.. #  #..#.#.## #.##.#.#.#.#.#.###.#.#.#.#..... .  .. . ..  . ########.#### .##.#.# #
# . .# # . .# ##..#.#.# # #..#.##.##.#....... .... ..   . #.#.. #..# .#..# ## .##..# .###.#. #  . .. .. . #. .# # #.#...# #. .#.######### #.# ###.#. =.. .# #. # # ...  .#
# ## # .### #.. # #.#.# # #.#.. # #...#.## #.##.#.##.##.##...##..#=#.#..#  . #. .# .#..  ..#.############.###.#..# # ##.#.#.###... . .. .# #.# . .#.###.# # # #..#.# #.#.#
#..#.####.#.#### # #.##.##.# ### #.#.#.#.## # ##.##.#.#.#.#.##.###.#..#. #.###.##  ## ##.#.#.  ....  . ..   . # #...... ....  ..#.# # # #..# .# #.#.#. .#.# #  # .#.#.##.#
#.#.  .... ... .. ... ......  ..   .    .. .   ......  .# #.#   ....### #.  . .  # #..#. #.# #.#.## ##.##.####..#.#############..#.# #.#.# #.#  #.# # #.#.# #.# .# ...  .#
# #.## #.###########################.# #.#.############ ..#  ## ## #=...# ##.#.##. ## .#.#.# # ##.# #.#.# # ..#.# .... .....  #.#. ..  . ..# .#.#..#.#.##.#.# ## .#.# ##.#
# #.# ## #... .  ......  .... . . ....# ##      . .   #.##. # ##.#.#.## .##.##.#.#..# # .# #.##.# #.#. .#.#.### #.#.#.#.# ##.#..#### ####### #.#. #. .... #.# .#.#..# .# #
###.#... #.##.########### ## #######.# .. .############.# #....# #.#. #.#...  .. . ##.###.##..... #. ##.# #..  .#.# #.##.###..#.....   .... . ..#.####### #.#.#. .#.#.# .#
#..  ###.#..#.#.. ......#. #. .....#.# ###.#.. ... .   .# # ## #.#.###   # ## #.##.#.  .= =..#.### .# ..# #####.# # #.  ..# .# .## #######.##### ...... #..##.## ## # .# #
### # .# # ##.#.#.#.### #.#..###.##.  ##.#..#######.###.# #  #.# #%...# # #.#. #.# .#.#.# ##=# .  # .##.# ..= #.# # #.## ### ##  .# .   ...  .  # ### ##. #....#.# #.### #
# #.##.#.# # .# # ##  # #..#. ..#. # #.... #  . .. # .# #.#.# #..#.# #..#.#.#.#....# # #.##.#.####.## # ####### ##.# # ## #.#.####.############## #.###.# ###.##.. ...  .#
#.#.. .#.# .#.# ## # # ## # .###. #. .## #.## # ###..# .# #.#.##.#..# # #.. # .#.#  . . . .. . . .   ...    .. . ......   . . . .. .. ...   .   .=#  = ....  ... ###.#.# #
#   ### .# ## #. . . .....## . .#..# # # #. #.#.  .# .# ..#. .. .#.#  # # ##.=#.. ## #.# ## ##.# #.## ## ##.#.#.# #.# ###.#######################. ## # ##.#.###.# # ##..#
###.. .# # #. .#.# #.##.#  #.#### # .#.# #.##.######.#..## =#####. ##.# #.#.#  # #.## # #.#.# # ##..#.#..#. ## #.# #. #.# .. .  .  ........  ...#.# ###  ### #.#.# ... # #
#. .##.# # .#.#  #.#.# .# #.... .. #.  #.#.......... .#. .#.... .#....# #...  #. #. ... ..  #.= .  #  .#. #....  . .#.#   # ##.#=#.##.##.# #.# #  #   . # ...  #.# #.# # #
##########################################################################################################################################################################
