################################
#.##.## # ##.##.# #  #  # ## . #
#    .     .    # .#. #..   # ##
############### #.##.#  ### # .#
#.    . . .  .  .    ## #.# #o##
# ### ####.## ## ###..# # # # %#
# ..# #  o # #=### # ## #.# # ##
# # # # ## # # ...   #  # # #..#
## # # ##.## #######. #.# . #.##
#    . ..= ..  .. . .##  ##.# .#
##############.# # #.#  # ##. ##
#.    . o     # # .#  #. ...# ##
## #.### #\# #   ###.# .#### ..#
## # # #  #.# # #. .. # #   #.##
# .#.# #.#  .  . ### # ..##.#. #
##.# # ## #####.##.#  # #.  #.##
# .# . ..     #.   #.#  ###=#. #
##.#.##########.####  #     # ##
#  # #    ... .... ..#  ### #  #
##.#  ## ##.#.##.###. # # .# .##
#  # ## ## # ## ## # #. ##.##. #
## #.# =   . ...  . . #.    # ##
# .# .## ## # # # ##.#  ####   #
## # #  #  #.#.#.#.#  # . . # ##
# .#.# # .#  ..      # .## # . #
## # # ## ########## ##.# # # ##
#. #.. . .. ..    . . .        #
## # #### ##.### # # ### # ## ##
#. #.#..  # ##=## #.## ##.## # #
##.# ## # ..             ..... #
# .#. #.#o#.# ## ##.##.##.# ##.#
################################
