#####################################################################################
#. ..# ..   .. ....  #. .# # # # #    . .  . ..  .        # #. # .. . #. #.# ##.##.##
# ##.###############. #.#  # .....# #.## ###=## ##.##.## #  #.## ###### ## .  ....  #
#   .  .   ...    ...#. .#   # ##.# ## ### # # .#.#.. .# ##.#.... . .. ...#.###.# ###
###.#.# #.##.# ## ## ### #.#...#..#    .   #  #.. ..# #  . .. ##.## ######     #.##.#
#. #.# #. # #.#.#  #..   # .## ####.##.##.#. #  ## #  .#.##.# .# .#..  .. # #.#  . .#
##.#.#  # .    .#.#  ###.#.#.  ..... # #  ##  # #.# ####.# ## # ## ###### # ###.#####
## # # # ######... #.#...# #.#.#.##.# ..# .#.#...        .   .   ..   . ##. .. .  ..#
#  #.#... . ..  #.#..#####.## #.#.#.####.###  ## # # ##.#.#.# ## ###.##.. #.# # ## ##
## #.# ### #####. .#. ... . .  .... ... . .. #. # #.# #.#.# ### ## ### .##. ..# # #.#
#  #.# #..# .. .# #.#.## ##.# # ## # #.## ##..#.# # #.## ## ..  .     # . # # #.. ..#
##.#.# #.#  ###.# #  .#.##.# # ##.##  #.## # #   .  # .. ...# # ###.##.####.#.#.## ##
#.  .# #..#.# # #  ##.#.#..  #.#..  .#       ##.### ########.#.#... ....... # #.# #.#
##.#.# # # ##.#.# #.# # ##.### ### #.##### #.      ... .. . . . #.##.### ###.... =  #
# ## #.. .  .. ... .#. .=  ...=   .#  .. # . # ### # #.### ##.### # #.   ...# ## ####
#....#.### ## # # #.# #.###########.#.### ## ###.##.# ##.### #   .#. # ##### .#.#. .#
####.### ###.#.##. .# .## ...  . .      .  .   .. .    ..   ..# #.#.#. .    # # # ###
#.. .   ..   .    # #.#.. # #.#.### #.###.##.#### ###.# #######.#   ##.##### ## # # #
################### ## ##  #.#.#  # ### #. #  .. #.  #..# ...  .  # ..   .. . ..... #
# .. . ... ..  . . . .    #   .# #. .  .# #. ##### #..#. ######.#  #.######.##.#.# ##
# ####### ##.#####.# ##### ###.#.## ####.#.# #.   .# ## #. .   .#.#..#  .   #..# # ##
# . .. .. # #.  .# # .  ..   . .   . ...  .# # #.# #.#.. # #.## #  # #.## ## #.#.#  #
#.# ##.## # .## ##.#.#################.####. ##.##.# ##.#.# #.### # # ## # #.#.##. ##
# ## # # .# # ..  .# #  .   . . .   .   ...#. .  . .  .   . .  .    %..  .. ..   #..#
#. . # .#.#. ##.#.## .##.#.# ###.## # ##.##.##.###.#### ##.#.# ##.##.#### ####.###.##
#.### .#..#.#  .# #  #. #.##.  . # # #   #..#.## ###..#.#.# #.# # #  #. . # . .#   ##
# # ##..# #. ## #.## .# .....### #.# ###.#.# . . ..  # ... ...  #..# # ##..# #.# #..#
# .. # #. # # # # .#.# ## ##.# # #    .#.#. ##.#.####.####.###### # # #.### #.. # .##
# ####..# #.#.# #.#  # # # #.#.# # #.#.#.# # ##..   . . . . .. .... ..... . .#.### ##
# . . .##.# #.. ...#   .   # # # ..#.## # . ...##.##.## # # #.# # #.# ####### #.##..#
# ###.# . # # #.#.# .## ###   .#.# . .... #### # .# #.## #.##. #..      . .    . .=##
# #.# .##.#. .#.#.## .#.#. #.# .  #### ##.# .. .#.#..  .  .   #.## # ###.#.######.# #
#.# # # #.#.#.. .#.#.#.#.#.#.#.##   .#.# .#.## #. ## #.##.# # #.# #.#   ##.#.   # #.#
# # # #.# #.# # #..#..     #.   .###.# ## ### ..#...# .#.# ..#  # # ##.#.. ## # # . #
#.#.#.# # #.#.# ##.#.#.### # #.#.# . #..#. .=#.#. ###.## #.## # #.#. #..## . ## #.#.#
#.# # #.#o#.# #. # #.#.# # #.# #.###.# ##.###   # .   #...#     # # #..#.# ##  .   ##
#. .# # # # # # #  # #. .# #.#. #. # ##...#..#.# #####.# # #### # # ## # # ## # #.#.#
#.#.#  .#. .#.#  # # . #.  #.# #  # .  .#=##.# .... .         .  . .   .. .   # #.#.#
#.#.# ## .#.# # # .# # # # #.#  #. #.##.#    .# ## ######.## ## #####.#### ##.#.# #.#
#  .#.#.# # #.#  # #...#.# # #.## ##.# ## ## #. ..# . . # # ...#...  .. .. #...## # #
# #...#.#.#.##. #. #.###.#.#  . ..  .   . ..##=##..#.##.#.# ### ##########. # #. .#.#
## ## # #.#. .#  #.# # .  .#.# ## # #.### #. .    ##  #.# .  .    . . . .#.#. .##.# #
#. . . .# #.##..## #. #### # # #.# ##.# #  #.#### #  #..# ## ##.##### #.#  .#.# #.# #
#####.# # # ..#.# ...#   # # #     .. .   # # . #  #..#.#.# #.# ....   # # #..#.....#
#    .##. # ###.# # # #.#.##.# #### ## ## #.# ##..##.#..# #    .### #.#. #. # ..# ###
#.# #.. # # #...# .   ..... .#. .. ## # #.    ..# #  ## #..#.#.#..#.# .# # #. # # # #
##.## #   #. ## .###########.# ##.#. .. #.##.## #  #. . # #.# ## # ## # .# .# # # #.#
#  . .#.#.#.# # #... .  . .. #. #.# # # # ## #.##.##.##.#.# # ..  ..  .# #.# .# # . #
### #.#   #.#.# .######## ##.#.#.##.# ###. .  ... #.....#.# ### #####.##.#..#.# #.# #
#...# #.##  #.#.#... ... ..# # # . .#  .\# ##.##.#.# ## # #    . ..... ..# # #.# # ##
##.##    .#.#.#  #.#.##.#.#. #  ### #### ###.##.## #.#..# ####.###.# ##.# . ....  . #
#.....# #.#.#.#.#.# ##.##  #.#.#. .    . . ..  .     ## #  ... .. #.# ##.# ## # # #.#
#.# # # # # #.#.# #. .    # .#.# ###.#.#### ## ##.# # ..#.#.## ##..  ... #.##. # # ##
#.# # # # # # # #.# #.###.##.# #....#.#. ... ###.##.# # #.# #.# # # #####.. . #. # .#
##.. .#.. ......  #. # .# . .# # #.#. #.# #.#.   . .# #.# ..  .    =. . .# ###.#.# ##
#.##.#.##.##### # #.## ##.##.#  ..# #.##.#. .#.##.#.. #.# ########## #.# #.# .  .# ##
#.  .    ##. .  #    . . . # .##.# .   .. #.#.#. .# ##. #.# .. .... #.#.#. .#.## #. #
### #.##.. # ##  # #.##.#.##.#.#..### ###...# ###.###.#  .#.# ######.   .#.##  # #.##
# #.## # #.#  # # ## #.##.#  #=#.#    # # #.......   .#.#.# # ..    # ####.. .#..# ##
# .....#.# # #...   .   . .#.. #.#.## .  .# # #.#####.#.# # # #.##.#. #  ..### # # .#
#.# ### .. . .#.### # #.# #.o##. # .# ### #.# # #.... = # #.## # #.##.####.#.  #.# ##
## ##.##.##.#.# #...# ## . #.  # #.##.# ## #.#.# # # ##.#. . . ...  .....#..# ## #..#
#.   .   #  ## . ####.. # #. #.#  #    .  .... ...# #.#.# ##.#.#.##.##.##. ##.# . .##
### #### .#  .# #... .##.. #.#.# # .# #.# ##.#.##.#  ...#..## # ##.# ## ##.#  .# # ##
#.#.#  #.# # #  .##.# # # #  ##.# # ##.#.## ##.## ##.## # #     . .. . . . #.### # .#
# # # ## # ##.#.# # #.  #..# ..  .. .. ..   . .  ..  .#.#  ##.## #.#.#.# # #.#   #.##
#.# #.#. # . ...#.. #.##..# .##.### # #.# ###.# #.###.# #.#. .#  # .#.#. #.   ## #..#
# # #. # # #####.## #.#.#  # # ##.##.# # ##.## #.##.#.  # .###.###.#. ### .# #.# # ##
#.#.# ## . .. . .#  #.  # #  #..   .   # ....     ..  # #.#  . . .# #  ..# # #.#.# .#
# ..#. ..#######..### #.#..#.# # ## ##.#.## ## ###.# #..#. ######.# # ## #..##.# #.##
###.# ##. .    # #. .    .#..##.## # # ## #.=# #  # # #.#.#    .  .. .# #  #.    #.##
# .  ...#### ##. #.## #.#. #. . .  .... ... #  ## #. .# # ##.##.#####....# ##### #. #
###.#.#   .#.#.#.### #.## ## ############### ##.#.#.###.#...# #..   # #.#  ....#.  ##
#. .#.#.### .# .     ....   . .. .   .  .. .   ... .  . # ### #######.## #.##.#..#  #
###=# ###.#.#.## ######.#################################. o  =.  ..      .##..#.# ##
# . .. .... .. ....  .   .    .. . =  .  . . . .         .##.### ##.# ## ## . #. .. #
#.# ## ##.#.#.# #.## ### #.## # #### #.##.# ##### ### ###.#  ..  # # ##.## ##..# #.##
# #.#.## #.#.#.# # ##. #.# #.# .#...#  # #.#... #   =#. #..##.##.. . ...   .. #  #  #
#  .     .. ... ...  # #.#.# .# ###.## #.# ## ##.# ## .#  # ##.# #### ## # ##.##.#.##
# #.#### #############.## ##.#..   ... .    .. .  .  #.## #. .  .#  .#.# #. #..  . ##
# #... #  ..  ....   . . .. .## ###### ##### # ##.## # .  .###o##### # # # #  #.#.#.#
# .#### # ##.#.# #.### ###.#..# #      ..... . # #..#  ##=#....#.# ..  . #. #.#.#.  #
# #.  . ..# ## ###.. # # . #.# ##.####.####.##.#.## ####..## # #.##### #.#.#..#.#####
# .#.##.#.#...    .#.#   #.# ......  . # ... # .. ..    #.   #.#.. ..  ..#  # .. . .#
#####################################################################################
