#####################
# # # ### # #. %  # #
#   # .#     #o##   #
# # # #  # #.#.# ## #
# # #  #. ## #    # #
##  # ## #  # ## ## #
# #.     ##    .# ..#
# # ##### # # # # # #
#o      #.### ## #  #
## ### ##         # #
#    # # # #### #\# #
### #  #  #   #= # .#
#   ## #.#. # ## ## #
###  # # ## ##  .   #
# #.##  o      #.## #
#.#.# # ## ## ### . #
#.  #=# # #  # # ##o#
###   #   #.## # ##.#
#  .#### ##..    =  #
#.#   # =  # ## # # #
#####################
