############
#o . #.#   #
####.# ###o#
#  .\ .   .#
##.##.###.##
# ##. #.  .#
#   # # # ##
# ##. #.# .#
# #.#.#%#.##
# o     #==#
## #o# #==##
############
