##########################
# # . . . ##  # #.# #.  ##
#   # ## #   #  #   .##. #
### .# #.  ## # ## ## # ##
#  .#.  ## #  #.      #..#
# #.# # #   #.## ####   ##
## . . # # #.   . .  ## ##
#.# ## #.  # #o######    #
#. # # .##  ###     .## ##
## #.  # =# =#  ####..  ##
#  .# ## # .# # # . # #  #
## ###.   # #   # ## #.###
#  ##= ##.# ###  ...  ...#
##   \# ###  . .## ##### #
# ###.    .## # = #      #
#o#   ## #.#..### ##.# # #
# # # .#.# ##   # .# ## ##
#. #  # ##  ..##.##  .  ##
# ## ## # .# # . .### #. #
#     . # ### ## #. # # ##
#######.## #   ....#. # %#
#     .    . # ####  # #.#
## # # #.# ## #.   #.  .##
##.# ##o## #. ##.#   ##  #
#o  #       # . . #.# . ##
##########################
