####################################################
#..#.. ... .#..# ..#=#.#.#.#..#.#..... ..#.... #.#.#
##.#.###.##. # #.###. . ....#.#. # ## ##.#=#.##..# #
#..#.#.# #..#..#.....#.#.###..#.#..#.##.##.###.#.#.#
##.#...#..#..#..#.##.# # #..#.#.## ......... ..#.#.#
#..#.#.# ## #..#..#..#.#.#.#.... ..##.###.###.# .#.#
##.#. #.#....#..#..#.#.#.#.###.#.#..#...#...#.##.#.#
##.####.#.####.#..# .#.#.#. .#.#.#.# .#.#.##...#.#.#
#............ . #..# #.#...#.#..#..##.#.#.#.#.#..#.#
##.##.##.#.#.#.#. #..# #.##. #.#.#..#..## #...##.#.#
#.#..#. # #.#.. #..# #.#.# ##..#.#.#..#...# ##.#.#.#
#..#.##.#.#.##.#.###.#.#... .#.#.#. #.###..#.#.#.# #
##.#.o.   .... #......##.###.#.#.#.# ...#.#......#.#
#...# ## ###.#. #.##.# ..#.#.# #.#.# #.#..#.# ##.#.#
##.# ##.#...##.#.#.#..##.#.#.#. .#..#.#.##.#.##..#.#
# ......###.#......#.#.###.###.##.o#....  .....#.#.#
#.#.#.#......#.# #.# ..... ....#.#.##.###.#.#.#..#.#
#.##..#.## ##..# ....#.##.##.#.#.#  #.#...#.#. #.#.#
#...#.#.# .  #.######.#.###.#.##.# ##.####.#.###.#.#
####.##.###### .............  .... ..... .. ... .#.#
# .............#######.###.###.###.#### ##.#.## #..#
#.##.## ####.#    ...#...#.#..#..# # ..# #..#.#. #.#
###.##.##..###.######.###.# #..#.# #.###.#.##.###..#
#.... ...#.... #............. ##.##......#...... #.#
#.######..#.##..### ##.## # #.# ...#.###.#.### ##..#
#.#......###.#.#. .# #.#.#.#...#.## .# #.#.#.#.#.#.#
##.#.#.##.##.# ###.#..##....#.#....# ..#.#.#.###.#.#
##.#.#.......#...#.# #. .###..##.##..#.#.#.#.. ..#o#
#. ..#.##.##.#.#.#.#..## #.##. #.#.#.#.#.#.#.##.# .#
######.#...#.#.#.#.#.##..#..#.#....#=.##.#.#.#.#\#.#
#.....=#### #..#.# #...#.#.#. .# ##..#...#.#.....#.#
######.......# ##..#.# #.#.## ##.#.#.#####.#.#.##..#
#. ..#.###.##.. .#.#.### .. #..... ........# #.#.#.#
#.## # #.#.. # # # .. ...### ##.##.##.####.#.#.#.#.#
## #.#.#.#.#.#.#.#.# #.#.# #.#.# #...#...#.#.#.#.#.#
#..... #.#.##..# ##.#.## #.......#.#.#.##..#.#.#.#.#
#.##.# #.....#.#...  ......#.# #.#.#.#...# #.# # ..#
#.#..#.#######.############.#%#.#.#.##.##.##.##.##.#
#.####..... ..... .................... ... . .  . .#
##.. ..##.##.# ##.##.#.# #.#####.#.#.#.#.###.###.#.#
# ####.#.##.#.##.##.#...#.#.....#.##..#.#..#. ..#.##
#......#...... ......#.#...##.##... .##.#.#..#.#..##
## ##.##.##.#.# #.##.#..#.# .. #.####...#..#.#.##. #
##..###.#.#.##.#.##.##.##.### #..#. #.#.# #.#.# #.##
#..# ....  ... .... ..... .....#.#.#.##.#.......  .#
## #.#####.#.# #.###.#.#.####.#..#.#....#.###.####.#
##.#.....# .#.#.##.#. #.#.. #.##.#.#.##.#.#.... .# #
#..#.#####.# ........#....#.# .#.# #..#.#.#.# ##.# #
##.#.#.....#.######## #####.###..#.####.# ## # ##.##
#. #..# ## #  .. .......  . ...# ..................#
##.#.# ..# #.#.# #.## #.# #.#.#. #.#.#.##o# ##.# #.#
####################################################
