################################################
# #.# ... #..  . ......# # #.. .........# # .#.#
#.#..####..#.#.##.## # # ...# ##.##.#.#.#. #.#.#
#.# # . ..###..#.##.## #.##.#.#.#.##.#.##.##.#.#
#...# ###..# #.#.# ... # #.#...  .........  .. #
#.# .#..#.#..#.#.#.## ##.....###.#.#.#.##.##.# #
#.#.#..#.. #.#....#....  ###.#.##.#.#.#.###.##.#
# # ##.##.## #.##.#.####.#.#.#.. .  .......  ..#
#.#... .#. . #.#..#..  #.  # #.##########.### ##
# #.#####.### #.##.####.###.##..... .=...#  #..#
##..... .. ..... .....   ... ..#.# #.# #..#.. ##
#.#.########.##.# #######.##.## # #.##.# # #.# #
# #=#......#.# #. .... ..#..##........#.. ..##.#
#.  #.#.#### ...#.#.##.#.##.#.#### ## .#.##. . #
###.#..##.. #.##...#.###..#.#.#..#..#.##.#.#####
# #...#.. ###...# # .o...# . ...#.###.# . ... .#
#.# ##.##. ...#.#..## ##..#.###.. ...  #.#######
#.#..   ###.#.## .# ## # #.# ..##.####.#... ...#
# .## #....##...#..%.# # # # ##.# ...#.#.##.#.##
#.#..#. ## #.###.##.#  ..#.#......###..# #.#. .#
#.#.#.## #...... .##. ####.##.# #.#..#.#.#..# ##
#.#...... #.#####.  # #. ....#..#..#.# # # #...#
# #.# #.##.#... . #.##.##### ##. #.#...#.# .# ##
#.#.#.# o#.######..#..... .... #. # ##.#.#.#.  #
#.#..#..##. ......##.#.##.##.#.# # ....#.#..# ##
#.#.#.##..#.##.##. ..## ## ##.#.##.###.#.# #.  #
#..... . #.#.#.#.###.   . .. ... . #  .# # #####
#.#.#.## #.#.#.# #.#### ####.####.#.#.##.   ...#
#.#.#.##.# #.#.#........#. ..#   ....# ..##.##.#
#.###.. #. #.#.#.#######..##..### ##.#####.# ###
# . .###.#.#...#........#.#..##.#..# . ..... ..#
##.#=. ..#.###.#.# ##.#.#  #.. .#.#..#.## ## #.#
#. #.# ## ..  .#.# # # ..##.#####.##.#.#.## #..#
##.#.#  .#.## #..#.#..#.# ..... . . .#.#.# .##.#
#..# #.##..# #.#.###.# .#.#######=## #.# ## .#.#
## # #..# # ...# ....##.#.#..o. #.#. #.#.. .## #
##.#.#.##..#.##.#.#.# ..#.\o#####. # #.#.####..#
# .#.# # .#   . ...#.## # ##. ..  #..# #. ....##
#.##.##.# .## #.#.#.. ..## .#####..#.##.######.#
##........### #.#.### #...#.......#... ... =.. #
#..#.##.## #...#. . .#..##.###.##..#.# # ##.##.#
##  #.#.#..##.#. ###. #.... .###..##. ## ..#.# #
# .##.#..#..#.##.#.###.###.#. ...#...# . ##..# #
##... .## .# #........ ...## ##.#.###..#.#.#.# #
## #.#.#.#... #.##.# #### #..# .... .# # #...#.#
#. #.#... # # ###.##....#..#..#.##.#.##. #.### #
##.# #.# #..#. ......## #.#..#. #..#...# #.... #
################################################
