#######################
#   ...#=#..#...  . # #
##.# #....#.. #.# #%. #
#.#  .#.#...## . ..# ##
#...#  ..#.#...# # .. #
#.#. # # # ..##. ..##.#
#  #..#....## ..##..#.#
##.##..## # ..# # #. ##
## . #.. . ##..... # .#
#..## #.##.=.##.# ###.#
#.##  ..# .#.. .#. #  #
# # .##  #. # #..#...##
##.\#. # ..#. # # .#..#
#. ###.. #..#.  . # #.#
#o###. #..#  .###  o .#
#  #o #. #. # .# #.## #
## .#.. #. ###. ....=.#
#.#. ##. #. #..#.#.# ##
#.##   #..#. #. =..   #
#. ##.###..# .# #o#.#.#
##..##.##.# #..#  .. .#
###..  . .. .#. =#.# ##
#######################
