##########################################################################################################################################################################
#.#. .. .... .....   .  .   .   .. ...   . ...  .. #. .## # #... . .  . ..     ..#.       .... .  #.##.#.#.##.#. . # # #.#.# #.## ....    .... . .... . ## # . .  ... .  #
#.  # # # ## ##.##.## ##.## ###### # #.#.# #####.#.. #.   .   ##.#.## ## # #.#.#   ## #.##.#.####.#.      ..  ..##     .   ...   .##.## ##.## ##.#.##.#.. .. # #.#.#.# #.#
### . . . . . .    .  ##.   .... . ..  # # #.###. .#  .##.#.#  .    ..        .  # .     .      . ..##.# # ## #. ..##.## #.# # ##. ..    . .. . .  . .. ##.# ....   .    #
###.## #.##.#.#.## ##   .## ##.### #.#. .  ... . #...#.  .. ..## #.##.## #.# # #. .##.# ##.#.## # #.  ...#. .. .##.#.  . #.# ... .#.# # ##.## ##.# ##.#.## # # #.#.# ##.##
# ...  .... .. . ... .## ...  ..   # # #.# ## ## # # # ## # #.##.#.  .  .# #  .  #. .. . . .  ...  .## #.. ##.# .  . ###  . .#.##...   .    ...........   ... ... .   ..##
### # # # # ## # #.##.## ##.##.###. .   . ..  ..  .    . .. #.## #.## ##  .. # # # ##.# ##.#.#### #.## #.# #... ## # # # # #.#.## # # # ##.##.## # ##.# ##.# # # # # ## .#
###.#.......  ...  .. .    ..   ...##.##.# ##.## #.#.# ## #. .     ....  #.# #.    . .  . .     . . .      .# # ## #.  .........  . . .  .    ....      .. ... ..  . .. ##
#. .. #.#.# ##.#.#.## ##.##.##.###.##.####.## ## #.. .. .. .# ## #.## ##.   .  # # #.# # #.#.# # ## ## #.#.#.    .  .#.#.# # #.#.#.##.#.## # ##.# #.#.# ##.#.# #.# # ##. #
# # #.. .  ..  ..# ## ## ##.#   .  .....    .... ..# # ## #.  ## # ##   .# #.#.  # # #.#.# #.# # ##.##.# # ##.# ## #.# # # .  .. .     .   . .# # ..# # ##.#.#  .# #.## ##
#.#.#.# # #.## #   ... ...  ##.##.## ## ##.## ## #... .  .  #.... ....## #.#.# #.      ..   .. . . .  ..... =  .... . ..   # # #.#.## # #.#.#.... #    .  .. ..#  .  ... #
# .. ...   ... ..#.# #.#.##.   # ..# ## ## ## ##.  #.#.## #. .##=##.# .   .  . . #.#.# # #.#.##.# # ##.#.#.## #.## #.#.# #.# #.#.# ## #.#.#.#.# # #.#.# ##.# #.# #.## #.##
### #.#.#.#.## #.      ...  ##  #.#  .  .  . ....# . .     .# ## ## # ##.#.# #.#...   .  ...   . .  .. ..    . . . .  . ..  . ..  ... ..    .    .    ...#.#    .  . . ..#
# # # #.# # ## #.#.# #.# ## ##.##.## # # # ##.## # #.##.#.#.....  . . . ....   . ##.## #.#.#.## ## # # #.# ##.# ##.## # ##.#.## ##.##.#.#.# # # # # #.# #....# #.# ## # ##
#   . . ...   ...   ....   . .. . ... .  .. .   . .  =. . #.#.##.##.#.##.# # #.#.##.#.## # # ##.## # # #.#.#.# # # ## # ## #.##.## ##.#.# # # #.#.#.#.# ##.# ...  ... . .#
#.# ##.##.#.##.# # # # #.#.# # ##.##.#.# # # # #.#.# ##.#. .# # #.#.#.## #.#  ...    .. .   . . . ...   ..  ...   .  . ...  .  ..     ........ . .   .  . .  # #.##.# # ##
#  .##.##.#.##.#.## #.#.##.#.#.# . ...## # ... #.  ..     #...  .... ..  .   #.# ##.#.#.#.## # # # #.# # # #.# #.# ## # # ##.##.# #.#.# # #.# #.# # #.# ##.#  . . . . . .#
#.#. .  ...  . .... .    ..   . # #.#    . #.#.  # # # ## . #.#.# #.## # # # ... ## #.# # ## #.#.# #...   . .    . . ...   #.## ## ## #.## ##. . .   ... .. .# # ##.#.#.##
#   #.#.#.# ##.##.# # ##.# #.##.  #.# ##.# # #.# #.# # ##.# # #.#    .. . .  # #...  ....  ..  ..  . # #.# #.# ##.#.# #.#.# . .   . . ...    .#.#.# #.# ## #... .... ..  #
#.#.#.#. . .   . ... .. .  . . .# ... .. .. .   .  .  =  . . ...  #.##.##.##..   ## #.#.# # # ## # #..  .             .. . # #.##.#.#.# #.# #.# #=   .    . .# # ##.# # ##
#    .  # #.# # # # #.##.#.#.## # # #.##.#.# # # # #.# ## #.#.#.# # ##.## ## #.#..  .. ..  =.....    # # #.# # #.## # # # ## #.##      .# # . . ..#.#.#.##.# # ..  ..... #
# # #.# ... .  ..  ..    ..  . ... . .... .... ... .... .......  .. ..   .. .   .##.# #.# # #.##.# # .. . .   ..  .   .    .  .  .# #.#. .  # #.#  . .. .   .  # ##.#.# ##
#.  #.#.# #.## #.## # # ##.#.## # # #.## # #.# # #.#.#.## #.#.# # #.#.#.# ## #.# ## #.# #.#.#.##.#.# #.#.#.#.# #.## ## ##.## #.##..   ..#.#  .# # # # #.## #.#. .   . . .#
#.# .. .   . ..... . .   ... .....   . ....  ..     . . .      ..   . .....  ..... .. ... .. .  .. ..  # #.# #.#.##.## ## ## # ## #.# # #.#.#   .     ..=..  . #.## #.# ##
#.  # # # #.# ## ##.## #.#.#.##.#.# #.##.# #.#.#.# #.#.## #.# # #.##.##.# ##.# #.##.# #.# # #.##.# # #.  ..  .   ..  .. .. . ...  . ....   . .##.## #.# ## # #.  . .#.#. #
# # .    ...   . ...    ......   ... .. .. .  ....  .... . . . .  . .. .  .. .   ....  . .. .. ... . ..#.#.# #.# #.# #.## ## # ## #.#.# ## ##.# .  .....   #.  #.## .   ##
#   #.#.# # ## ##.## ## ##.#.##.# # #.## # ##.#.## #.#.## # # # ##.# # ##.##.#.#.## #.## ## # # ## #.# . .  ...     .... ...  . . ...          #.#.##.#.##  .# .   =# #  #
# #  .     ...  ... . . . .... ..      . . .      .  ...  .  . .. .   .    ... ..##.# ##.## #.#.#.## #.#.# # #.# # # # # # # # #.#.## # #.# ## #.# ##.# ## #.#.#.## #.#.##
# # # # # # ##.##.# # #.##.# #.## #.# ## # ## ##.# #.# # ## # # ## #.# # # # # #..  .  ... .  . ..  .. .....   .. ..    ... . .. .... .  .  . ....  .  . . . ..  . ..  ..#
#  ...  . ..... ...= . . .. ...  .  .. .  ...  . #.#. .  .. . ... .. . .. .  .   ##.# ## ## #.# # #.#.# ##.##.## #.##.#.##.# # # #.#.#.# #.## #.#.#.# #.## #.# # ##.# #.##
# #.# # #.#.#.# # # #.# ##.#.# ##.##.#.#.#.## ##.  ..# # ## # # ##.# # # #.#.#.#   .    .  . .    ...  .     .  . . .    .   . .    . ..... .. .  ..   .   . #. ....... .#
#...... .    .. #.#    .#.# ##.## #.## # #.##.##.# #.# #.## # # ## #.# #.# #.# # #.## ##.#.##.# # ##.## ##.##.##.#.## #.## # # #.# # # # #.## # # # # # # ##...#.## ## # #
##.#.##.# #.#.#.  . # #.. . . ...   .  . .. . . .. .  ....  .  .   .  .. . . .... ..  . . ..       .. . ...##. .. .   ...      ... .. .  ...   ..  . . .   ..#.   . ..  .#
##.# ##.#.# # #.#.#  . .#.## # ## # ##.# #.#.##.# # ##.## # #.# # ##.# #.#.#.#.# #.##.# ## ## ## ## # # ##....# #.# # # ## #.# # #.# #.## # #.# #.# # #.##.# # #.##.## ###
#  .   ...   .  #  .# #.. .. .    .....#.# #.##.#.##.# # ##.#.#.#.##.#. .. ... ..#.##.. ## ## ## ## # #.## ## . . .. .# ## #...   . .. . .# # # #  ..... . .... . .  .   #
##.# ## # # #.#...# # #.# ## # ## #.##....   .   ... . .... ..    .   .#.# #.# # . . .# .  .  ...  ..   . .  .# # #.#..  ....# #.# #.# ##...   ...# # ## #.#.#.# #.## # ##
##.#.## # #   ..#    ..   . .# ## #.## # #.## ## ## # #.#.# # # # ## #. .  ..   .# ## # # #.## # ##.# #.#.# #.# # # # # ##.#.# # #.#.#.##.# # ##.##.#.## #.# # #.#.##.# ##
#..  .   .  #.# # # # # #.##. .  .   .     ## ##.##.#.# #.#.# #.# ##.## ##.#.# #.   .. . ..   . . .  ..   ..... . ..    .   .       . .  .        .   . .      ... . . ..#
# ##.##.# # # #.    # #. ... # ##.#.##.#.#.. .     . ..      . ... .. .     . . .# # #.##.# #.## # # # ##.##.## #.# ## # # # #.#.#.#.#.##.# #.## ##.##.#.#.#.## #.#.# #.##
#   . .   # . . #.#.....#.## # ##.# ##    .#.# # # ##.# #.# #.#.# ## ## ## # # # # #.#.## #.# ## # #.#.##.##.. ..   # .  ..#..    .. .   . .    .  .  .. ..... . .   .   #
#.## ##.#.. #.#.#.# # #. ... .  .     .# #. ..     ... ....    .....    .   ... .  .  ..   ..=      ... .....##.# #..# # #...#.#.# #.# #.# #.# # ## # #.## #.## # #.# # ##
#.  ... ..#... . ..  .. #.#.## ##.#.## . # # # # # #.# # ##.# #.#.##.# ## # #.## # # #.## #.#.##.# ## #.# ##.## #.# ## # # # #     ..  =..   .. ..  . ...... . .     ..  #
# ## ##.# ..#.#.# # #.#.. ...  ..... . #...  .  ..        ..  ...  .    ... .. ..   .  ... .  .  . .     . .  ..... .  . .  . .# # #.##.## # #.# # ##.# ## #.##.#.#.#.# ##
#.      ..#. .  .  .    #.# ##.##.# ## ..#.#.#.### #.#.### #.##.# #.#.#.# # # ## #.# # # ## ## # #.# ## #.# ##.# ## ## # #.# #   . .... . ..   . ...   .##.# ##      .   #
#.## ## #.# # #.# #.#.# # ...#.  .#.## #.#.# . ..  .   ### #.##.# #.   .. # #.## #.# # #.## #  #.# # ##.#.# ## # ..  .     . # #.#.##.# ##.#.# #.##.#.#..  . .. #.# #.# ##
#.##.#.    ...  .... .. . #.#  ##. ..   ...  #.###.# #..   #  ...  #.# ##... ..   .  . .  . .# .  ...  . ..  .  .# #.# #.#.#   #. ..  . ..   .   .  . . ## # ##. .  # # ##
#.#   # # # #.# # # # ## ## #.# #.#.#.##.#.# ## ##.#.# ###   ##.# #  ..  .# # ## # #.#.####.## #.## # #.# ##.#.# ..  ..  . ..#..# #.# ## # #.#.#.## #.#.##.# #..#.#    . #
#..# #. . .   .. .. .. ..  . .    . ..  ...    . .. ...  . ## #.# ##.##.#.. #   .#.....       . .#. .    .     ..# # # #.# # #.## #.#. . # # #.#  . ...  ...  #  ...# #.##
# ##.##.# # #.# # #.## # #.##.# # #.#.##.#.#.#.#.##.## #.#. ..       .. #.#.  ## ..# #.#.## ## # .# #.#.#.##.# #. .. .. . .   ..  . ..##  ..  .  ## # # ##.#.#. # # # # .#
#    ...... . . .      .        .. . ... ..  . .. . ##.# # ##.# #.## ##.  . #  . # .   .. .   . .#  .  .. .     .# # #.# #.#.# # ## #.##.# # # # ##.. . . .  .#  .   .. ##
# ##.##.#.#.# #.# # ## # # ##.##.#.## ##.# # #.##.# .     . . #   ## ## #.# #.##.# #.#.## ##.# #.## # #.##.# #.#. . ..   . .......  =     ..  .    .# #.# ##.## # # #.# ##
#.##.#.# ##.# #.# # ##  .       .  .  . .. ..   .   ##.#.#.##.#.#  .   .. ...           .. .  .. .. .... . ... . # # #.#.# # # # ## # # ##.#.# #.##.#.# # ## #  ... .  . #
#...  ..  .. ... . .  .##.#.# ##.#.## ## # #.#.##.# ## #.# . . ...##.#.## # #.##.## #.# ##.#.#.#.##.#.# #.#=## #     ..      . ## # #..  . ...... .    .   .  #.#.#.# # ##
# # #.##.## # # # # ##  .. ....     ....  . ..   ...... .. ## #.# ##.   . # ## #.## #.#.##.# # # ...  ..#.# ## #.# #.#.#.#.#.# ..  . .#.#.# ##.# #.##.#.##.#.#  .    . . #
# #.# ## ## #.# # #.##.##.# # #.# #.## # # # # ## # ##.#.#.. ...  . .## # . .. ....  .#.     .. .## #.#. ..  . .. . ..  . .  . # ##.#.#.# # ##.#...## #.##   .# # #.#.#.##
# .  .     ..  .. ...     .   . .. . .. . . .  ...  .#.# # ## # #.##.  .. ## # # #.## ..##.#.#.#. . . . # # ##.# # #.#.#.# # #.   ..  .......   .#.. .     # # .     .. .#
# # ## #.##.# # ##.# # ## #.# # # #=#.## # #.#.##.# # .#  . .. ..  ..# ##    .... .. .#  . .  ...## # # .. ..#.#. ..   . #.# # # ##.# ## ## ## #.# ## # ##.#.##.# #.#.# ##
# . . .# ..  . .  ..   .   ... .#..  ... ..  # ##.#.##.. # ## # # ## ..## ##.# # # # ## # #.## # .   ...# # # .  #.# # #   ...   .   . ..   ...       ...    ..  . .    .#
#.#.##.  ## #.#.## # # ##.# #.#. .# #.##.#.#..   ... # # #.# ##.#  #.#.. ...     ... . .     .   ## # #  .  .#.#.# #.#.# # #.# # # ## #.#.#.##.#.#.## # # ##.## # #.#.#.##
#. ....#...   #.##   . ...     .#... .  .   .## #.# #..  .     .. # . .##.## # #.# #.# # ## ##.# # ##.#.#.# ## #....  ... .....  . .....# ##  .#.    . .. ..... # # #.#.##
#.# #.##.##.#    . # # # #.##.# #.# # ## #.#.#.##.### # ##.#.##.#.##.#.## ##.#.#.       .. .. .. ...  . .  ...   #.# # #.# # ##.## ## #... . #   #.## #.#.## ##   ... .  #
#. . ... . .. # ## ... . .. . ..     .  .  .  .  .. .....   .      . .. . . ..   #.# # #.## ##.#.# ##.# # # ## #.# #.#.# # .. .   ..#.# # #.## #     .    ...##.#.#.# ##.#
#.# # ## ##.# # ##.# # # #.## # # #.#.## #.#.#.#.# ##.#.#.## ## #.# ##.##.##.# #... .. . .# ## ... . ... . .... ..    . .. # ## #.#.. ......  .# # # ##.# ##    .. .   . #
#.    .. . .  . .  ... .  .... . ... .   .  .. . .  .  ...##.##.# # ## ##.##.# # # # ##.#.  .. #.# ##.## ## ## # #.#.# #.#.  ## # # #.# # #.##. . . .. .  . .#.#.## #.# ##
# # ## ##.# #.# # ## # ##.##.#.#.#.#.#.# # #.# #.# ##.#.# ... ...       .. .    .. . .. #.#.## # .      .. ..   . . ...   =#. .... .      . .  # # # ## # ##.# #.## # ## #
#.  .   # #.# . #.#. .  . . .  .   ...     ..    #.## #. .#.# #.# ## #.## ##.# #.# # ##   .  ..  #.# #.#.## ## # # #.# #.#.#.## ## ## # ## #.#.. ...  ..#   .  . .   ... #
# #.# # .    .#. ...## # # #.# #.# #.#.# #.#.# #. ..   .#  .  ........ ...    ...  .  . #.# ##.#. ..   .   ...     .. ...  ......  .. ... .  ..# # #.##.  ##.#.#.#.## ##.#
# #.# # #.#.# #.#.#.## # # # # #.# #.#.# # # # # #.##.#.# #=#.# #.# ## ## # # ## #.##.# #.# ## # # # ##.# #.# ## # # # #.# # # ##.# # #.##.#.#.#.#.# ## # ## # #.# ##.##.#
#.    ...    .. .. . .  ..  ..... .   . .   .  ...   .. .     .. ... . .... . ... . .  . .....  .   . . ....    .    . ... ...... .. .  ....   . . .. .   .  .. .... .   #
# # ##.## # # #.# ## #.#.#.#.##.#.##.#.# # # #.# #.##.# #.#.#.# #.# ## ##.#.#.## # ##.# #.# ## # #.#.# #.##.# ## #.# # #.#.# #.#.# ##.# ##.#.# # #.#.##.# ##.## #.#.# ## #
#..  .   . . . . .   ..# # # .... # ##.#.. ....#....  .. ... ...   .  .  ...  . .    .  .   ...   . .#...  .#.   #   .. .# .. ......      ..  ....   .. ..    .. ..    # #
# # ## ##.#.#.# ## # #.    . # ##.      .#.# #. .# #.##.# # # #.#.#.## ## # # ##.# ## #.# # ##.# # #  # # # ..##.. # # #  .# # #.# ## #.## # # # #.# ## #.##.##.#.# # #..#
# #.## #. #.# #..   .. #.###. .##.# ## # .. .. #.  .... .     . ...   . .  .#.##.    .  ..    .#.# #.## #.# #. #.#.# # #.#     ....## # ## ##.# #.# #.# ##.#.## #.# # ## #
#   ..  #...  ..## # #..    .#.....   .  #.#.# # # # ##.#.# #.# # #.## ## #.  . .#.##.#.# #.##.   . .    .... # .   .  .   # # # #.... ............  ...   . .     . ... #
# #.# # #.#.#.# ##.#.#.# #.#.#.##.# ##.#.# .      ...  .     .. # # ##.## # # ##        .  =  .# #.## #.#.# # .# # ## ##.# # # #.# ## #.##.## # #.# #.# ##.# ## #.# ##.# #
# #  . . ...\ ..   ....   ..  .... .....   # #.# # #.##.# #.# #..  . .  .   ..##.## # #.#.#.##   . #  #.# #.#.#  .. . .  ..  . .  .## # ##.##.#.# # #.# ##.# #.## # ## # #
# . # # #.# # # ## #.# ## # #.#.#.#.##.# #.# #.# #.# ## # # #.# # # ## ##.# #  .  .... .   . # #.#. .#.   ..  .#.#.##.##.# # # #.#   .  ..  .   .. ..  .. .  ..  . . .. .#
# #   ..      . . .   .##.#.#.# # #.#.## # .. .  . ..... ..  . .... .. .   .#.## ##.#.#.# # #..  ..# ## # # #o## . .  ....   . # . ## # #.# # # # #.# # # ##.##.# ##.#.#.#
#.# # #.#.# #.# ## #.# . .    .   . .... ..# #.# #.#.## #.#.#.# #.# ## ## #....  ##.# # # # ##.# #..... ..   ....# ##.##.#.# #...#..  . .......     .. . ..     .... ..  #
#..  .# ... . # ## #.##.# ## # # # ##.## # # #.# #.#.# ## # ## #.##.##.## # #.##.   . ..  .. .. ...#.# ##.# #.##  .. ..    .  .#  .## # # #.#.# # # # #.## #.##.# ##.# # #
# # #  .# #.#. . ...  ..      .....  ..   ...     . .. .. ... .   ..    ....  . .##.#.# ## #.#.# #..   .....   . # ## ## #.#.# ..#    .  .# #.#.#.# #.# ##.    .... . . .#
#.# # # #.#.# #.##.# ##.##.#.# # # ##.#.#.## # # ##.# # # #.## #.## # #.#.#.## #..   .  ..     . . # #.##.# # ##..  .   ...    # ..##.# # ...    .    .....#.#.##.##.##.##
# .       ... # #.## ##.## ## # #.# # #.#.##.... ....     .   .    .# ..#.#.## #.##.#.# ## # #.#.#.#.# ##.#   .. # ## ##.#.# # #.#.   .. .#.# # #.# # #.##. .#.## ##.##.##
# # #.# # # #... . .... . .  . .... .  . .   #.# #.##.##.## ## # ## . #    .  .  ##.#.#.## .. .  #. .     . #.##... .        ....  ## #.#.  . .  ...... . .# .  ..... .. #
# .   .  .. ..#.##.#.## ##.##.#.#.# # #.# ## # #.#.## ##.## # ## ## ## # ##.##.# . . ...  .#.# #   # # ##.#. .. .# ##.## # # # # #.## # #.# #.#.# # # #.##.# #.##.#.### ##
#.#.# # # # #  . .. ..      .    .    ..   .   .   .    . . ...... . ..  .   .. .#.# ## ##  . . .# # . .. ..# ## # ## ## # #.#..  .  ...  .  ...  . . . ....  ..   .  . .#
# #.#.# #.#.# ##.# #.#.#.# ##.# # # ## # #.#.# # # ##.##.## # ## ##.##.#.##.##.#  . . .. # # #.# ....##.# #..  . .  .... . ... # # ##.#.# #.# # # # # #.##.#.## # #.# #.##
#. ......... ..#   ... .  ...  .  .. ...       .     .  . .      . ... . . ..  # #.##.#.#. # # #.# #.## # #.# ##.# ## ##.#.##.#  #.#.##.#.## ##.# # #.# #..  . ...  .  ..#
#.# # # # # #.#  # #.#.# #.##.## # # # #.# # #.# # ## ##.##.# ##.## ## ## #.## .  . ... ## .  .. ..       . # ## # .. ## #.##.##       ..  .. . .. ... . # #.# ##.# # #.##
# .  . ...  .. #. .  ... .   . ... ..  ..  .... ..  . .  . ... .    ..     .   #.# ##.#....#.# # #.#.## #.#...   . ##   . .. ... #.# ## # ## ## #.# #.##... .. ..  .  .  #
# # #.#.# #.# #. # #.#.# #.##.## # #.#.# # #.##.##.#.#.# ## # # # #.## ## #.##... .  .. ## #..    .# ## #.#.# ## #.. .## # ## ## #    ... ##  # #.  .  . # ##.#.# #.# # ##
# #.#.#.. # # ## #..     . ... .     ...  .. ## ##.# #.. ##.#.# #   ..#.#.#.##.# ## #.# .#.. #.# # . ..   .  .  .  ##...  .     .. ## #.#.   #  ..#.# # ##.     .  ... ..#
# . . ..# . .... ..# # ##.# # ##.#.#.# # # #. ...   . .#. . .   ..#.#. . .   .   #.## #.#  # # #.# #.## #.# # ## #.# # # #.## ## # ##.#.#.## ## #. .#.  . .# ## # #.# # ##
# #.#.# # #.#.##.#.# # ##....    . ...  ..  .## ##.# #.# ## # # # #  .# #.#.##.#....   ..# . ..  ....  . .= #  .. . ... .   . .        .. .. .. . #.. # ##... .. . .  . .#
# #  ..  .. .     .   .. .#.# #.# ##.# #.# #. .. .       .. ..... . #  ...#.#....## # # ##.# # #.#.#.## #.# ..## # ##.##.# ## ## # ##.#.# ##.# ## # # #.## ## # # #.#.#.##
#.  #.#.#.# #.## # # # ## ... . . . . ..     ##.## # # # ##.# # #.# . # # #.  ## ## # .  ....   . .  ... .  #. ......        .. .. .  .. ..  . . ..   .   ...  .. .   .. #
#.## ## #.    .    .    . # #.# ## # # # #.# ## ##.#.# #. # # #   . #  ..  .#   .   ..#.##.#.# #.#.# ## # #.#.## #.#.#.#.#.## ##.#.## # # ##.# ##.# #.##.# #.#.## #.#.#.##
#.  ... . #.#.## # # # ##.. . .... .    .. .  ..   .     #. .  .#.#.#.###.# ..## ##.# ...    .. .     .  .  ...... . .  ...   . . .  . .# ## ##.# # . ## # # #.## #.# # ##
#.##.##.#   ......   ..##.# #.#.## #.# # # #.##.##.# # #.## # #   #.  . # . # #..##.# #.##.# #.#.#.#.##.# #.# ##.#.# #.#.#.## ##.# ## #     ..  ..  #. .     ..  ..   .  #
# . .##   # # ## #.# #  .  .  ..  ..... ...   ... .    .... ... # . #.## .#.#  #  .       ...  .  .. ... . . . .    . .   ...... # ##.#.## #.##.# #  .#.##.# # ##.# # # ##
# ## . .# .. . #.# # #.## # #.#.## #.# # #.#.## #.##.#.#.## #.# #.#.#.## ##.  #  # ##.#.# ##.#.#.#.# ##.##.##.# # # ##.# #.##.## ..     ... . .. . .#   . .. . .  .   ...#
# ## ##.# # #.#..    .  . ... ..   . ... ..  . . . .  .....    .  ..  . ..  # ##     . .    ..   ... ..    ...... . .    ..  ....#.## #.# ## ## # # . #.##.# #.##.# #.#.##
#   . . ..  # ##.#.#.##.#.#.#.# # #.## # # # ## #.#.# ##.#.## #.# #.# #.# # #.##.#.##.# # ## # # #.#.##.#.# # #.# # ##.#.# # #.#.# ## # # ##.## #.#.# # ## # #.## #.# # ##
#.##.##.#.#..  ... .  .. .     .. ..       .  .  ....    .  ...... .... .  . ... .   .   ... .... . .......  ...  . . ... ..  ..     . . . . .  .....  ... .  ...... ... #
#. ... . .  # # ##.##.# # #.##.##.# ## # # # # #.# #.## ##.## #.# # # # #.# ## #.# #.## # ##.#.#.# #.# ##.#.# #.# #.## # # ##.##.#.##.#.#.# ## #.# ##.#.##.# ## #.#.# #.##
# #.#.#.#.# #.#.... . .  . ... ## # ##.#.# # #.#.## # # # # #.#.#.# #.. .   #. . . .   . .## #  .#  .  .   ...# #.# ##.# #. . . .   ..  .. .    .   ...   ...    ..      #
#.. .  .#.#    .## ##.# # #.##. .   .. .   .  ...    .      ..   ...  #.# #..# # #.#.##.#     .#. .#.# ##.#.#    .    .  ..# #.#.#.## # # ##.## ##.# # #.# #.##.# # #.# ##
#.#.# #.... #.#..#.# #.##.# ##.##.# #.#.# ## # #.## #.# # #.#.# # # #. .....##.#..   .  ..##.#.#.#.# #.##.# # # # #.## # #.    ....      .  . ....   .....       .  . .  #
#. .. ..#.#.#.# # ..o ... .. . ## #.# #.# ##.##.# # # #.# #.#.#.#..   #.#.# .    # # ## #.....   . .. ...   . . .    . .. .# # # # ## # #.# # #.# ## #.# # #.## #.# # # ##
#.#.# # ... ... #o##.#.## #.## .. . .  ..  . .  .. ... .   ...  . #.# # . . ## #. ..  .  .## #.# #.# ##.# # #.#.#.# ##.# #.  .. . ..    ... . ..## ## #.#.#.#.#.#....  . #
# # # # # # #.# .. .  .  . ....##.#.# ## #.#.## # # # # ##.## #.# ....  # #    . #.# ## # . ..  ..=  .  ..    . . .   . ...##.## # ##.# #.# #.#...  ....   . . .  # # ##.#
#. .   . .. ... # ## # ## ##.#.   . ..  .  . ..  ..  ...  # #. .#.#.# #.#.# ##.# # # ## #.##.#.# #.#.# ## #.# #.# # ##.# # #.#.#  .# .... ..    ##.## # # #.# #.# # # #  #
# ##.##.# # # #  ... ..  . . ..##.# ## #.# #.##.#.#.# # # . ..#    . ..  . ...     ..    ..   .... ...  . ... .   .   ....  .. ..#  # # # # # #. ... ...  ..  ..  .    # #
#. . ... . .... # ## # #.# #.# . .  .  # # #.##.# #.#.#.#.# #.#.# # # #.#.# ## # # #.## #.## #.# # # #.##.# #.##.## ##.# #.## ## # ## #.#.#.# #.## ## #.#.#.#.#.#.#.# ##.#
# ##.##.#.#.# #.# ## #.# #.#  .## # ##  .... .       .. . .....     . .     .   .. ..  .. .  .    ... . .    .. .  .  .    ....   .  .  ... .      ...  . ..  . ...    ..#
#.##.##   ..# .      ..    . #. .. .. .#.# # ##.# #.# #.# # # #.# #.#.# #.#.#.#.# #.#.#.# #.# ## # # ## #.# # ##.# # #.# # ## #.# #.# #.#.#.#.#.#.#.#.#.#.#.# #.# # #.##.#
#  . .  #.#  .#.#.##.# #.#.# . ##.# ##      .. ..... ..     ..# # #.##.# ##.#.#     # .  .  .. . . #..  . .  ... ..  #   .    .. ## #.# #.#.# # # #.#  .  .  ..   # # ## #
# ##.##.  . # ...   . .. . ..# ## # ## # # # ##.#.#.# #.# # #. .. .. .   ... ...# #.  # # # # ##.#. .##.#.#.# ##.# #  %#.# ## ##   . ..  ... .....  ..#.# # # #.#..   . .#
# ##.## #.# # # #.##.## ##.#   . ..  .  ..... .. . . .# # # #.##.## ##.## # # #.#.  #.#.#. .  #  . #.. ..  .  ## #.## ## #.## ## ##.# #.# #.# #.# #.#.#.# ...  .## ## ## #
#..  . ...  . ... ###.# #..# # # ## ##.#.#.#.# ## #.#.   .  .. ... .## ## #.#..   #  . .  #.#  # #=  #.##.# #.. .... ....  .      . . ..  .. .#.# #.# ... #.#.# . .##. . #
#.##.## # #.# # # . . .. #  .  # ##.##...  .. . . #.#.#.# # # ##.##.. ..... ..#.# #.# # #.# #.##.#.# #.##   . ## # ##.## #.## ##.# # ##.# # # .   .. .#.# .  . .##.   ## #
####.. .   ## #.# # #.#.##.# #.   .. ..# # # #.##...   ....       ..## ##.# #....   ... ...   .    ...    #.#  .  .  .  ....  ...    .. . ..#.# ## #.## # #.#.#.## ##.##.#
# .  ## ## ........  .    .....#.##.##     .  .  .# # # #.#.#.## ## ##.## #.# # #.#.# # # #.# ##.# #.# ## #.#.##.##.#.##.#.##.## #.#.##.#.#.. ..    ..  ..... ..      .. #
# ##..   . ##.# ##.##.## # # #.#.## ##.#.# ## # # # # ......   ... ..    . .... ..    ..#.#.# #  . . .  ..   .       =    . .  .... . .   . #.# #.# # #.# # #.# # #.#.##.#
#.## ##.## ## #.   . .  . ..  .  . .  .. .  ..  . . ..#.#.#.# ##.##.#.# # # # # # # #.#.   ..  #.# # #.##.# #.#.# #.#.#.## ##.## #.#.##.#.# #.# # #.#..    ...... . .   .#
#.. . ..   .... #.# #.##.#.#.# # ## ##.#.#.## #.# #.#.#.# # # ## ## #.# #   #.# # #.#.#.# # #.##.#......... ..   .  .. .. ..    .. .... . # . .    . .# #.#.#.# # # #.## #
# ## ## ## ## #.# #...  .... # #.##.## #   .. ..   . .... .... . ..  .....# .  .  ...    . ...   . #.# ##.# #.#.##.# # ## # #.## #.#.##.#   #.# # #.# # .  .. .  ...#.. .#
#   ..  .   .  .....#.## # #.. ..  . .  .## # # #.#.## # # ## #.#.# # #.# #.# #.# # ## ##.#.#.## #.. .... ...   ..   ...  #  .   #.#. .. .#.# #.#.# #.. # #.# #.#.# =.## #
#.#.#.#.## ##.# ###.. .    ..#.#.##.##.#.   .   .... .. . ...    . .# #.#.# #.# # #.##.##..  . . #.#.# ## # #.## # # # ##...#.##   ..## #.. .  ....   # #.#.    ..  #    #
#  ...#..  . .# # # # ##.# # ##.# # ## #.##.# #.# #.## # #.## # #.#  . .  . ...  .    . ..# #.## .. ...  ..  .##.#.# # ##.#  ..# # #....#.#.#.# ## ##   .. .# #.#.# # ## #
# #.#  .## ##.     ....  .      . ..   .  . .    .   .   .... .  .. #.# # #.# #.# #.## ##.# #.## # #.# ##.#.#. ..  ....... .# # .  . ##...  .. ..   ..##.##       .  . . #
#..  .# ## ## ## ##.#.##.##.#.# # #.## #.##.# #.# ## #.# #.# #.## #.# #.#..  ..  .  ... .  .    ..   .. ....  ## #.# #.##.#.#. #.# #.# ## # # #.# # #.##.##.#.#.# #.# ## #
# # # #.  .   ..  . . . ... # #.# #.#....  . . ... ..     . ..    . . ..  # #.#.# #.##.## #.# ##.# # ## # #.# ##. . .     . . # .   .  .   .# # .    ..   . ..     .  ...#
# .   ..#.#.#.## ##.#.## ##..  .   . # #.##.##.## ## #.#.# #.# #.## #.# # #.# #.# ..     .# # # ...     ..   .. .# # #.##.# # ## #.# # ## # . . ## ## ## ##.# # # # #=##.#
# # #.#. . ..  ..   #.##.##.# # #.# ## #.##.##. .  ... .  . ....  ..      ..   .. #.## ##...   # # # ## #.# # ##. .. . .  ..     . .   ...  # #.  .  ..     ... ... . .  #
# #.#   #.#.# ## ##   .... ... ..... .. . #    ##.## # ## # ##.# ## # #.# #.#.#.# .. ..   #.#.## #..    . #   . .#.#.# ## #.# ## #.# # ## #. .# ## # #.#.##.#.#.#.# # ## #
# ... # ## ## ##. . #.## ## #.#.# ##.#.# #..##    ....  . . .. ..  .  . . .   . ..# ##.## .   .....#.## #. .#.##    . ..    ... ..... . ..  #.   . ..   .......  ..   .  #
# # #  ... . . . ##.  .       #.  ##...   # ##.##.#.## ## # ##.## #.# # #.# #.# #.# ## ## # #.##.#.# ## # #.# # ##.#.# # #.# #.#.#.# # ## # # #.## # # # ##.# #.# # #.##.#
# # # #.# # #.##.. .#.## ##.#...# .. # #.#.  .. . .... . ...  . .    ....... ..  ... ..   .. .. . ...   . . .. ......   . ....  .. . ..... .. .    .. .  . ...   . . .. .#
#..  ..  . .#.## ##  .    ... #.  ##.#.#.## # #.#.# # # #.# ## ##.# #.#.# # #.#.# #.#.# #.# # ##.#.#.## # # #.##.#.# # # #.# #.#.# #.#.##.# #.#.## ## #.# # # # #.# # ## #
# # #.# # #......  .# ## ##.#.  #.  ..   .# . .     ....   .      .   . ... ...  . ..    ....    ..  ##..  . .       . . ... .  .. .  .. . ... .     . . ..... .    ..  .#
## ## # # # # ## #.##..    .# #.#.##.# #.# .## ## # # # # # ##.##.# # # #.#.# #.# # # #.# # # ## # # .  # # # ##.# # #.#.#.#.# # ## ##.## # #.## #.## # # # #.#.#.#.# ##.#
#  .  ...    ... .   .#.# #    .  .. . . .# ##.# .  ..... ..## ## #.  . . .  . ..   .   . .   .  . . ##... .  ## #   . ..#  .. . .... .. ....... # ##    .....# #.# #.## #
## ##.# # # #.##.## #.#.#.# #.#.#.## #.# ##.   .#.# #.# # # .  .. . # #.#.# ##.# ## # # # # # #.## #.  .# # #.. ...# # #...# #.#.## # # # #.# ##...   #.# #.#. . .    .  #
#. . .   ...    . ....  ...  .   . ..   .  .## #.  ..... . .##.## #. .  .  . ......  . .#=# # # # ## ##.# #.# ## # # # ..# .      ..  .   ... ## ## # #.#.  . #.#.##.# # #
##.##.# # # # ## # ## #.#.#.# # # ##.## # # ##.# ##.#.# #.# ##.## #.# # #.# ##.#.## #.#   .   .   . ..  . ..   .  .. ..#  .## ## ## # # # # #....  . . . .#.# .        . #
# . ..  .  ....   . .. ...  .. . . ...  ..   ...   . ... . ..  . . .  ..# #.## # ##.# # #.#.# # #.##.#.#.#.#.##o# ##.# #.# ## # #.#.#.# #.#.# ## ## #.# # #.#.#.# ## # #.#
##.##.#.#.#.# ## ##.# #.#.#.# #.# #.# # #.#.# # ##.## ## ## ## ## # # #    ..   ..    .. ..   .  . . .  .  ... .. ..... .  . . .. ..    . .. . .  ... .  ...    . .. #...#
## ## # #.# # ## ## #.# #   .. .#.  .   .  ....  .    .... ...  .   ... #.#.## #.## #.# #.#.# ## # #.# #.# #.## ## ## # # #.#.#.## # # #.#.## #.# # # #.# #.#.#.#.##.#.#.#
#.... .   . .      . .  ..#.# #.. ## ##.# # # # ##.##.# #.# ##.##.#.#.#..  . ... ##.#.#.## ##  .  .. # # #.## #.## ## # # # # # ## ..   .    #  # . #.# #.# #   . ##. .. #
#.# # #.# #.# ##.#.## # # #.#.# # ## ##.#.#.#.#.##.## ##.## ## ## # #.# #.#.#.##.  . ..  ..  .## #.#. .   . ..  . .  .. ..... ..  .#.# # # #.. ##.#      . .. # #  ..#.# #
#.... ... .  .# .. .   .. ......   . .   ..   ..  .  .   . .....   .... # #.#.# #.#.# # ##.##.  ##.# # #.## # #.##.## # #.#.# # ##      . ...# .   .#.# #.#.#     ## .=#.#
# # #.## # ##...## ##.#.#.##.# ## ## ## #.#.#.##.# # #.#.## ## ##.# #.#. . .   . .  .. .   . .#..  .  . .. .. .....##.# #.# #.#.##.# #.#.# # # ##.# # # #.. ..#.# ## #.#.#
#.  . .. .   .#.##.## #    .   ##.##.#.. ...  ..   ..  ....      .     .# #.#.#.# # # # ##.##  # # # # # ## #.# ##  . . .....  ...  ...   .  ... .   . .  #.#  .  ..   . #
# # # ##.## #.      ....# #.##...    . # # # #.#.# #.# # ##.##.## # # #..   ..    .. .   .    # ##.#.# #.##.# # ##.##.## ##.# #.##.# # # # #.##.# #.# #.# #.#.# # # ##.#.#
#.. . ## ## # #.## ## # #.#.## # # # ##.##.#.# # #.#.# # ## ## ##.#.#.# # #.#.#.#.#.# # ## ##.       ..  .  .       .. ... .               ... .. =.  .. .. ...     .. . #
#.# #  ..##. ..    . .   .   ... ...  .  .  .   . .. .. . . .    ..... ...  ...       .  . .  #.# ##.#.# ##.#.# ##.## ## #.#.#.# # # #.#.# #.# # #.# ## #.# # #.# #.## #.#
#. . .## ...# #.## ##.# #.##.#.#.#.## #.##.# # #.#.# # ## # ## ## #.##.## #.#.# #.#.#.# ## ##.       ..  .  ......  .     ... .  .  . . .#.#.. .   .   . . . . .. . ..   #
# # #.##.#.## # ..  #.#.#         .         ..   .  .  =. ..  ....  .   . .    ...    #.##.##.#.#.## #.# ##.#.# ##.#.# # ##.## ##.## # # .  # ##.# #.## # #.# #.# #.## #.#
#..  . .. .     ##.#.. . .##.# #.# ## ## #.#.#.#.# # # # # # # ##.#.##.## # # #.#.#.#  .   .... . . ..    .   ...#  .#..  .... ... .  .. # ## ## # #.##.#.  ..#.#.# ## #.#
# #.# ## ##.# #.. . # # #.. . . . ..  . .....  . .    .. .. ...    .. . .  .   . ... .# ## ## # # ##.#.#.# #.# #  .#.  #.## ## ## #.##.#   .=.. .         # #.  ..  .. ..#
#  . .  .   .. .# #.#.# #.## #.# #.##.## #.#.#.#.# # #.#.#.# # ##.# ## # ## #.# # #.#       .   ... .  .. ..     # ..#   .. .  ..   ##.# #.#.# #.# ## # #..  .# # #.##.# #
#.# #.## #.## #. ...      . . . ..  ... .. ..    ...  .   . .      .   ..  .... . ... # # #.# # #.##.#.#.#.# # #.# # #.# ## ## ##.#..  .....       ... .#.# #  .  #.##   #
#   . ... .  .# #.## ## #.#.##.#.# ## ##.#.# # # # # # # ##.## ## #.## # ##.# #.#.#.# #  . .      . =...   .. . . ... .       . ... ##.#.#.#.# # # ## #.   . .# # .. ..#.#
#.# #.# ##.##   #.# # #.# ## # #.# ##.## # # # # #.#.# # # #.#.##.#  .. .. .  .... ... .#.#.# # #.## # # # # #.#.#.# #.#.## ##.##.#.##   . ... # # ## #.#.#.#.   .## #.  #
#   . ..  .  .#.     . .  ..   .......  .   .....   .   . . . .   ..##.# ##.#.#.# #.# #.. ..  ..  .. . .  .. ...   . .  .     ...... . #.## ## ...   ...   .  # #    ..#.#
#.#.# ## # ## . #.# # ## ##.## #.# # # # # #.#.#.#.#.# # #.#.# ##.#.##.# ## # #.#.# # # ## ##.# #.##.# # #.#.#.#.# #.#.# ##.## # #.# #.# ## ## # # ##.# #.# #.# #.####.#.#
# .  .... .. .#.#.#.#.##.####.## # # #.# #.# # #.#.#.. ..  .   ..  .. .. .. . .. =.   ..  .. .. .   ...... .  . . ..  ... ... ..... .. .. ..   .....  ... ...  .    .   .#
#.### ## # ##  ....  . = . . .......   .        .  ..#.#.##.# # #.# ##.# ##.#.# #.# # # ## ## ## # #=## ##.##.## #.# # # ## # # ## #.# # # ###.# #.# ## # # # #.#.## # # #
##########################################################################################################################################################################
