##########################
# = # .  ... #.# .#.#  ..#
#.# # ##.#.#  .  #   ### #
##= .=# #.#  ###.## #..  #
#  ## .  .## .  . .  #.#.#
##=#. # # . # # # # #    #
#. ##. ##.# %.#.## # # #o#
##o # #  .o #. .. .  .o#.#
#. #  .##.# # ####### ##.#
# # #.#  .   .\   . ..  .#
#. .  #.#.###.##### ## #.#
## ## #   # . #  .  . #. #
##########################
