########################################################################################
#. #.#. .# .#.#..#.#.# #.#.#.#...#  ...##.# ## #.#... .. ...#  ..#.#.#..... ......#.#.##
#.#. ###..#.#..#.#.#.#... ...#.#.#.#.# ....... ..#.#.##.##.#..#.#..# .# ###.#.##.#..#..#
#..#... .#..#.#. ..#.#.#####..#.. #.. ##.####### #.###.#.# ##.##.#.#.#.##.#.###.#.#.##.#
#.## ####.#.# .#.#.# # ... #.#.#.##.## #.# ...  ........ ..=..... ........ .. . ..... .#
#......   ..#.#..# #..#.#.##.# #.........#.####.#####.#.#.##.## #.#####.#.###.##.#.#.###
# # #o# #.# #.##.#.#.###.#...#.#####.##.#....  ##.......##.#.#..#......#.#. # ##..# #..#
#.#....#.#.....#.#.. .#. ..#.#. .  ...#..#.#.##. ####### #.#..#.#.##.###.##.....###.##.#
##..#.# .##.#.#.#.###.##.#.### ##### #.###.##.##.........#.# #.##...#. .....# #....... #
###.#..# ..#.# ........ . .. ...... .......  ... #######...#.#.#.###.##.##.#..# ## ##.##
###.####.# #.#.#######.#.#.# #### #.#.# ###.#####.......#.#....# .......#.#.# # .#. .#.#
## . .....##.#.#... ..#.###.# ...# # ##....#....#.##.#.###.##.#..###.##...... ..## #...#
# #.#.###.#. #..#####....#..#.# #. .....#.#..##.#.#.#.#.##.....#.#..##..##.##.###.#.##.#
#.#.#.#  .##.#.# ...#.####.#..#..#.####.## #.# #. .......  #.#.#..#...# #.#.......... ##
#...#..##... # #.#.##...    # # ##.#..# ...#.#.### # ##.##..#.##.#..#...#.##.#.#.####. #
###..## .##.#..#.#....#.#####.#.#...#.# #.#..#...## #.## #.#.....###..# #..#.#.#.#..#.##
#...# .#. .#.#.#.##.#.###.....#..#.# .#.##.#.# #.. ........#.# #. ..#.#...#..#.#...#..##
#.#. #.#.##... #... #.....##.#..#..##.#.... .#.##############.##.####.#.## #.#.####.#. #
###.##.# ...## .#.#. .#.#.#.#.##.#..# ######## ... ....... #..  #.....#.. . ...... ...##
#......######.#..##.#.##..... .... # . .......###.######.#..#.### ####.#.### ###.#####.#
######........ .#...# .#.##.##.#.##.#.##.#.#.#...#. ...# #.#... ..#.    .. . #.........#
#.....### # # #..##.#.#..#.#. #..# .#...#.# #.## #.### ###..#.###.#.##.###.#.#.#.#.#.#.#
#.#####.##.#.#.###.##..#.#. #..### #..#.#.#....#.#.#.# ....#. #.#.#.#....#.#.#.##.#..#.#
#..... ............#.###.#.##.## ..##.#.#.#.####.# #.#.# #..# #.#.#..##.##...#....###=.#
##.#### #.##.#.#.## . ...........#...... . ......#.#.#..##.#. #.#.#.# . ...#..###. ..###
#.. . . ###.# #.#.#.##.##.#.##.#.######.##.# #.#.#.# #.#. .##.#.#.#.#.#.##.#.# .. ## . #
##.### #.. .. ........##.# #.###... ..#.#...# .# # # ..#.#..#.# #.#.#. #.#.#.#.#.# .##.#
# .#.#. #.#.#########  .. .. ....#.##.#..#.#.#.#.#..## #.#.#....#.....##.#.# ....=#...##
##...#.#..#.#.. ......#.###.# #.#..#.# ##.#...##.# #...## . # #. ## ##...#.#.##.#. # #.#
#.####..#.#..###.## #  ## .#..#..#.#... . ##.#.. ..#.#...#.#.##.#.#.##.#...#..#.#.#. ..#
#..... #..#.#. ##.#.# #...#.#.#.#..#.#.###.....##.#.##.#.#.#...# ..... .#.# .#..#..#.#.#
# ####.##.#..#.  ...#.#.#.#.  .###.#.# #...### #..#.....#..#.#.#.#.#.#.#.. #.## #.#...##
#.# .......##.###### .# #..#.## # ##....#.## # .# #.####..#..#...  ###.## #...#.#.##.###
#.#.#####.#... .. . #.....#   ..... =#.#.#...#.##.#. ...# .###.#.## .... ..#.## # .#..##
# #. ...#.### ##.## #.#.#.# ##.## #.##.# ##o#..#...#####.#.....#.######.# ## # #.### #.#
##. #.#.#...# #.. # #.#.#.#.#..#..# # ....#..#..#.#........### .#.#....#..#...... .....#
#..#.#.#..##...#.#..#..#..#.###..#...#.## #.#..#..########...# #.. ### .#..#.##.## #.# #
##. ....# ..#.##..# #.#.#.#....##.###.# ##..##..#..........#... ##.#...##.##.#.#.## #.##
# #.###..##.###.# #.#. .. ##.#........  ..#..#.##.# ##.###..##.#.  #.#.#..... ... .....#
#.#. ...#.#.  ...##...#.##....#.##.##.# ### #....#..##.#.# #.#.#.#.###.#.## #######.# ##
#.#.##.#.. .#.#.# ..# #.# #### #.#.#.#.#....#.##..# ..##.#.. #.#.#.... #.#. .......# #.#
#.#..# .###.##.##.## .#......  ... ..... ###.# #.##.#... #.#.#.#.#.# #... #.# # ###....#
#.#.#..#. # .... ...#.##.#=#.#.##.###### ..#.#...# #.#### .#. ...#.#.#.#.# .# .#..### ##
# #.##..#..#.##.#.#.#  .# .# #.#.##....#.#.#..##... .....#..##.# #.#. .#.#.#.#.##... ..#
#.#..#.##.#.#.##.##.##.#.#.###.#. ..##.#.#. #..#.#.#.#.#...#.#..#..#.##...... . .##.#.##
#...#. .... .......   ...  .  ...#####\# # ##.## .#.#.#.##.#. #..#.#.#..#.#.#.##.#.#.. #
#.##..###.#.##.#.##.#.##.#.#.#.#  ..#.. ..##.....#....... .# #. ##.#.# #.#.#.#.#.#.##.##
#.#.#.#.##.## #.# # ###.#.#.#.  #.# ##.#.#..#.##.#######.##.. #..... .......... .. . ..#
#...#..... .... ......... .. .#.# #..#.###.##..#=......#.#..### ##.# ### #####.# #.##.##
#### #####.##.###.#.### ##o###..#.#.#... ....###.##.##.#..#.#...#.#.# . #... #.#.#.....#
#.........##.#..#.#.#..#..##.##..##.######.#. ....# #.. ###.###.#...# #.#.###.##..#.#.##
##.###.##.#. .#.#.# ##..#.#.....#...... ....## ##. ###.#..  ....#.#.#. #.........#.#.#.#
#.....#.#..#.#..#.#..# ##..##.#.#.#.###.##.#.##.###.#.#.##.#.###... ..## #=#.###.......#
###.##. #.##..#.#.#.#..#..## #..#.###.##.............. .. ##. ..#.#.##. .##.. .#.#####.#
# # ..#.#=#..#   .# ##.##.# ..#..#.. ...## #.#.#.#########..####..#. .#.#..#.#.#.... #.#
#..##...#.##.#.###.... ...#.##..# #####.#.#.#.#.... .  ...# # . #.#.##. #.#.#.#.#####..#
#.#..##.#..# .....#.#.###  ...#... ............# #####.## #.# #.#.#.# #........ .....###
#.. # ..#.##.#####..#.# #.##.#..######.# ##.## #... ..#.#.#.###.# #...=.####.###.#.# ..#
### #.###....... o#. ##.#.#..##.#..... ##.## #..## #.#  #.#....... #.# #....# .#.#.#.#.#
#.#. . ...#.# ##.#.#.#..#..# .#...#.##.......#.#.## ###.#.#.#####.#..##.##.#. #. #. .# #
#.####.###.#.## ##.#..#...#..#.## #.#.##.#.# #.......#..#.#......#.#. .....##.###.##.# #
#    . ... ......... # #.# #.#.##.#.#...###...##.###..#.#.#.##.#...#.##.###.#..%.. ....#
#######.#######.######...#.#.#... ..##.# #.#.##.#..#.#..#.#...#.##.#   .#.#..# # ##.#.##
#.  .. #...  .#.#.= ...#.#..#.# ###...... .#.  .##.#.##.# ###... .#..##.#.#.#.#.## #...#
#.##.##.##.##.. ####.# ### #..#.# ######.##..#.#.#.# . ... . #.##.#.#. #.... ...  .#.#.#
#.. ......##.##.....#...  ...#.........#.#.# # # # #.#.#.#.#..#.#.#.#.#.###.####.###.###
#.# ##### ...#..###.#.##.#.##.# ###### #.#.#.# #=..#.#.....#.#....#.#.#.....# ...# ....#
#.#.... #.####.#..#...#.#. ...#.#....#.#.. #..##.##..# #####.#.##.# #..#.## #####.##.###
#.# #####........#..#....# ###..#.##.#. ##.##.#..#.#.. ......##.### #.#.#.#.. ... ... .#
#.#... ..# ###.##.###.#.##.#.##.# #.# .# ...#. # ...#.##.##.#......##.# ...##.# # ##.#.#
##..###.#. #.. ... ..#... ......#.. .#.#.#.#.###.# ## #.. ##.##.##... ## # ..# ... ..#.#
#.#......#. ## ##.##.# ###.###.##.####.#.#.#.....##...##.#....#.#..#.#..#..#=.#.#.##..##
#..####.## # #...#  .# #..#...#... . . . #.#.#.##. #.#...#.#.#...# #.##.##.#.#.#.#.#.###
#.#...#...#....##..#...##.#.##.## # ##.#.#.#.#.#..##.#.#.#..#..#.#.#.... ... #.......###
#..##.#.## .##..## #.## ..........##.#..#..#.##.#.#. .#..#.## # .#.# ###.#.#.#.#.#.## ##
# #...# #.#..#.#. .#..#.#.##.#.##.....#.##.. ...#.## #.# #.  . #.#. #..#.##. ..#.#.  ..#
#.#.#.#...# #..#.#.#.#. .#...#..#.####.#.# ####......#.#. .##.##.#.#..#....# #.#...##.##
# # # # #.#.##. #.##..#.#.##. #.#.. ....... ..##.##.##.#.#..#. ... # #..##.#.#...#.#.#.#
#.###.#. #.# ..#.... # ...  #.# #.###.###.#.##...#.#... .. #.#.###.#.###.##..#.#.#. ...#
# ... #.#..#.#### #.#.#######.###.#... .#.... ##.#.#.###.# .. .. ..#.......#.# #..# #.##
#.####.##.# .# #.# #....... .#.. .##.#.###.##.##.#.#.#  ##.##.#.#.#..##.## #.# #.##. #.#
#..........#.........## ##.#.####..#.##.#.#.# ...#..# .# . # #.#.###.#.. #.#.#.#.#..#..#
# #.#=#####..# #=#.#...#.#.##... .#..........#.##..#.# #.#.#......#. .#.#.## #....# ##.#
#......... .##..##.#.##..#....####.## #.#.###.# ##.#.# #.#.#####.#.#.#.#.... #.#.##....#
###.## ##.#.#. #..## #.#...#.#...... . #..#........#.. #.#.. .... ...# # ###.#..#...#.##
# . #.## ##..#.##.# ....# #..##.#.###.# #...######.###.#. #####.###.##.#..= .#.## #.# ##
# #....... .#... ..#.## .###..# .#.......##.... ......=..# .  ..#. .#. ..#.#.#. ... #..#
########################################################################################
