############################################################################################################################################################
#         # .       #      .           # #  .  .          ..       #          . #.#  #.#.    .        .. . .      # #     #  .     #.#.#.#  # .    .       #
## ## # #  ###.## # # ### ## ## # #.# #  .# # # # ####.# # # ## ## ############ #.#.## ##### ########## #### ### ##.#####.######## # # # ## ########## #####
# #  # #  ## # # # ## # ## ###.# # # # # #  #  # #    # #  .# . #  .   .  ..        .     .  .   .       ..   .           .        .  ...        .     .   #
#.## # ##.            #  . .    .         # # ## #.#### ##### #  # ######### ############### ############## ###### ############## ### ######### ####### ## #
#  # # .# #### ## # #  #.# # ## ## ## ## #       #.# .         .##    ..   . ...                .                . .  . . .         ..  .             # # ##
# ## # ## # .    # #  #.#.# ## ##.## #.#  ### ####.# # ## ## ##.#  ## # ## ## ######.#### ### ##### ## ## ## # ### ########### ## #.#.##### ### ##.## #.# .#
#   .# #.  ### #.#  #   .   .    ..    #.#.  .     .# #  # #  # ##   #    # #.#      # .  .  #     #  #.. #  . # #   . .      #.# #   .     # ## ## ##  # ##
## # #  # #   .# # #  ##### # ###### ##   ## ##### # . #   # #   # ###.## #.## .# ## .###### ## ## ##.### #.#### ### ####### ##.#  ### ##.# . . .     # #  #
# ##.# ##  # # #.#  # #    # # .       #.#      .#. # #  #.#  # #  #   #      # #    #        .  .     .   ...                 .# #     # # ## ## ## #  # ##
#         # # # ## ## ### ## # ######### #.##### # ## ##.## ## # # ###.## ##### ##### ###### ######################### ######### # ##### # # ## # #.# ### ##
### ## ##   .      .    . .         ..                .. .        .        ..   . .  ..  .       ...   ..  .         .  .      .  .  .       .   .    .    #
# .#  # #.# ## # ## ## ##### # ### ## ## ## ##.# ##.# # ## # # ## ###.# # ## # ##### ## ## #### # # # ## # ### # # ## # # ## # ##### #.# ### ## ## #### ## #
##  #.# # #  #  # # # #  .  #        #  #  # ## #.## #.## # # # ### ## # #.# # #    #  #.  #  # .  # #.##.## ## # # ## ##.#. # #   # #  # ..#..#  #   #    #
## ##.#.#  ### #  # ..#####  # ## # # .## #        .          ..         #.##  # ##  #  ## # ## ## #   .       ..    .    ###  .# #  # ##.### ## ## ##.#.###
#         #  .  #.# #.   .# ##  # #  #.#  .# #############################   #  #.# # .#    . .  #  # ##.## # # # ### # # .  # ##  # #    . ..  . =.  .   .#
## ## ###  # # ## ###.##### # ## ## ## ## # .#         ..      .   .       ##. ##.# ## ########### # ## # ## # # ## ### # # #  #  # ## ##### ####.#### # # #
#   # # # # ## #           .        .      # ## #### # # ####### # ####### #.# #                       .    .    .         # # ## #.  .#     #   #      #  #
## ## #  .# #. ## ## ## # ##.##.##### ### ##  # #   # #. .     # .  .    # # #  ##### # # #.## # # ### # # ## #.##### #.# #     # ####.# #.# .## ##.# # ## #
#..# .# #.# ##.  =  #  # ##.#  #    #  .#.#  #   # #  # ######  ### ### #  #.# #  . # # ## #.#  # ## # # #.#.# #.    ## # # ## #  .  # # # # #.# .#.# #  #.#
## ## # . #    ## # # #   .   #  # #  # #  # .# #  ## #..    # #   .#  .## # #  # # # #  . # #.#...    # .   #   ## #   #.##.##.# # # .##  # #   ## ###.#  #
##  #  ##  # # #   ## # #####  # ## # #.#.## #   #  #   ## # #  ### # #  # # # # ## ## #####.# # # # # ### # # #  # # # #       # =# #  .#.#. ##   .  .  # #
# .#  #   # ##  #.#   #.    # # .  .# #.  #   # ## ## # #.# ##.## ### # #  # #  . .  .       #.#  # ## . # . # #### ## ## #### #  #    ### # #   ## ### ## #
## ##  ##.#    #. ### ####### ## ###    #  # #               ..  .      ## # # ######## ###.## # #  #  # # #       .      #.   ##. # # #     # #    # #.#  #
#   # #  .#### .#.         .        # # # # .##########.## ## ## ## # # .# #.# #      # .   #  #  #  # ##   ## # #.## # #  # # .# #  #  # ##.# # ##   # .# #
## ##  ##   .# #  ## ## # # #.## ## # ##  ##.  .  =.  #   # # .#.  # ##.#. #    #.###   # #. # # ## #  . # ## # ##.#.#.#  ## # #  ## # # ## ## # # #### # ##
#  #  #.# ## #  # #   #  # #  . # # #.  #  . # # ## # # # # # # .##  #   #  ## # ## # #.##.# . #     # ##  #.        .  # #. #  #.   # .. . .   ..    .  . #
## .# # # # # .#  # #.#### # #### #   ##  ##  # # ### #   #.##.# # #. # # .#  .    .# #      # # ####  # #  ### ## # # #   # # ## ## # # # ##.### # # # ## #
# .#    #   .#  # .    . .          #   #  # #.  .    #.##  .  # # #.# . #  ##.## ##  # ### ## .     # # . #   #.  # #  # ## # #   # # .#   # # ## # #   #.#
##  #.##  ####.##.############# #### ###  #.. # # ### ##.# ####       # # .# ...# # # # #      # ##### ### # # # # #.# #. #  #. # #  # #  # #    #.#   #   #
#. #  . #             = .  . . . ..     # ## ## #   #          # # ## #  #  ## ## # # ## # ###           #.# # # # # # .#  ### #   ###  # # ###### ###.# # #
##  # # # ### ## ## # ## ## ##.# ### # ##  # #  #.# # ## # # # #  # ### ## #.# #  # #  .  .  # #### ##.# #  ## #.# #   #  #  ..## #   .#  .             ## #
#  # # ##.#  #. . # #.# # ## ##     # #  .# . # # #.# # #.# # #  #     .#  #   # ## # #####=##     .#  ### #.  # #  ##  #  ###  # .### ## ## # ####### #  .#
###       # #  #.##.#        . # #### ###  # ##.# # .        ..#  ## ## .#. ## #              .## # ##   . ### # . # . #  ## # #  #. #. # # # #  .. .# # # #
# # # ### # ## # #  # ## ## # #         # #  #  # # # #.## ## ## #.## # ## # # =## # # #.###.#.# #  .# #.#       #  ##  #   .#  # ## # #  # # # # # #. # ..#
# # # #.# #  # #.##.#  ## # #  # #######   # ## .# ##  #.# #  # .#     .#  ..#.# ## ## ### ## ## #### # # ####### ## ###  # #  #   # #.## # #.# ## # # ## ##
#.# #   # # #  .# # # #   . #=#         # #   # # .   #     # ## #.#.## .# ##.        ..          .        .   .       .#  # ## # ## #       . .        . .#
# . # # # #  # #  . # # # # #  #.## ## #   # #  #.# # #.## ## .# # ## # #  #.# ## ########### ### ### # #.## # # # # ## # #   .  .  .  ## #### ###### # ####
# # # ##  # #   # # #.  # #   ## # # ## # #   # # # #  .   #  # . .   #  #.  # # #   . .    # #    .    # # # # # # # #.#. ## ## # # #  # #   #  .  .#     #
# # #   #.   # #  # # # # #.#   .#        .# # # # ## ### # ## ########.#  #  .#. #####.###.# # # # #.#          . .# # # ## #  #.## # #.  ## #.# ##.# #####
# # #.#.# ## #  # # # ### ## ###.# # ####.#   .    . .    .      ..      #   # # #.  ...#.# # # # #   ###.#=#.# # ##  #.# .  # #  #  #.## # #.## # # #. .  #
#.#.#.# #. #.# #  #.#       .     # # . #  # ## ## ## ## ##### # ## # # #  ##  #  ## ## #   # # #. .#  .# #  # ##.# # ### # #   # ## #      #        #.## ##
# # #.# # #  .  #.# # ########## # .. # . #  #  #.#  #  .    # # # #. .. #   # # # ## # ### ### # # # # #.# #        .   .#.## #     # ## # #.## # # #.    #
# # #.# # ## # #  #.#.# .  .. .  ####.###  #  # # # #. ## ## # #.#.# ####  #   #         .      # #  .#.# # .# #.# #### # ## #.## # ## # #.## # # ##.# #####
### #. ##  # #  #.# # # # #.####    .  .# ## #. # # ## # ## ## #    .  ..#   # # ## # # # # # # # # # ##  # #  #  #   . #.     .   .      .                #
#   # #   #  # #  #.#.# # # #  # ##.# ### #  ###  #          . # ### # #.# # . ## # ## # # # #  # # #  .# #  #   #  ### # # # ##.## #.##### #### ### ## ## #
### #  ##  # #.## # # # # # .#.#.# #  #    #    #  ######## ##.# # # ## #   ##        ..  =.  # # # # ##. # #  #. #   # #. # #  #.## #     #   . #.  # # # #
# #=# # #.# ## .#.# # ##  # # .# #  # . # #. #### #  ...   .   #  . .    # # # #### # ####.### .# #.# # # #  # # #  #.# # #   #.   # ### # # ### #.### # # #
# # # # # #    # .#     #.#  # # # #  ###  # #     # ##.### ## # #.## ## # #   #    #  ..# #  # # # # . #.# # .#. # ###.# ## ## ###  . . # ##  #     .   # #
# # #.. #.# ##  #.# # ##  # #  # # ## .   #   # # #.# .#  #  # # #  # # # .#.# #### ##### # # # ## #  #   #  # # # .    #          # # #.# .# #  ### ####  #
#.#.#.#  . # # #    #.  # ##.#.#      ###  # # # .# ## ##.# #  # ### ## ## #.  .           .. .  .. # # # # ## # ## # # # ## #.# ##  # #  .#   #         # #
# # #.  # #  .  ### #.# #      # # ## #   #   ..# #       #. # #      .  #   # ##################### ## # #  . #  # # # #.#   ## #.# .##.#  # #  #.# ## #  #
# # # ##  # ## #  . # #   #####  # #.  ##.##.## #.# #### # .#. ##########. ##  # .     .           .      # # # .#   ##.# ## #   # # # . # ## ### # ##.# # #
# # # ..#  # # ######. ## # .  # #  # #.#. # # .# #.#   #.#  #  ..  .    #  .#.# # ######.# ## # ### #### #  # # ##.#   #  # #.# # # ###             ..  # #
# # # # # #       . . #   #### # # # .# # #.  # #.# ### # # ## #### # ###  #   # #    .    . # #.#  ## .#=# #     #. ## # #  # # # #  .# # # # # # # # # # #
# # ###   .## #.# ##.#  #      # #  #.  #  # #    #   .     .  #    #    #   # # #.# # ## # #  # ## # .#  #  # # #  #   #  # # # # . #   # ## # # # #.#.# .#
# #     # # ### ##.##.# ####.## ## # # ## ## ## # ########## #.# ### ##### ##  #  # ##.# # # ## #.# ## ## # #. #  #   # # # .# # . # #.# #  .        .   # #
# #.# ##     .         .         = ..  .       .                 .   .       # #.# .                     .#  # # # .##  #.### # #### ## #. ### ######### # #
#.#  # ## # ### # # ## ## ## ## #.# # ## ######### #########.# # # # ########. #..######## ## # ## ## #.#.# #  #  #  .# # .  .           #.#      .     .# #
# # # . . #.#   # # #..# ## ## # # # # #. .    .            #.# # ## #   . . # #.##  .  . . #.## ### # .# #  # # #  ##  # #### ####### # #  # # # ## # # # #
# ## #### ## ## ## #.#   .   .       # .############ ###### #    .   # # # # # # . # ### #.##     .. .#.# # #  #. #   # # ..      .  # #   # # # # #  ##.# #
#  .      .   =  ... # # ## # ### ###  #     .      .        =####### . ##   # #.### # # # #.#######.## # #  # # #  ##  # # # #.# #.##.  #   #     # #   # #
# ### ## ## ## # ## #  .#  #.#.   #  #  # ## ## ## # # ## # # #    . # #  .# # # #.           .     .o    # # .#  # # # #  # # # # ## #### #.# #### # #### #
### ## # # # ## #.## # ## ## ###### ## # ##.## # ## ## # # ## ## ##### #### # .#   #.# # ## # # # # ## ##    # # #  #     #   =   .  . . .         ..      #
#   .  . .                          .    .  . . .                 . .  ... ..# # #.##.# ## # # # # # #. # # #  # ## ### #  # ##### # ## ### # ## #### ## # #
### ### # # ####### ## ### #.#### # # # # ##.# # # # ### # # #.###.# ### # # #.# #     .        .    # #  # .# #.    .#.# # #     #.  #   # #.# # .   #.#  #
#. #  # # #  .       #     #    #  # # # ##..##.# # ##  #   #. #. # ## ## # #  #  # ### ############ #  # # # # ### ## #  # ##### ## # ### # #   # ##  . # #
## #.## ##.####### ##  ##### ## .#.#       # .#.# # . # # #  # # #     .. .  # #.#.     .    .         #    . ....   .. #.# .  . .  .   ..    # # # #.####.#
#   . .      .      =# #.  . #  #. #.#.# # #.#  #  .# # # # #  #  # ### ## ##  #  # # ## # #### # # ## .# ### ######## #  #.# ##### # # # ### # # .      ..#
######### ############..##### ##=# # #   # #  # ###          # # #  #  # #   # . #.# #  #.#     # ## # #    .        .# # #. #.    # #. #   #  . # ## # ## #
#                .     #.. . .      .# # # #.#    # # ###.# #= # .# # ##.# # #.# # #   #  # ### ## # #  # ## # # ## # # # # ## ##### ### ## ### # # ## # # #
# ## # ### ## ##.# # #  ##### ###### ##.#.## ## ##  #...# # ## # #  #    # # # # #.# #  # # #        # #  # # # #  # #  # #       .    .      #.# #   .# # #
## ##.## ##  ## # # # .#.             . .    .    # # ##   #.# # ##  ### #.# . # # ### ## ## ###### ## ##.       #    #.    ###################.# #### # # #
#           #     .  #  ## # # # # ### # ### ### #  #   # #    #. # #  . #  ## # #.             .       #.######## # ##.# #                     #    . .  .#
#### #.#.## # # # ###  #    # # # ## ### # #.# ## # # # # #### # ##  # # # # # #  #################### #  # .     . ..  # .# ## # ##.## ## # ## .####.# ## #
#  ..  # .# ## #     # # # #    ..     .     .  . #.# ##     # # #. #  # # #  . .#          .       .  ## # # #### ##.# # # #  # #  #. # # #.#  #.   # #   #
## # # # ##   . # ## #  ##  ##.## ##.## ## #.#### # #.  #.#### # ##  # # #  ## #.######################.# #.     # #  # # # ##.# ## ##.# # # ## # # #    # #
## # # # #  ####  #..# #  .# ### #. # # # ##.#      # ##  #. . #    # ## ## # .#   .        .    = ..   # # # ## #  # # # #              # # .# # #  # ##  #
#. ##  # ##     # ##   # # #      # # #.# .   # # # #   # # ## # ##...       # # # # ## ## ####.###.# #   #  # #  .#  # #.# # # ## ## ## . # #  # # ## # # #
## = # #  #.### #    # #   # # #.#  ..   ### # ## #.#.# # # #  # #  ####### # .# # # #  #.    #  .   #  #  ### #### ###   # ## # ## # # ## #  # # # #   .# #
# .# # # #  # # # # ##   # # # #  ## ## #  . # # #. # #.#   .# #  # #      . # # #  # #  # #### ## # # #  #     .     . # #     ..       . # #  # ## # #.# #
## ##  #  #.# #.#  #   ##  #.# # #    # .# # . .. #.# # # ## # # #   # #.### # # # #    #  #    # ##.# ##  #.## #.# # # # ###### ####### # #  # #    . # # #
#    # # #  # # # #. #.# #.## ##.# ### ## #  ###### # # # # ##.#  # #   .      #   # ##  # ## # #.   #    # # ## ## ###.#  .   . #   .   #.#.# . ##### ### #
## ###.#  # # # #  # # # #          .     .# #    . # # # . . .# ##  #### ## # # #  # # #   ## # ### # ## #           . #.## # #.## ## # #.# ## #.     . . #
## #. .  #  # . # #  # #   ### #### ## ## #  #.# ##.##.# #######.#  #.     # # # # #.    # #     .     ..  # # #.#.## # # # # # # ## ## ## #  # #.# ## # # #
#. # #.#  #. ## #  # #  ##.# # # . # # ## ## #  # .       .     ..#. #.## #  # # # #.## #  # ## ####### #.#   #.#.#   # # #  .     ..        #  #  # # #  .#
# # # # ### # ### ## #.# # # #  ## # #   . # # ## # ### ## # ## # # #.  #  # # # # # #  .#  ## # . o. .#   # # .  # # #    #.## ## ####### # ## # ## ##.## #
#.                   # # .     #     # # ##. .    # # . # ## # ##.#. # # ###.# # # #  # ## #  .# ### #  # # # # # ## #  # #   # # .       #   # #        . #
################# # #  # # # # # #.## .#   # # ## #  ##           # #.  ..   # #.# # #  #.  ## #  .  # #  .         . #.# # # #. ###### # ## #   # #######.#
#.   .      .    ..# #  ## ## # ## #.##.##   # # .# #.. # ## # # # .  ## ### # ..# #  #  # # #.### ### ## ## # # ## ##. #.# # #.#             # #          #
###### ###### ### #  # # . .               # #  # #.#.# ##.# # #  # # .    # # # # # ## #  #    ..      .  #  # # #   #.# #  .   # # ## ##.# #   ######### #
#         . #   #  # # ##### ############## # ###.# ## # #.## #.### ####### #  # #.#    ##  ## ########## #  ##  .#.### #  ##.# # .# # # .##.##.#      .   #
## ###### # # # # ## # .                .        .     .    .    .       . o #   # # ##. # #     .         # #. # #.#  .# # # # #### # ## #.  # .##.# # ## #
#=        . #       .# ## ############# ## ############### #.## # # # #######  #.# ## # #. ############## # # # ## # ##.# # # #.       .   # ##.#  # . # # #
## ### ## ##  #.# # ## . #                 .  .       . .#    .#       ..    # # #     . # .    .     . #      .  .     # # .   ## #########.#   # # #.# # #
## #.## ###.# # # ..#  # # ## ### ####### ## ### # # #.#   ## #  # ##.#.# # # .#.# # # #.# ####.## # # #  #.#### # ## ##.  ## #.#. #      . ..# # .# #.# #.#
#           # # # #  # ## .#     #.     #.  #  # ## # # .#  #  #  ##.## # #  # #.  ## #.##.#  # # # # .## #     #   . #.# #   #. #  ###.## # ## .# # # # # #
## ## ######  #.# #.#    #  #### ### ####.##. #  .#   .# # #. #  #. .   # #.#= # #.       ..# # # #  #  #.#.### #### ## #=#.# # #  #.. .# ## #  #      # # #
#  #       .# # # #. # # # #.     . .#    . #  # ## ## # #. #  # # ## # . # .# #.# ###.#.# #. # #   #. #  #    .          #.# # .#  ### # .   #. ##### # #.#
## # # ##### ## # ## # # #  ### # ##.#### ##  #.    .  # # ## #.  ## ## # # #  # #    # #   # # # #  #  #  ### ### # ## # # # # #  # .# #### ## #        # #
#  .    . ..         # ##  ## ## # #     .. # ## ## # #  # # . # #      #.#  # # # ##. . # #. # ### #  #  #  # # # #. ### #.# #  #.#.##    # #  # #.## # #.#
######.## ### ### ## #.  # #  .  .  .## ### #  # # # # # # ##### ####### # ##o # #.   ##.# .# #      #.## # ## # # # #    # # # ##      ## # .#  ##  # # # #
#    # #  # =   #.#    ##   ## ##.##  # # # # ##    .  # #.   .             .# # #### # # ### #######.# # # #  #   #  ### # # ### # ##### ## #  #   #= # #.#
#### # ##.# ## #  # ##   # #  #  #   # .# # # #  # # ##. # ## ## # #.# ## ####.# .  .   . .     .       # #  # ###.# # = .#                   # # # ## # #.#
#. # #..#   . . # # #. ##   # ## ### ## # # #  # #    .# # .# # ##.# #  # #     .# #.## # # ##.# # ###.#  # #    # # ## #  # # ### ### ##### ##   #    #.# #
## # # #.######## #  #   # #      .   # #   # # . ## # # # #  # #  #  .#. # ## # ## ## # # ## # # ##.# ## #. # ## %# . #  # #    # # #.    # #  ## ##### # #
# .# #.#      .   . ##.# # # ### ### #   ## #..# #   ##  #  ### ###.# #.## # # # .  .  ..   .  ..   .   # # ## # #  .#  # #  #.#  .# ######   #      .   # #
## # # .### # ###.# #. #.# #     # # .# #.  # ## # #.  # # #         .    .    # # # ## ## ## # ###### #  # #    ..# # #  #.#  # # . .     # ## ###.# ##  .#
#..  # #   #    # # ##  ## #######.#.# # #### # # # ###.##.  ### # ## # ## ### # #  . # # ## ## #   . # # #.## # # # # ##.#  ## # ##### ##.# #  # ## # . # #
#### #  ## ## ##  #  # #                      .  .     .   # # ## ## # #. #  # # #.## # #    .  ##.##   # # .# ### # # . .# #   . .   . . . . #.# .   # #. #
#..# #.# .  #.  # # ##  # # # # #.## ### # # # ##.# ##.# # #  ..  .. .  # # ## # #.#. # # # ###  ## # ### # #      #  # # # # ## ## # # ##.# # . ### ##  # #
#.##.# # # ## ##. #.#  #   # . # # # #  . # #.# ## ## #  # # ####### ##   # #  #.#. # # .# #    #     ..  # .# # # # # # .#  #.# # # # #.#    #.#  #.#  ##.#
#      ### # .  # #  #  #### # # # # # ## #.       #   #.# # #   .      # #.## # # #  # #  #.## # # ## ## # ##.# . # #. #   #    # # #.# # # #  # ## ## #  #
# ##.#  ..  # # # # #  #.   .    ..# #  #  #.# # # ## #.#. # # ## ## # # .#  # # #  # #  #. .    # #.##   # # .  #   # #  #.###### # # # ##   # .       .# #
# # # #### # ## # ## #  ## # # # #.# # #  # # # #.    .  # . ## # # # # # # ##.# # #  # #  ## # #       #.#  #.##  # #.##.#   ..         ..# #  ########.# #
#      .     .         #.# # .# ## # # ## .   .  #.#####.# #            # #.#  # # ## #  # #.   . ## ###  # ## # # # #    # # # ##### # ###   #        # # #
# ## ##### ## ###### # # #.# #.   .. #    ########     # # # #.# # # #.#  #  # #   .  #.# . # # #..     #.# #  #.# #  # # # #  #    # # #..# ## ##### ## # #
#  #      # #  .. .  # # # #. ## # #  ###.#    .   # # # # ## # # #.## ## #.#   # #### # # # # #.### #### #  # # # # # #  # # ## ### # ## ## #  .   # #  # #
# #  ### ##. ### ###   # ## ## ### # #  # .#### ##.## #  #   .               # #                .         # #..# #      # # #      .. .      ##.### # ##.# #
#  # #   #  #        # #=   .      . # #  #     #     .# # #### #### ###.# # #  ### ######### # ## ## # # #  # . # #####  #  ## # # ### ## # .#.#    . # # #
#.##  ## ## # # ####.#  ## #########    #. ####  # ## # .# #  .##   #.    # #  #.  #    .    # #   # # #  #.##=#.#.     # # ## #.# ## ## ##.### ####### ## #
# .  #        #.  .# # #  #   .    # ###  #     # . ## ###  ##.#  ### ## ##. # # ##. #.#####.# # # #.   # #    # # ### #. #...     .      .         ... .  #
## #  # # # # # # # .#  # # #.# ##=#    #  ## #  # #=      # #  #     .# #  #      # # #. .  # # # #.# #   ### #.# # ## #  # # ##.## ## # #.#.#.# # ##.### #
# #.## # ## ## # # ### ## ## # # # #.#### # # # #   ######.#   #  ## ##   # ## ###.# # # #.# # # # #  # # #   .    #      # # # # . #    # #     # ## # .# #
#    ..     .      .               #.#    #   #  #.# .  .  # #  #.#.   # #  .#.#  .# # # # # # #.# #.#    # # # ##  ## ##   # # # #  ## ##  # #.#  # .# ## #
##.#### # # ## ## # ## #.### # ## #.. ### ##### #. # ## ## . # ## ###### ## #  .#### # ##.## # ## ## #### # # #  # # .# # # # # # # #. . . # # # # ## # #  #
#     # ##.## # ## # #. ## ## # #..# #      .    #  # .#.# #   .      .      # #        ....          .    .#.# ##  # # #.# # # # # # ## # #        # #  # #
# # # #             .# #      # # #   #.# ### ##   #  #  . # ## # # #### ## #  ## ####### ## #### ####### # # #.#..## # #=# # # # #..    # ## #### #  # #  #
# # # #.# ## # # ## #  # # # ##.# ## #.##.# ## # # ##.#### #.#  # # #. .   . #  # ..  . # # #    .#  .  # #.#  .##.#  # # # # #   #.#.## #  . .  .  # .. # #
#   # # ### #=# # ## # ##. #.#  # .#..     .  .         .# ## ##.# # #######.  #  ## # #    # #.# # # # # ### ##.#  # # # # # ###   ##.##  # ##### #..## # #
# # # #    .   .    .#   #  # # #.## ### ##.### # # # #.#     .    .   ..    # ## # ## ###### ## # # ## # .  .  .. #  # # # #.    # .   .#  #    #  # # #  #
# # #.  ### ##.## # #. ##  #   . . . #.### .#  ##  #.# # # #.#.# ## # #.## ##   . ..  .   ..      .     # ###.## #  # # # # # ##### # ###  ## #### #   ..#.#
### ###.  # .# #  #  # # #.#### # ## .    #. # #  #      #  # # #.## # #  #  # #.# ## ###.#.# # # ## ## #.#.## ### ## # # # # # .  ..    #          # #.# .#
# .     # # # .## ###       .  .# #. ## #   #. .# ###### # ## #         # ## #  # #.###.## # ##.## ## ###.#. . ..  #  # # # #  #### ###### ##########  # # #
## # ## # # .#  .  . # #########.  #.# .### ## ##   .   .#    # # ###.#  . . # #=             .   .   .   # #### # .#.#.    # #   . #      #       .. #. # #
#.# # #  # ### # # # # #.       #.#. ##   #    # .## ## #  ## # #    .# # # ##  # ## # # #.############## #   .  #.##   #.#.  ##### # #.## # ##.## ## .# #=#
#   . # #      # ## #  #.####### # ## ####.###.### ### # # #.## ###### ## ###. # # ## # #  .           .   #######.#  #.#.# # .  .# # # .. # # # ## #.## #.#
### ##  # ## #.#     # #            .        .           .     .   .     ..  # #    . #  ### ## # ## # ## #.  .  .. # # #  ## #.##. ## # # .             # #
#   #.#  # #.#.# # ##  .#### ############ ## ## ## # ## ## ## # # # # ### ## . # #### # ## ### # # ## # #  #.## ## ## #  .#.   # ##..  . # # # ## #######  #
###.  # #      # # # # #      .  .     ..  # # # ##    # # #   # # #.#    # ##           .           .  # # #.## #      # # # #     #####  # .# #       .# #
# # ###  ###.# #. =# # .# # # # # ##.## # #   .#   # # #  .# # # # #  ### #  # # # ######## # ## ## ### #.# #    # ## # # ##   ####      #=# ## # # ## # # #
# .     ## #   # # #   # #.# # #=## #.##   # #.# # # # # # #    .  # ## # # ##  ## # .     . #.#   .   .# #.#.##   .#   #   #.#     # # #  #.#  . ## ## #  #
#######      # # #  ##   .            ..# # # ## ##      # # # ## #  #  # # #. #   ## # # ##    .##.# #.# #  .# ## #. #   ##   ## # #.#. # # # ##        # #
#  .   .# # #  # # #   # ##.# # #.# ## #     ..  . # # ##. # ### # # ## # #. #.#### ## ## ## ##### # # ## # # #     #  ##.# # #.### ## ### # ### ######### #
######## # # ## #.# ## ## # ##.#.#.# ##.# ##### ##   # # # #           .. # #        .    . .   .      .  #.  #### #  # # #   ..  .      ..          .  .. #
#          .  .     ..            ..    #    . #   #   # #  ## # ## # #.#    # # # # #.# # # #.# ##.#.# # # # .  # .#   #  #.### # ###### ### ##.## # # ## #
## ########### ####### # # ## # #.#### #  # ###  # # # # # #  # ## #.#.## ###.  # #.# # # # # # ## # # ##  ## ####.#  # # # ## # ## .   # . # #    .# .# # #
# #  .       #..     . .# ## # ## #   # # ## . # #.# # #   # #      .    . . # # .     ..      ..      .  #    . .. # . # #. .    #.####  ### ### ## # # # #
# # # ## # # = ### ###.#  .       # #   #  # # # #   # # #    # # #.# #.#.###  # # ###.### ## #.### # # # # ## # # #  #    ### # ##     #   .  .. . .  . #.#
# # ### #  ### # ### # .#.# ## ## # # ##  #  #   #.# ## #  ## # ## # # #     #  # ## ##.  #  # ## ##.# # . # ## ##.##  ##.#   #  #  ### # ## ###.### #### .#
#  .   . #          .#.#.    # #  # # # # ## ### ##     .#  # #     .  .# ##.  #  # .   #.# #           # #      .  # # #  ## ##.##.# ##. #    #  =#     # #
### ## ##. # #.## #.# .## # #   #       # .        # # # # ## # ### ###.#    #. # #####.# # ## ##########  # # # #.# .# # #     . #.    #  #.# # # # # ## .#
# # # #.## ### #     #  # ## # #  # ##.## ## ## ## # ##.#  # ## #.### ### # #  # .  ..    .     . .       # .  ##   # # #  ## ##.##.##### ##. # # # # ## # #
#        .    .#### #  ## .  #  # # # # . # ## # # #     #.#.              # #  ## #### #### ## # #### ## ####.  # #    # ## # #    ..   .# .#   .         #
## # # # # #.#... .. # #  # #  #  #     # ..     #.# #.#.# .# # # ## #.## # \  #  .   #     .  .# .     #  .   ##   # # #    ..#.# #.## #  #  # ## # ## ## #
############################################################################################################################################################
