##########################################################
#...  . #     . #     # # .#      #. .  .  # ## # #.. ..##
# ## # # .## # #  #.#  ...##.## #. .# # ## #   .# ..###. #
# #  .# #.. . . # .   #.# #     . # # #    # ##...#..  o##
# # # # #.## ## #.#.### # ## ##.# # # # ####.# ##  ## #. #
# #.#.#   #  .    .            .  . .  ..      .  # ### ##
# . #=# # # # #### # #### #.# # # #### #.# ##.###   .    #
# #.  #.# # #      .       ....   # .### .    #. .#.## # #
# #.#   # #.## # ## ### # ##.## ##  #   .#### . #   # # ##
# . . #.  #      .   ... ..   .o. #. .##     .#.. #   . .#
#.# #.# #   # # ### # #.## #.## ##  ## # ##.# . # # ## # #
# #.#  .#.# # #      # #.   . .#. #.#.. .#.# #### #.#  # #
#.# ..# #       #.# # .  # # #.#.## .#.# #        # ##   #
# # #.#.# # # #   # ## # # # #.. #  ## # ## # ###.#  . # #
# . # . #.# # # #   .# #.. # #.#  #    #   ...  # # ## # #
# #   # ..#   ..# # #. # # # #   #..## # ## ## ##.. # .  #
# ### # # ..## ## # ## ## ## # # ##.##.# # # # #  #  # # #
#  .#   # #=.   .       .    . .  .. .   . .    # # ## #.#
# #.  # . # # ##.## ### # # ##o##.# # ### ## # ##.# #..# #
#  .# #.# #   ### .     ...#.# #.#  # .  .  #.#   #. #.# #
# #.#.# # # #..## ########.#=#.   #.#.### ###.# #.# # .  #
#   #.#  .# # #     ..   .=# ## #   #  .  .  . \# # ## # #
# # . # # .     # ## ##### #.   . #  # # # # ## ..# .   .#
#. ##.#.# # # #     .     .# ## # #.## ##.# # # #   ## # #
# # #  .# # #  .# #### ###.#.          ..  .  ..# # . .# #
# #   #  .# # # # #  #.  # #.## ###.#.## # #.# # .## # # #
# ###.### #  .  .   #  #.# #       .#  #.#.## # #   .    #
#. .  ..   ###.##.#  # # # # #.## # # # .#.   . #.######.#
###### ## #    # .  # .#.. #. # ###.# #### #%##      ..  #
#    . ##.# ### ### ## # # #.#    .= .    . o   # # #### #
### ##  ..#.   .    ....   #.# ## # # ## # #.##   .     .#
# .    ## .#.### ## #### ###.# # # # ##.##.## ###.##### ##
# # ##  # # .   # #    .         .   .    .  ..     .   .#
## # # ## ## ####   ##### ##########.######## # #.#.# # ##
#. .   .    .. . .# . .      . .  .# #.. . . # #.# #.# # #
#.##.#### # #.### # # ######=##.# #   #.# # #       .#  .#
#.  . ..  #  # . .# # .. .   #..#  #.#  .# . #.#.# # # ###
## #### # # #. # #  # ## # # ##   ##.#.# .# # # .  # # . #
#     # # # ## # ## # ## # ## #.# # .# # ## # .# ##. # # #
#.#.# # #      #  . #..          . # #    . # ##.# #.#   #
# #   # # #### #.##.#.##.## # # # #. ######.  .  . .   ###
#. ##.# #    #  . # ## #  #.# #.# ##      #.# ## # # #.. #
# # #.# # ##   # ##  .. # .. . . .  .##.#   ..# ##.# # # #
#.#.# # #  # #.# #  ###.# # ### #### .## ## #  . ....# # #
#     . # #= # .  # # # # ..  .. ..  # .    # #.##.#.  . #
# #.# # # ## # # ## #.### ##### #### ###### #.## #.# #.#.#
# . # #.#      .   . .   ..      .. . .   ...=     ..    #
# # . # #.### # #.# ## #.# ## ## ###.#.##.# ### # #.###.##
# ###.#.   ... # ## # # # #.# # #  #.# # .# # # #     .  #
#       # ### #   ..  .   .      #   .   #    # . ##.# ###
# ###.# # #    #######.# # ## # #. #.#.# #.##   # #. # # #
# #   # #   #.#     . .#  .   # ## # # # # #  # . ## #.  #
# # #.#   #    =##.# # # ## # ...# # # . #=.# #.#  # # # #
#   #.# #   # #   ...# .   .# #### # # #.#### # # ##.#.# #
# # # . # #   .#.# # . # #.#   .   # ...   . .. =  .     #
# # . #    .# # ## #.#   .  #.### #  # # # ## ####.#.#.#.#
# # #.#.# ## .#  . #.#.##.#    . . #  .        =  . .    #
##########################################################
