#############################
#     #       .     #  # #  #
# # # # ### ## ## #.# #  # ##
#.  .   #    #    ..   # # ##
# # ### # # # # ### #### .  #
#.. = .    .             ## #
#### # # # ############# # ##
#   .   # #  .          .   #
# ##.##.# # # #.# ## #.# # ##
## # #. #   # ##o#     # # ##
#.  =## # #        # # .    #
# ### #.# ########## # # ####
#          .    ..  .   ... #
### ### #.##o# ###### ## #.##
#  #.    #  .  #      .#. . #
## #### #  # # #### # #  ## #
#    .%  # #.#    # # ## #  #
##.# ## ## # # #.# ##  # ####
#    .  .       .     #     #
# # ##.##.# #.## # # # #.## #
## #.## ###  .# ##   .   .  #
#     .     #      ### ##.# #
###.## ## # ### ## .     .  #
#   #  # ##  .   # ##.# # #=#
# #  # #    ### ## #.# #.## #
#o# #  . ##      ..  .      #
#   # ## #. ##### ## #.#### #
# #  \    #.#      . = o  . #
#############################
