##########################################
#.... #.#..#...#.#.....  ........ . .#.#.#
#.# #.#..#.#.#.#.#### #####.######.## .# #
#.##.##.#.. .#.# o ........ .....  . #...#
#..... ..#.#...#.##.#.# ##.## #.##.# # ###
#######.#.## ##..#.#.##.#.# ..# .#.##....#
#.o.... ..... .# #......#.##.#..##...#.# #
###.#.#.#### ##...#####.#...  #.#. #.#...#
#.##.#..=..#. .#.#....#..###.#..###.# .#.#
#.....#.## #.## ..#.# #.#. . .# ... .#.#.#
# ##.##.#..# . #.#.## # .#.#.#..#.##.#.###
#... ...##.#.#.# . ...#.#..#..#.#.#.#... #
###.###..#. ..##.###.#. .#.#.#..#... #.###
#.#.#.#.# .#.#...#.#..#.#.## ##.### # .# #
# #.#... ###.###.#. .#....... . .... #.#.#
# ...##.#  . ....#.#. #.############.#...#
### #....#.#####\##.#.#. ...  .. ...#..###
#.  # #.##.  . #.....  .###.# ## ##. #.#.#
####.##.#.####.#.########.##.#.##.#.##...#
#. ..... ........... .. . ......... . .# #
##.##.#.##.###########################...#
#.## ##.# .#... .  .... .  . ... ... #.#.#
# .... .## #.#.## #.##.#.#.###.# # ##..#.#
#.###.#..#.##.#.#.##.##.##   #.###.#.# #.#
# #. . .#.......... ..... .#.. ....#.# ###
#=##.##..#####.### # ###.#.#########.#...#
# ... ..#.  .#.#.##....#.#.... ....o.# #.#
##.####..#o#.#... .#.#.#.#.#### ##.#.#.#.#
##.#....#  # # ##.#..#.##  .   ..# .#..#.#
#. .#.#. ###.# #.. #. ...# ####.#..#.#...#
##.#.#. #... ...#.##.#### ... #  #.#...# #
#.... #. #.#.# ## # .#. .# ###..#..#.# # #
##.## #.#.#.=#..  .#.#.###.#  #.##.##. #.#
##.# #..#.##.#.#.# #%#.. ...#.#..# ..#.#.#
#..   #.#....#.#.#.#.#.#.#.#....#..#.# # #
######.#.####.#.#.#.## #.#.##### ##.##.#.#
#.  .. . .. .. .= .. ......... .........##
##########.############.# ##.##.# #.#.##.#
#..... .. ..... ........##.##.## #.##.## #
####.###.#.#.#.####.###............ . . .#
#.... ...#.#.#.. .....#.#.#.# #.##.#.#.#.#
##########################################
