###############################################################
# # .  .# ## .# #   # .  #. .   # =## # #.# #.#=# .  #  \     #
#...###   . # #..##  ##.#.##.##.  #  ..  ..   . .# #  ## # # ##
# # #   ## #  # #   #    .   #.#### ## # ## #=# # # .#. #  .# #
### #.### ### #  ## # ###.##       #.   # #.##.# ..# # #.# ## #
#   # #  . # .#.#  .  .  # # #### ##.###  .  .  .##  #   .    #
#.#.#  # #  #.# # # # ##    # .  # ..  .# ######## # # ########
# # # ###  ## #.#.## #.# ### ## #. ######   ..  .    .    .   #
#.#.# ## #.  .# .     .#.    .   ##      # # # # # # ## ## ####
### #    ## #  ## #.### ### ### #  .## ## # # # ## .#...# #   #
#  #..# #  .# # .## ..  . .# .   ##.# #  .#.#  ...## ## #   #.#
##.## # .### .#.# .####.##  ### #.    .##   # ## #       # # .#
# ..  #.#. .# # ##. .  ## ##..  # ##.#  # # #  # ## # # # # #.#
# # #  #  ## .     ## #.  .. ##  #. .# #. #. ## .. .##..#  .# #
# ##  # # .#.#.# # ## # ##.# # # ### # ##.### # #.##  ###.### #
#.. # # ..#. %###  . # .# #    #   # #  # .   . #  .#  . . .  #
#####..## o# # # # ## # #  # ## .### .##. ### # # # # # #.### #
# .  .# #.# .#.#.#    #.# #. # #  .. # ## # .# #.# ## ## # .# #
# ###   #  #     # # #  #. # # # # #   .  . #     . . .. .# # #
### #.##  # .####. #. # # #. # #.## .## ## # ### ##.#.# # #.  #
#.     # # #     #.# ## #  #   #   # #  . #  # ## ## #.##..##.#
### ## # #  ######  # .   #  # #.###  # ## #          .. ## # #
#.   .#o. # .      # ##### #.#.#.# ..#  #.  #### # #####      #
## ## ## #  ### ## #     .   # #.###. # ## ## .# ## . . # ### #
## #. .#. # # ###  ## ## ###.# # . # #. . .#.#...   ## # .. # #
#  ## #  #     . #...# # . .#. #### .####### ### #### # #### .#
### # # # #.##.##. ###.#####..#  . #    . . . .    .        # #
#  .  #   # # #  # . .. ... #  # # # # ###.# # ##.# ## # ## # #
###.# #.#.# #. # #.#####.## ## # ##  ###  # # ## # #. # # # ###
# ### #. #    #    .   # #  . #  . #    .# .    .    ## .    .#
#     . #.# ## # ###### # ####  ## # ####### # ## ##  ..## ## #
## # ##.#.#.#   .     ..  .   # .# # #   # ## #.## #.##.# # . #
##.# #     .#.# # # ###.##.# #  # .# .##.#   .  . ...#. #. ## #
#..#  ## ###  #. # #..# # #   #. #.# # # .######.# #..# .# #..#
###.## ### ## #.#  # ##.   #.#### .#     #.  .   ##  ##.#   ###
# .         . #.## #.# # #.#  #.## # ###.#.#####.= # #.  ## # #
### ##### ####    .# # #  #  #   . #.# .# .# .  # #  ##.# ..  #
# .#     ##   # # ## # # # #. ## # # ##  # # ##. # #  # .#### #
##.# ## # . ##  # #. # # # # # .#..# . # # #  # #.  .## #. =  #
## #  ## ## # # .# # .    .#.##.## # ###   # # .# ##.#.   ### #
#    #          #  . ## ## #      .# #  #.# #.# ###  .# ##    #
#### ..#.# # # #  ##.#.# ### ## # ## .# # #.#.     #.#. #  ##.#
#    ##. #.##.# ## # # .. .  # ##.# .## ###.# ##### #.## ## ###
###### #  # ..      . ## ##.#...   #       .. .  .  . .  .. ..#
#     .. #.######### #   # # ####.## #.##.#.# ##.#####.# ## ###
## # # # #  .   .     ##.# #      #  ## ## # ##.     # # # .# #
# .# ## .# ## ####.# #  .#. ##.##  # ..    ..  # ## #..## # #.#
# ###  # # .# ..o # .# #   # # #  ### # #.## # .# .  #.. .#.# #
## ##.#  # # # ##  # .#.## #    #..# #...# ##.# .# # #.##.#.# #
#.     #.#    #.##.# # ..  .#### #o#..#=#     . ## .#  #  # # #
#.#### #.#####    #  .## # # . . . # # .####### # .#.# # ##   #
#.   # #   ... ### #.#  #  # ## ## # .#  .  . # #.#   ..#   # #
###### ######.#  # #. # ### #.### ## ##.######..## #.# ## #  ##
#   . .   ..   #.#=# # .      .          ..   #.    # # . ### #
### ###########.  . .# # ## ##### # # ## #### # # # # #.#   # #
# # # = ..     # ### #.#.  # ... # # # ## . .#  # ##. # ##### #
# #. ##### ### #.  #    ## #.## #.    .  #.#### #   # #  .   .#
# .# #.. . # #.#### ## #  #  #.# # # # ##    #  ##### # ###.# #
##.# ##### # # . .  .# ## ##     .  #  # ## ##.# .    #..  #.##
#       .. #   ##.# #. .#   ##.#.##  # # .  .  ####.#.# # # . #
#.## # #### ##.# ##  # # ## # # # # # ## # # #    .##.# #.## ##
# .# # .     #.    # #. .        .    #.  #  # # ##.    #     #
###############################################################
