###########
###\.#   %#
##  #  #.##
#o#  #.#. #
# =.# # #.#
# ##     o#
#=## # ##o#
#  = #=#  #
# ####  # #
#o .  # # #
###########
