####################################################
#.... ..... . . .  . #...#.#.#.. .. .=.#.#...# #.#.#
#.##.#.# # #.#######  #.##.#.#########.#.#.##....# #
#. #.##.# #. #.. ..#.#........ . . .  ..... .#.#.#.#
#### ...   #.#.#.#.#.## #####################  ### #
#..  #######.#.##.# ... .................. ..# ....#
##.# #... ... . .. #.## ###.# ##.###.#.###.#.# ###.#
#.#.# ##############.##.#=.# #.  #.##....# # #.# #.#
#..... . . . . .. .......#.#.#.#. .  #.#.#.#.# # ..#
# ## #.#.### ##### ## #.##.# ##.#####.#.#... #..##.#
##.# .#.#. .#.  ..# . #.. .. ... .. . .  # ##. # =.#
#..# #.  ## #.### .####.###.#####.## ####.. .#. ##.#
##.#.## #.#..#. #.#... .#.# #...#.  . .. #.##..#.#.#
#  #.    .#.##.#.. #### # #.#.#.#.###.##.#.. #.#.# #
## #.#.#.#..# . # #..   #.## ## ### ##.##.###... #.#
#  #.#.#  #  #.#. #####..   . .. . ....   .. #.## .#
##.#..#.###.##. #... .#.###.##########.#.### # ..#.#
## #.# . ...#..#..####..#..#... . .  .#.## # # ### #
#.o# #.## #. #..# #...#..# #.###.#.##.# #..#.#. .  #
##.# #o.. #.#  #..#.# #.#  ... #. # #.#..#.#.# #####
#..#.#.### .##..#.#.##..####.## ###.##..#. #.#. .o.#
##.# #. . # .# #  ....# ...# ..... ...#..#.#.#.#.#.#
#..#.#.###..#..##.###.#.#.#..# #### ## .#....#.#.#.#
## #.#....#..#..#.#...#.# ##.#.. .# #.#.#.## #.##.##
# .#.# ##.#.#..#...##.# #. #.## #.#.#...# # .#. ...#
##.#.# #=# ..#. #.#.# # #.##.=## ##..##.#..#.#.###.#
#..#.#.  .#.#..#. # ..#.#.#..#   ...#.#.#o## #.#...#
## ##.##### ##.##.##### ##.#.######## # ###.##..####
#. = . ..   ...  . ..   ...... .... ......... .#. .#
##.##.# #.##.##.#%##.#.### #.### ###.##.#.# ##.# #.#
# #.#.## #.#=#.#..#.#..#.#.#.  # # ..#.#.# .#..# # #
#.#.. .... ... .# #.#.# .#.#.# #.#.#...  .#..#.#.#.#
#. .# #.##.#.###..#.#.##.# # # #.##.######..#. # #.#
###.# .##.#. ...# ..... .#.# #.#.. . .....# ##  .# #
#.#.#.# . .#.###..## ##.##.#.#.#.### #.###...#.#.. #
# #.# #.# #. #..# #.#.#.# .# # #.#.#.# ...#.##.# # #
#.#.# # # ##.#.# .#. ... #.#.# #.#...#.#.#..#. ### #
#.# #  .#  #.#.###.######. #.# #.#.#.# ...#. #.... #
# #.#.###.# .....   . ...#.# ### # #.#.##.#.#  #.###
#. .#.#...##.##.### #####. # .....## #.#.#...#.#.#.#
# #.#. ##..#..#.#...# .. #=#.###.#. .#.   #.#..#.#.#
#=#.#.#.# ##.##.###.#### ##.## ##.###.####.#.#.#.# #
#.# #.# # #..   ..#.. ...  ..... ... ...... ...# #.#
# #.# #.#.##.###### # #.##.####.# ##.####.###.#..# #
#.# #.#  ....# ... .##.#. # ... #.#.#   #.#..  #.# #
# #.#.#.#.##..##.##.....#.#.### #.#.## # .#.# #..# #
### #.# ##.# #...# ##### .#.#.#.# #.....#.  #.##.#.#
#... .#. . #..##. .\.   #.### # # # #.##..###..#.#.#
# #.#.# ### .#.#.#.#.#.#.=.=. #.#.#.###.#.#...## # #
## ##.#=#.##.# #.## # #.#.#### #..#.. . ..###.#....#
#.....#.#.=..#. ...   .. .. ... #.#.#.# #..... # #.#
####################################################
