#############################################################
##.#   #  .   #  .  .# ##.#   # #.# # ## .# #  #  #   # # . #
# .# #   ## ##  # ###... .## #. ..  #    # .# ### ###.# # ###
# #  #### ##  # # #  # ### #.## # #.# ##### # .## . #.  .  .#
#  # .    .  #  ### #  #.   .. #  .#. .. #  # #  .# .##.#.# #
#.## ####### ##   .. #.#.#.# # ### .### # # # ###.### ##..#.#
#.    .    #  .# #.#  =## #  # ... #    #..             ##  #
###.#.# # # ####  # ##     #.# # # # ##. ## ##.##.## ## #.#.#
#   .### .       #...# ##.# .#.# ##.  #.#  ####.# # # # # ..#
# #.# # ### # ###.#.##.#.# # # #   # #  # #.## ... .# #.#.# #
# # .. ....# #  .. ...  . . .## ###  .#   . . #.### #.#  # .#
###.#### # . # ## # ##.# # ## .    # #  # ### # #  #  #.### #
# ..   #  ####..# ##..#.#.# .#.# #  #.# #.# #   . # # .  #..#
# # ## #.##    #  .. #. . . #..##  #.. . #    ##.#.. ## ## ##
## # ###   # #.#### #.# ######  .## ###.#  ##...##.#.  . .. #
#       ## ### .   #  # ..  # ## #   ... ### ### .# .### #.##
# #.###.. #    #.#. # .#.#.#   #  .# ##.#      .#. #.#... # #
##.## ## ## ###.# ## #. # .## ## ####..#  #####\##. .# #.##.#
#     .     .  . .   ## ##       # # # ##.# .    # # .#  #  #
# ##.# ##########.#.#. . .## ###.#   .  #. #### #### # # .#.#
# #.# .  .. .  .# ## # #.# ### # #### ##.# #     #.  # # #  #
#.#. # # #.#####   =..##    .  ..    . ..  #.# # # ### # # ##
#.#.##.#.# #. ..#.## #  #.#.## #.# ###.# # .## # # #..  ....#
#.#.#  #. # # # #   ##.# #  #.#   # .#..# # # #  # # ### ##.#
##   .#.#   # #.###    # #.# .  #.## # #  #.. ## ## ##.# #. #
# .##  . # #. #.   .# #..# #.## #..   ### ####.#.     . # # #
##=  # # #..# # # #. # # #  #.#.# #### #    .  # ## ## #    #
##.#.# .#.## # #..# #  . #.# . .#  . .   #### #...#.#. #### #
# .##.## . .. . ##. #.###.#.##### ## ##.#..  # # #. # #   # #
##      .##.# #=  #    .     .. ..  #  ## ## #.#  ###  .##  #
# ##.## #..#   ## # ###### # ##.# # .# #  .###.# # . ## #.###
#  #..#. # .## #  # .    #.#.# ### ##  .# #. ..#.# ##    =  #
#.## #. # .#. #.#### # # # # .. #..=.#.#.   ##.# # #.#.#.## #
#.#  ###.# .#.# #.# #. ## . ## #  ## o  # ### ## #.# .#. # .#
#. # .   # #   ...    #   ##..# #.# ## #  #   . . . #  # ##.#
# ## #####.# ##.##.##### #  #.# # # # . #.# #######.#.## .# #
# .    . . #.#...#   .#.## ## #.#    # ## # #.  . #.# #  # ##
###.### # #.# # #.####. .  #. . # ## #. . #. #### # #.  #  .#
#.#.# # ### #  ##  ..# ### .#.#    .#..###.# .. . #..## .## #
#...#.   . ..#  . ##  # .  ###.## ##.# ..  ..##.# # #...#   #
# # # # ###.# .# ## .#. ##  #   #     ### ##..### #  ## # # #
# # #.#   #..#  #  #.## #  ## #. ####. . #. #    # .#.   ##.#
## .# # ##### #  #      .#    # #    #### #. # ### #.## # . #
### # #  .#.. .#  #.# # #  ###.#  ## . ... #  #  ...  .# # ##
##. # #### .## .## .##   #  .   # #.####.#   #  ##.# #.  . ##
#.#.#.    #..# #   #. .#  ##.#.#. #..   #  # # #. # ## ###  #
#   ## ##. #.# #.##.# # # ## .#.#   ###.# # #. ..#  . .. #.##
## # #  #.#. # ## # .#.  #  #.# #.##.. . #.  ##=## ## # # # #
#  #  .#.##.## .  .#.##.#.# # # # # # #.#.#.# # # .#.## #  .#
#.#.# #.      ##.#..   .. ..#  o= . .## #   .   #.#. .. . #.#
#  .#.#.## # # #  #.# ## ###  # ####.#  #o## ## #.#.###.##.##
# ##.##  #.#.# # ## ## ### ##.#.#  # ##.# #.#  #..# #.. ..  #
# # .. .# .## .#.# #.    . .. .## ## ..#.## #.## #.## ### # #
## .#.#o## . # #  .#.#.###.# #..  . # #      . .   #  # ## .#
#.##.#...# ### #.# #  # . ## #.#.# # #.#.# #.###.#. # #  #.##
#  .  #.#.#   .# ### #..##.. #.##.##      # .. #  # # #.# # #
## ##  .  #.# #.    .## .  ## .....  # ##.## ### # #..%  . .#
#..#.### ##.#.### # # # # #  # ## ####  #   #..  #..#.### # #
## #.# #.  .##     #.    ## ## # .# .. #  # # ### # # # # # #
#....   ## #. .## #  ## # ..    #..#.#  #  #.  .    # #  .# #
#############################################################
