#########################
##.#.#.#.# ##.#.#.##...##
#....................#o.#
####.#.########.#.##...##
#....#....... #.#.#..#..#
#.####.#.#.#.##  =.#.. ##
# .....# #.#.#..#.#.###.#
###.##.#.#.#..#.#.......#
#.#..#.###.#.# # ########
#. #.#........... ......#
#.##.#.#.#.#.#.##.#.###.#
#....#..#.#.#...##..#...#
#.####o##o#...#...#.#.# #
#. ...\#..#.#.#.###.# #.#
#.#.##..# #.#...#=..#.#.#
## #.#.#..#.#.#...##..#.#
# .....##.#.#.####.#.#.##
######............... ..#
#.. ...##.#.##.#.####.#.#
##.###.#.##.#..#o#...##.#
##...#.#.. .#.#..# #.# ##
#..#....#.# #..#.###...=#
##...#.##.### #......#.##
#.%#.#.#..=.=..#.#.##...#
#########################
