##################################
#   .   .# # #.## # # # # # # ## #
#### ###            ..       .   #
#. #. =# ## ###.###########.# ##.#
# ## # # # .  # #\ .   .  .# #   #
# # # ##.## ##  # # ## # # # # # #
#    . .  #   #.## ## #.## # ##=##
## ### ##  ## #.  .     ..    . .#
#.   #.#  # .#.##.##o# ##.## ## ##
##.#.#  # #.#  # #  # # # # #  . #
#  # #.#     # #.# #      # # # ##
##.##.#.# # # .#  . ###%# #.# ## #
##  ..  # #..# ### ## ## ##.# o  #
# #.## #  # #o         . .   =## #
#.## #  # #. ################..# #
#  o ..#  # #=     .        . #  #
##################################
