##########################################
#.# #      # ###.#.#.#=..#.# # .  ..# ## #
#.#.#.## # # .#. ..#.# # #.#.# ### #  .. #
# #.#.. #  # ## ####.# ##.   .. .# \ ## ##
#.# #.#.## #.%.   . ...   #######.##. ## #
# . ##  .# # ###.## ##.## #.  .  . ..#.# #
#.#  .#.#..#  .# .#.# #.#.#.## ###.#=..  #
##  # #. # # # #.#.#..   .###  #  ##.#####
# .### .#.  # #.#..# #.###   ###.#   ... #
#.#.# # .# #..   .#...#... ##.. .# ##.##.#
#. .  #.#..#.#.## ##.##.### #.## #.# ##.##
##.##.#. #. # # . ... . . .  .#.. .#. .  #
# # #...#..##o#.####### # ###.# # ## ##.##
# . .## ##    # #. .   # #   .#.#.#  .#..#
## #  #...### ..# # ##... ###  ##  #.#  ##
# #  #.# #.. # #   #.#o##   ..##  ##  # ##
#  #.. # # #### # #. #.  ## # # #.#. #...#
##.#.# . .   #. # ##.#.## # #...#.#.#.#.##
#  ## ## ##.#  ##  .. .   ..#.#.#.# #.. .#
## .. .# #   #. .### # #.#.## # # #..##.##
## ## #  #.# #.##..  # # # # .# #.# #. . #
#. .### #.  # .# .###.. #..#.#..# #   #.##
# #.   .# ## #. # .. ##  #.#.# #... #.. .#
#.# # ## #.  . #. # #.#.#. # #.##.####.#.#
## .#  #.  ###. #. #..#. ##.#     # # ## #
# ##.## #### # # ##.#...# #.##### #  ....#
#... ...   .   . ... ##..   .. ..#. #### #
# #.## ###### ## #.# # # ##.## #  # #  # #
# .# ###.  ..## #  #.# #. # #.# # # ..#. #
#.#.. ..#.##  .  #.###.###  #...#  ###.# #
#  #.##.#.  #.## #....   .#..##.#.#  . . #
#.#    # .#.#.#.#.#.# #.# #.#.... # ######
#.## ##.##.# .  ..# # #.# # .#.## .. ... #
#  . . ..=. #.##### # #.#.# #.###.###.## #
####.######.#.  ...   #o.## #  #   .  ...#
#. ...... .  ##.## #.##.#  .#.##.##.#.##.#
### #.## ####..#  #.#   # #.#.. .#. # = ##
#.#  ### .  .#.#.## ### ### #### # #..##.#
#.#.#.#.##.## o.  .  . . .. ...#.# ## ...#
#.   ..  ##.##.### ### #######. . ..#.####
#.# #.# # . ..   .# .   ..   # ## #.# . .#
##########################################
