################################################################################################################################################
#. # .  .     #.=     # #.       ..     # ##    #        ..  .         .  # #.# ## ## ##.# ## ## ##.## ## # # # .  .=      .       ##    # ## ##
##   # ## ###  ##### ## # # # ## # # #.#   ..## # # # ## # #### ## ## # #      .             .    .   .         # # # ## ## #### #    ##.     .#
# =#   .    . #  ..     . .  .   ##   # # ##              .#        .    .# # ## # ### ## # # # # # ##.# # # ##              .   # ## ## # ## ##
##   # ## ###. # ### # ## # # ## .# #        ## # # # ## # ##.# ## # # ## # # # ## #   # #    #     ##  .  #  # # # # # # ## ### ..# . . #.##  #
#  #.      .. #.      .     .  . #. # #.# ##      ..     # .    =       ..  .  .  .  #    # #  # ##    #.# # ## #   #   # .#     #  # ##      ##
## . # ## # # ##### # #.# # # # # #.# # # ## ## # # # ##.## # ##### ##### ## ## ## ## ##.# ## ## ## ## .    . .=### # # . #  # # #.#  ...#.##. #
## # #  #.#.  .  .  .                          . .        . .    =                .   .  .     ..      # # # ##     #   #  # # . # ## ## #=# ###
#      # .# # ## # # ## # # # ### ###.#.# ## ## # # ## ## # # # # #.#.# ## # ### # # ##.## ## #.#.##.#   #.#.   # #. # # # # . # .    .  #     #
# # ##  # #     .   ..  .  .          .  . # ## # # ## ##.# # #   .        .            #     # ### #. #     ## #   #      . #.  # ## # #  # # #
#      ##   # ### ##.### # ## ## ## ## #.# #    .    .  . . . .# ## # ## ## # ## # # ##   #.#.  .    #.# # # #  ### ..## # #   #   # .#.## # #.#
# ## # #  # #.   .                       # ..# # # # ##.## # # #                 ... .. #.# # #.## # # .   .  #   . # # #  # #   #. # #    .   #
#    #  #  . .# ###.# # ## # # # ## # ##.  #.# ## #.# ## #   # ..## ## #.# # #.# # ## #.#.. # .   .  # # # ## # #.#  =    #   ##   #  # ## # # #
# ## # ## #.#     #.     #   # #. .     .#    .         .  #   # # ## ## # #.# #.# #.# ## # # # #### #    . .  .#  .# # # ## #   # ##      .   #
#.##   #  #   ## # #=# # ### #.  # ## ## # #.# ## # # ## # # #                                         ## # # # . #       .# # #      # ## # # #
#    #..#   #        .     .   #         #   # # # # ##.##.#.  # # # #.# # #.#.# ## # ## ## # # ## # #.#      # #=# ## ## #  # # ## #    #   # #
# # #  #  #.# # # # ##.#.# # # # ## # #.## #       .  ..   #.#   ##.# # #.# ## ## # # # # ##.# # ## #   # #.# #..   #.# # ##     ##.# # ## # # #
#    #. #.   .       #   #     ..#   .#      # # # ## # # ##   #         . . ..   .       .          # #  . . # #.#  .       #.#       =     # #
# #### # #### #### # # # # ## ## # # #.# # # # # ## #.### # # ## ## ### #.# ## ### ##### ## # # ## # #  # # # # # # ## ### # # . ## # ## # # . #
#.         .     ..  . .    . .        .  .     .  . ..              .  .             .   .            #  #.# #.        .      #    .    .   # #
# ### # ## # # ## # ### # ###.##.# ## ## #.# # ## # ## # ## # # ###=#.# # ## # # # # #### # ### # #### # ## ### # # # # ##.# #  .## # ## #.# # #
#=# #.#             .     .      . #    .  .                    .             .      # ..      .   .       ....    .       . #.# #. #  # # # # #
#  .#  #.# # # ## #o## # ## # ## # # # ##.### # ## ## # # ## ## # # ## ## ## # # # # # # ### ## # ##.# ## # # # ## ## # ##%#  ..  #  .## .   . #
#.# . #..    # ##.#.# ## #                      .        .                =.   .     .        .        # # #   .#.# ## ## # .# # #  #.#  # #.# #
#. .# # ## #  .    .       ##.##.# ## # # # # # # ## # ## # ### # ## ## ##.# # # # ## ## # # # ###.### # .. # # ..         #     .#..  # #     #
# #.#  .     # ## # ## # # .     ### ##      .  .   .#     .      .    .. #  # #    #    ..     ..  .    # ##.  # # ## # # #.# # ## # ##   # #.#
#.#   # # ##. .     ## #.# ## ##       .# # # ##.# #   # # ## ## ####.# # # ##   ## #.## ##.## # # # # #.#.   # ## # # # # # ### #  # #  # #. .#
#  .#  .     #.#.##          . # # ## # #.# # ## # ..# #  .  .       .      .  #.   #    .   #=  # #   #   # #  .....             # # ##.# # # #
# # # #### #        # ## # ## #      .#  ..    .   #.=   # ## ## # # # # #.# #  #.#  # # ## #  # # #.#   # # ## # # #.## # # # # #       .     #
#     .   .. #.## # ## #    #  # #.##  .#.# # # # ## # ## #.# ## ## ## ### ### ## # # # ## # #       . # # #      ## # . ## # .#  # # # ## # # #
# # # # #### # # #.  .   ##.#.## # .  #         #    #   ..  .             .  .        .       # #.# # # #   ## #    . #    . #  # # ## #   .. #
# .     # .  \    # # ##    #   .## # # #.# ## #. ##   # # # ## ### ## # #### # ## # ## # # ##  # ##       #.     ## # # # ##  #         # # # #
# # # # # ## ## ## #.#.# ## # ## .     .#   ## ##.## # ## #   .   .  #.# #          # # # ..   #    .#.#.# #.## #    .   # #. ## # ## # ##   # #
#    .#. ..        .      .  .   ##.# #   #  ..         . . #.##.## #. .  # # ## ## .     #.##  .# #.  # #      #.## # #  ..#    # # ## #  #  .#
# # #.#### # ## ## # #.# # # # # # # # ## ## ### ### # ##.# #.## ## # ## # ## # #.# # ### # #.# ##.# #  .#.#.## #    # # # ## ##         # # # #
#       .  .    .  . .           .  .   .    .           =              ..  .     .                .  .# # #.   # ##.#  .    ..# ## # # #  #   #
# ## ## ## # # ### # # ## # ## # ## # # # # ##.## ### ## # ## # #.# ### ## # # # # ## # # # # #.## # # #   #.## #.  .  # # ## #   ##  #  # #.# #
# # # # # # ..#    # # # # #=# # # # #.#.## # # ##.  .     .  # #.      # # .# ##.       .     # # # .   # ## #  # # #.  # #   # #   ## ## # # #
#        .  #. # # .   .                    .    # ## # ## ##=.  =# ### #   #   . # ## # # ##.#  .   # #   .   .#  #   # #  # #   .#.#     # # #
#.## # ## ### #    # # # # #### # ## # ##.#.##.#  ..          # # .     # #   # # # #  # # .# # # # ##   #.# ##  # # # # # ## ##.#    # ##   # #
# # .# .      # ## #  # #     ##    # #   # #.## # ## # # # # # # ## ## #   # #   #  #   #.#           #   .  # #   .             ##.#   # # # #
#. #  # # #.#   ##  #..  # ##    # #    #   .   .#. ..        ..    .     #     #   #  # # .#.# # # ## # # #.#.  # # # # # ## ## #.# # #       #
# ##=#.# # #  #    #  # #.    ## #.## #  .## ## #  ## # # ## ## # #.## ## # # #   # ## #   # # # # ##       ..# ##  .  # # ##.     .     # ## ##
#         . # ##.# ## #  # ##         # #.# # #  #..             .        .     #.    .. #           #.## ## #     # #.  ..   ## # # ## ## # # #
# ###.### # #       #  .#   # ##.# ##..  .     .#  ## # #.###.# # # ## ## # # ### # ##.#   ##.# # #### #   ...# ## #   # # ##  # #  . .        #
# .           ## # ## #=## ## ## # #.## # # # # ##.   #  #  # # #       #   # .   # ##   #       ...   .# ## ##      # #   ## # . # ## # #.#.# #
# # #.## # ## ##=                  .. ..      .    # #  #  #    #.## ## ###  #.##.     #   ## ##.## ##.#.    .  ## #   # #..  .# ## #   .  .   #
#   #    #.#   . #.## # ## ##.## ##.## # ## # ##.#  .#.# # ## #           #.#   . # #.# ## #. ## #    .## ## ##    . #o  . ## # .    # #.# # # #
#.# . ##    # ## #.#      . . ..     .  . ..    . .#            # # # ## # .# # #.  . .     # .    # # .#. #    # ## # # ## # ## ## ## #   #.# #
# ## # # # ##        ### ###### # ###.# ### ## # #.# # ### # # ## .    # ##     . # ### ## #  ##.#   # #  # .## ## # # #   .  .   .     .#   . #
#     .       ## # # #   .     .  #   #.    #     ..   .        . #.# #  .. ## ## #      # ## # .# #    # ##.# . .       ## # ## # # # # . ##.##
### # # ## ##        # ## # ## ## # # # # # # # ## # # ## ##### # # #  # ## # # # ## # #    =  #     # ##.    # # # # ## #.#   # ##.#.## #    .#
#.  #         ## # #            .         #.# .                     # ##. #    ..    .  .# # ## ## #   #.## #       ## # #  #.#   . .    . ## ##
# #   # ## ## ## #   ## ## ## # # ## ## # . # ##.# ##.# # # ## ## #      # .## ## # #.# #     .      #        # # #        #   # ## #.# ##     #
# =.#       #  .   #  .          . ..   #.#    =.#   #.   . # # #.## ## # #     # #   # ##.# # # ## #  ###### #.## # ### # #.# # # # ## ## ## ##
# #.# # ## #  ## #  .## ## # # ## ## ## # #.# ##   #  # ###.           .  #.## #  # #    # # # #.   ##     .      .  .                         #
#      . #  #      ##.#.## # ## #              . #   #      ## ## # ###.#       #    .# #        ##    #.# ### ## ## # #.###.#.# ## ### ## ##.##
#.# # ## # #..# ##  .        . .# ## ##.# # ## #   #  #=## #.# #      = # # ## #  # # #  # ##=##.#  ##  .#    .       . .                      #
# # #  #.#  #  . # ## #.# # # #    #    # #  # # #   #   .      # #.#.#   #  #  # # # # ## # #    #.#. # # # # ## # ## ### #.## # # ##.# ## # ##
# # ## # # ## # #  .. #.  .   ..# # .##     #  .   #  # # ###.# #       ##  #  #   .           # #   #   # ##  .       #   ##     . # #    .   #
#             .#.# ## # # # # ### # # # # ## ## ## #.# ## # ## # # #.# ##.# ## # # ##.####.## # # # ## # .   # # # # # . #  ..# # # #  .## ## ##
#.# ## ## # # # .     .  .           ..          .                .     .          .  .   . . .       =# ##.## #.#   # # # ## #.#.# #.# .     ##
# #.   # .# #  .## # ## ### # ## # # # # # ## # ## ## ## ## #.### # ## ## ## # # ## ## ## ###.## # # # #.   #. . # #            =      =## ##. #
#   ##  #     #  .   ## # # # ## ## #.# # # # # # ## # # # ##=# ##.## ##  .       .       # ## ## ##     ##  # #     # # # ## # ### #.#.## .# ##
# # ## ## #.# # ## #  .        . . .  .               .   . .            # # ## #.## ## # . .    .   # #    ## ### #     #  #.    . ..   . # . #
#        .           # # #.## # # # #.# # # #.# # # # ### # #=# #.#.## # #     ..         #.## ## ##   #.## #        # # . #  # #.# ### ## ## ##
#.# # # ####.# # # # #.# # ## ## # ## # # ## ## # # # # # # ### # # # ## # # # ### # ## # ## #.# # # #    # ## #.# # #   #  #.# #. .   . .  #. #
#     # #      #            .    .   .        ..    .    .  =      .      . ..     .            .     .# #   #   #     #   #.  .# # ### # #  .##
# # #     ## #   # # ## ## ## ###.# ### ## # # # ##### ## ## #### # #### ## # # ## #.## ### # # ## # #   ## #  # # # #   #  # #   # # ..# # #. #
# # .# ##.#    #   #         # .# #.#.   . .     .             .  .  .     .  . ## # # ## # # #.# .    #  #  #.. . # # #.# # # # #  # # . #   ##
# # # # #  # #.. #.. # # # #  #. . . # ##.## # # ### ### # #.##=# # # # # # # # .   .    . .    . ## # . ## ## #.#    ..    .     #  # ## # #  #
#   .     # .  #.. #   # #   # .# # # # # # ##  ...      .  .# ##   # # # # # # ##.##.#.###.## #.#.#  .#           ## ## ## ## ## # #         ##
# # ## ## # ##   #  .#   # #.## #         .    # ## #=## # # .  . #  .     .                      .  #   # # # # # # .# # ## .. #  .#.#.# # #  #
#      .     . #   #.# ## #    = .# ## # # # # #  # # # ##.#.# ##   #.## ## #.# ##.## ## ## ### # ## # # .. .  # .  #  .. .  # #  #         # ##
# #.# # # #.# #  # .  .   .# ##.# #         .    #     .     #    #    .  . ## #. .# #    #.#. .# ##   . # # # # # ## # ##.## # # #.### # # # ##
#.# #.  . ## # #  .## # # #     #   ## # # # # #   ## # ## #   ##   ## ## #      #   . # #  # #      # # # # #.   ..     . .   . .        ..   #
# . . # #  .   # # #    .  # ##   # #.## #.## ## #.## # ##.# #    #   ..  # # ##   # #   ##=#   ## # # . .     ### # ## # # # # # # ## # ### # #
# # #     # ## #     # # # # ##.# #.        .    #.   .   .#   ##   ## # #    ## #  .# #   .  # .    # ## #### # # ## ## ## ## # # ## ## # ### #
# . . # #      # # # .     ..       # #.# # # ## #.### #.# # # ## #  #.#  # #  .   ### # ## # # # ## #. .  .             .     .     .         #
# # # ### ##.#      # # # #.## ## # #       .       . .     .    .## #.# ## # ## # .      =.           ## ## # ## ### # ### # #.# ## # # ### #.#
#.#       .    # # #    ..# #  .      # # # # ## ### # #.# #.## # .      . .. .  # # ### ## ## ## ## #.    # #. ##        #   .        #.     .#
#   #.### # ##      # # #    # ## # # ## # # # ##   #  # #   #  # ## #.## # ## #.#.#    # # #  # # # . #.# # ## .  ## # #   ## ## #.# #  # # ###
#.#   # #.     # #.#    ..# #  #. # #.            #   #   .#  # . # # #     # #  # .# #      #  =    #.. #   .  ##    # # # ## ## # ##.# # # # #
#   # # # ## #   #  # # # #. #. #     # # #####.#.# # ## #.## # #     . # # #  #   #  ..# # #. ## ##   #   # ## ##.## #     .                  #
# # # .   # # ##   #   .   # # ## # #   .   . .             . .  .#=### #     #= # ## # #.# ## ## #.## #.# # .     #. # #.# ###### # ###.#.# # #
#.   =# #       .# .# # # #       # . # # # # ## ## # ## # # # ##.# # #  .# # ##  . =   .   .     .. .    .# ## ##  #     . ..        .      # #
# # # # ## ## # ##.## # # # ## ## ..# #.# # # ..  #.## # # #.## # .     #  . .   # ## #### ## # ##.### # #.# # # # #  # ## #### ## # ## ## #   #
# #.   ..          .   .   .   .  #           # # #         .     # # #. # ## ## #  . . .   ..         .   #        # . ..               .  .#.#
#   ###### ## # ### ### ##.# # #### # ####.# ## # ### ## ##### # # # ## ## ## ## ## ## ##### ## ###.## # #.# ### # # ## # ### ## # # ### ##.# ##
# # #   ..     ..     .. .      .   .             .  ...         .        .    =       . .  ..  .   .   .      .       .                   . ..#
#     ##=## # # # # # # # #.### ### # #.## ##.# ###.# #### #### ## ## ## # # ### # ##.# ## ### ### # # # ##### #### # ##.## # # # ###.## ### # #
# ## # # # # # # #.# ## # # # # # #   #       # # . .      # .  #     .  .=.          . ..       .      .           .       .   .        #    .#
#        .             ..      . .  #  # #.# #    # # ####   ## . # # ## #.# ### #.# ###### #.## # ###### ## ## ### # ## ## ## # #.## ##   # # #
## # # # # ## # ##.## # # # #.# # #  .#  # .. #.# . #    # #  . #.  .   . .   .  .  .     .      .      .  #     . .      #   #.# # # ## # # # #
## ## # # ## ## # # # # #.# # . # # ## # # ###.# ####.## #.## # ## ## # # # ######.# ## ## ### # ## ###.## # ###### ## # #..#           .      #
#       .                    .#                       ..               .    .  .     .   .       .   .  .      .     .  . # # #.# # # # #.# ## #
# ### # # # #.## ## # ## ## # . ##.#### ## # # # ##.## ###.#.## # # # # # # #.#.### ### # ## # ## # # # ## ### # ### ## # # # ## ## ##.# # ## ##
#     # # # #.#   #  .        # #  .  #    . .               # ## # # #.# #  # #  .    . .  # # # #.##   # #   # # .  #  . ...    .            #
# ##.## # .    .#   ## #.##.#     ### ## # # # #### ## # # #              # #   .# # # ## #            #.#  ##    # #   #.# # ## ##.###### # # #
# #   . .#.## #  ## #.   ##   # #         .              .   ## ## # ## # #  # # # # #  #  #.## #.## #.#  # ## ## # #.#  .#          .    . .  #
#  # ## #       #   .# #    # #..# ## ## # ## # # # # ## # # ##    # ## #  .#       . #.  ##  #.#.##.# #.#   ..  =      #.  ## # ## # # # ## ###
#.#      # ##=#   # #  #.##   # ## ## # ##   .           . #   # # # . .  #.# ##.## # # # .  # .  =  .    # # # ##.# ##.  #.           .# .    #
#   # # # # # # ## # #  .# ## #.# .  . .   # # ## # #.## # # # # #   ## #         .    .. # # # # # ## # # .## # # #  # # # # # # # # #   # ## #
# # . #       .      #.#      # # # ##.### # # ## ## # # # #     #=#.##.  # ## ## ##.# ## .     #    .  . #       . .#   .   .        # # #  # #
# # #.  #.## ### ## #. # ## #     .                          # #     .  # #   # ## #=#    #.# #   # #### ## ##.# # # ### ## ## ##.# #   .   #  #
# ### # # ## # ## # ## # # # .# #.## # # # # # # ## # # ## # # # # # ## # # #  .  .    ## ..  # #      .          .  .  .  .#.#.# # # #.# # ## #
#.           o        .   . #  =.        . . #  .. # .  .#     .  .           # ## # # .# #.#.   # ## # ## # # # # #.# #.##      .   =.   .    #
# ##.# ####.# # # #### # # ## # ## ## # ## #   # #  # # #  # # ## ## ## # # # # # ##.# # =    # ##       .#  # ## ##.# #    # ## ## ## #.##.## #
#          . .             .  . #  #       # # # # ##   ##.   ...     # # #.#          ## # #   #. ## ## #. #         ## ##    # ##  #   .     #
# # # # #### ##.# # # # ## ## #  #  # # ##   .        #   .# ##.# ##.# .# #  # # ## ## .    # # ##     #. #   ## # # #    . ##   .  #  #.# #.# #
# # .= . ..         .     ..  ..## ## #  # #.## # #.# ## #.  #      . # #   # # # ## # ##.#.     # # #   #  # #  #   ## # # #  # ##  #.#.##.## #
#   #.# ## # # ## ##=## ## ## # .    .  ## # .. .       . .# #.# # # #    #.=   .  ..     # # # #  # ###. # # ## # #. # #.#  #      ##.# .     #
# ## ## ## # ## # ## #.#.  ##   # # # #..    #.## ### # ## #    # ## ## #.  #.## # # # ## # #   ## #    .#       .   ##.#.# ## ####.     ## ## #
#  .       .   .  .  ..  #.   #.#   #   ## # .               # #..        #.# .  # # .     .  #  . # #.#  # # # ## #   .    .   .   ## # #  ## #
# # # #.# # ## ## ## ## ## ##    ##.# # ## #### #### ##.## #.## # ### # ### # # ## # # ## # #.  ##.   #  ## # ##   . # # ##.## # ## .   ..#  . #
#   .             .=  .    #  # #        =       . .. .                .   .        .     #  .#   .##  # #. #    # #.#.#.## #   .   ## # #  ## #
# #.### ## ## # # ### # ## .# .  .## # #### ### ## # # ## ### # # # # # ## #.# #.# # ## # #.#   ## # .#   #   # ## # .     . # # ## #     #.   #
#. ..   .   .       . .    ## # ## #  .  .=#=   . .             .   ...  . # # #     .  #.  # # #   #.## #  # #    # #.# ## #  # #   #.# #  ## #
# # ## # ## # ## ## ### ##.   # ..   # # #   ## # ## # # # # #.### # # #.#       #.## #   # .    #.##..   # # ## # # #   #   #    # #  #  # #. #
#=  .            .         ##   ## #.# # # # # .  # ##           #.## ##. .# # #        # # ### #.    ## ##      #     #  # #  ##  . #   ##. # #
#=# ####### # ## ## # #.## #  #     . . .  #  # #   .= # # # # #  ..     #.    # ### #.##        # ##  #    # # ## # #= .#  ## # ##.#  # #  #..#
#.#.    .    .  .          ## # # ## #.# # #.## #.## #         # # # # #   # #.           # # # ## #  #  ##.#          #  #          # #  # ## #
# ####.## # ## # # ### # #         # #  .#     .# .  # # # #.#.# # # # # # #  # #.##.## #     # .   # ##.# .# # #.## #.# #. ## # ## ## ..#.. # #
#        .#             .  ##.# ## #   #   # ## # # ## #   #   .  .        # #.## # ## ## # #.# ## #  .   #     .    #    #    .      .#  # #. #
#.# ## ## # ## # # ### # #  # #=  .  # ..#        .      # . #.# # # # # #  .  .          = ..   # # # # ## # # #.##.## #.  ## ## # ## #.#   # #
#       .   .        . .   #  # ##.# # # #.# ## ## # #.# # # ##.#.#.# # ## # # # ## ## ## # # #.#           . .         . #         #    # # #.#
# # ## # ##.# # # # # # ##  # #.    .   .        ..   ..          .     .              . .  # # ## ## ## ## # ## ###### #   # # ###.# ##   ..  #
#    .   #  # ## # ## ## # ##  .## # ## ## #.## # ## # ## # ## ## #.##.## ## # # # #.# ## # # . .#  .      .       . . .  # #  .#.. ##   # # # #
# # ##.#  # #        . .  .#  #. # # # # # # # ## # # #   # #  #.# # ## # ##  .   #.## #      # # .### # # ## ## ######.#.  . # # #    # # # # #
#      # #    # # # # ## #  #.# #            .     .    #    #  .            # ##       #.#.# #  # .                      # #     # ##     .  .#
# # ##.   # # # #     #. # # .. # ## #.# # # # ## # #.#   ## #o# ## ## # ###.# ## # ## ## # #   #  # ### ## # ### # ## ##.    # # .    # # # #.#
#.     #.#       .# #. # #  # # # #.         .  .   .  ##         . .    ..  .      .    .#.# #  # # #.  #.# #            # # # # # # #.  .# # #
# # #### ## ## # #.## ##.# #  #    # ## # #.# ### # ##   .## # ### #.# # ## ## # # # ##.#.#.    ##     #      # # ## # ## # #.      .  # #     #
#  .     . .      .         # # # #  . ##    . .. #  . ## . .  #.# ## ## ##.       # ##.  #.# # #  #.# # # # #.## ##.#  . #  # #.## # #  . # #.#
# #.## # ## # # # #.## # # ## # .  #.#    # # # # = ## #  # ##           .  # #.# #     # # #    # . #..        .    # #### #.   #     # #.  #.#
#   ## ##.# # # #    .          # # .#.## # #    .#     # # ## ### #### # # # #.# #.### # . # # ## #   # ##### ##.## #    .  # #  # # ## # # # #
# #           #   # ## # # ## # # ## #.   # # # # # ## #  #. ..    .    .    .  .      . .#.# # .  # # # #. .    .     ## # ## # ## #  ..# #   #
#   ## ## # # # #      #.# #  # #  # # ##=#. .         ## . # ## # # #.## # # ## ## #.# # #     ##   .     # #.## # ##         . #    ## # # # #
# # . .#   .  #   # ##    .##   # ## # ## # # ## ## ##. # ## #.#.# # #.##.## #.# # # ## .  .### # ## ##.## # ## # ## #.## # #.# #.# # ##       #
#  # # .# # #   ### # .# #.   # #           . .       .#  .   .    .      .  . .  .     # #    .          . .          . .               # #.# #
# # ## #  #.###   .  #. .  ## #.  ## # ## ## # # ## ## ## ## ### # ## ## # # ### # # ###    # ## # # ### # ## # # #.### ### # ###=# ## #     . #
#.#    ## #.  # #.# #  ###.## # #. #                .              .         . .        # #          # # #  # #   #        ....     ## ..# #.# #
# # ##      #       .#  .     =  .#  ## ## # # # # # ## # # # # # #.## ## #.#.## # # # #    # ## # # .   . #.   #  # ## # # # # # # .  #       #
################################################################################################################################################
