############################
# # # # #.#=# #  #..   ##.##
#.#.#.# # # # .#  ##.#  o  #
# ..# # #.# #.## #.###.#####
###   o  .o =   ...  . .  .#
#  .## ## #.###.# ## #.# ###
### #.#  #  #. # #.### # # #
#.= # ## ##. #.#.#.... # #.#
### # o  .####.# #######.# #
#.# .#.# # . . .  ... .  # #
#.#.#. # #.# #.# ## # ##.  #
# #.####.## # #   ###  # # #
#    .    =% \.#.#    # .# #
############################
