########################################
# # ##.##.#. # #   ## # . .#. #  ## #.##
#  o. ..   # .  .#  ..#.## ##  # .. . .#
#.#####.# #  ##### ##.# .  .. # .##.##.#
# #    # . # # . . # ##.#####. #  # . .#
#.## #.# ##o.#####. ... #   . #. #  ## #
# ... .....#. ..  .#.## #####\###.#.#.##
# # # #.## # ## #.#. # .   .. .    .. %#
# # ## . #.#.# # # ### ######.# #.#.##.#
#.#  .# #. # ...  . ..        #.### # ##
# # ##   #.#=# # ##.##.###.# # .. . o  #
# #.###.#. ..# # #. .#.#.    ##.###.##.#
#.## #.# ##### #. # # .#.#.## #.#.# #.##
# ..  .  .   . #.# #.# # # #..#. .# .  #
# # #### #####.#... .# # #. # #.#o# #.##
# # # =.#   ... ### #  # #.# .#...#...##
# #..##.######.#. .==#.#. ..#=#####.##.#
# #.# .. ... . # ##.# .. # # . =  . ...#
#. .#.#.# ## #.#.. . # #..  #.# # #.#.##
########################################
