############################################
#.    #  . ..#.  . .   # # # # #  # . # #. #
##### ######=######### # #.# #  # # ##..#.##
#.. . . .    .    .  ..    #.. # =    #.#. #
##.### #.# # ###.## ##.#.#. ##  # #### .#.##
#  #  #.#.## # #  #  ## ## # # #  . ..# #.##
##  # #      #.#.# .#  ..  # # ## # #.#o   #
##.#  # # ## # #..#. # #.# #      .# ##.## #
# .##.## # ###.### .# #..#. # ###.#     #..#
##.   .. \. .  . .# #. # # #..#   #.# #  # #
# .## # #.# ## ## #.# #  #.### ## ## ##.#.##
##  # # # ## # #. # # .#.#..        .. ....#
## ###.# #.# ## ## ## # ## #################
#..###    . . .   .  ..   .. .  o  ..   .  #
##  #.# ### #### # ###.# ### # # #### #.# ##
# .#  # #   # . #.# .  # #  #.# #  ..# # # #
##  # # # #.### #  ###.# #.#. #  ###.#.  # #
#. #  ## #      #.#    # # .# # # .. #.#.#.#
## ##    .#.#.# #.#.## # #.#  # #### ### #.#
# ..#.## #. # #.# #  # #.#  # #         .  #
##.#. # #.#.##.## ### #  #.#..# # ######.###
#..##.# # #.. .  .     # # ## #.# #    #.. #
##  # # # # #.# # # # #  # .  # #..# # #.#.#
#..##.# .    #.#.#.# # # #.####.#=## ## .# #
##.#  # # # # .  .  ..   # #..  #   .  # # #
#  ## #.# # # #.# ##.#.# # #### #######.# ##
##  # # ##  #  # # # ##. #.  .  .  . .     #
## #. #.  #.# #. # #.  # # #### ## ## ##=# #
# . # # #.#.#..# # # # # # #   #.# #..#. # #
## # .# ##..#.## # ## # .# # #.  # .#% #.# #
## .# #. .# #.       .o# #. ## ### # .## #.#
#  #  #.##  #.#### #.#.# # #        # #. #.#
## =# # #.#.# #   .## # .#.# ##.##.#. ## # #
#..#. #   # #..#.# ..  #.#  ##.#.# ##. # #.#
## ## # #.# # #.## ## #  #.#  .     # #. # #
#. .# #.# # # #.     # #.# #########.#.## ##
##.# .# # #.#  #.#.###.#   ...  .   .  ..  #
#  .# # .##.#.# ## # . # #### ## # ## # #.##
##.#. #.#.. # # ...### #.#..###.##.#..# ## #
## ##.## ##.#.## #.  #.# # # .    . # #    #
# ...     # #..# # # # # #.#######.#  #.# ##
##.####.## .# ## #.### # .      o#  # # # .#
#  #. .  .# # # .# .   # # # # # # #. #.# ##
############################################
