############################################################################################################
# ..#..#.#.#. ...#...## #.#.# . ...   ..  ........#. ##.##..# #.....#.. ... ..#.#. .# . #.#.#..... ..##.## #
# ### #. ..#.#.# .# #       .# ##.##.#############. #.  ...#..#### ##.#########.### .#.#..#.########.....  #
#.. .. #.# #.#.# # ..#.##.##...#...# .... .... .  #.######.##. ..#.#.=... ........ .#  .#.#.... ...#.###.###
#####.#.##.##.##.##.#.#.#.# ##.####=###############. ....#..#.# #...## ########.###..# #..# #.##.##..#...#.#
# . . ......... ... ...  ... ... ....... ... ...... # # #. ##.##.# # #. ....   #..# # ..# #.##.###.#.#.#...#
##.### # ###.##### #### #.###.#.#.##.#.# #.####.###.# .#.#.# ...=. # ###########.# ..#.#. . ....  .. ##.####
# #..#..#..#.#....#..  #. #. # # ##.#.#.#.#....#. #  #. .# #.#.# # .. . ...  ... .# # ..#.#.## ##.##. ... .#
#.#.#.### ##.#.## .# # .#..#.#.#.. ...... .###..#.#.#..#.# .#.#.##.################.##.#.# ##.##.##..#.#.###
#...... . . ..#.# # ##.##.#..#. ##.# #### #....## #..# ### # ........... . ...  . .. ..#. ..  ...  #.##.# .#
####.####.## #....#.. . ...#.#=#. ##.. .#.#.##... #.#   . . ##.###.### #.#####.# #####.#.#.######.# ..#.##.#
#  # #.. #.#  ### .#########.#.##.#.#####.##.#.####..#####.# # #   # .#.. ...#.#.#...#.#. #  .  .# #.#.. ..#
## #..##.#.# # .#.#.. .   ..   . ..    ....     ....#  ....#.#.#.#. #..#.##.#..# #.# #.#.##.######.# .# ##.#
##.#.# #.# #.# #. .# ####.#.# ##.## ##.##.#.##.#.## #.##.#.# ..#.#.##.#.##.# #.#.###.#.#. .  . .. .#.#.#.#.#
#    #. .#.# #. # #.#...#. # ##.## #.###.# ## # #.#.#.# ##..## # #.#......... .#... .#.#.##########..#... .#
##.#.### # ..#.#. # #.# #.# ..... ...  ............ #.#....### #.#  ## #.#.# #.#.# #.#   ...   ... # #.###.#
#.##.=. . .#.#.##.#.###.#. ##.##.# ## #.##.## #.###.##.###..#.#.#.###.#.#.# # #.#.# ## ############# ###.#.#
#....######  #..#.#.....  #.##.##.# ## #.## ###.# #..... #.# ....... . .. .. ... =. ...#. .... . ........  #
#.##.#.....#.# #  ###.###.#............... . .. #.#.##### ..#.# #.###########.########.# ####### #.# ##.####
##.#. ##.#.#.# .#  .#.#.#..##.##.# #.##.#.# #.#...#.#... #.# .#..## ..  \...# ...=  .#.#.#..... #.#.. #.# .#
#....# # # #.# # .##..#.#.# ##.##.# ##.#.#.#.#.###..# ###.. # #.#.. ####### #.# #.##.# ## #####.#.##.#  ## #
#.## #.###.#.#. #. .# ..#  .. ... ..  ....  ......# # #..# #..# .##.... ..#.#.##.#.##.. ...  . ....# .#..#.#
#. # #.  ... # #..# #.## .# #####.# ########.#.####.#.#.## .# #.#...#######.# ..  .  #.#.##.#.######.#..## #
#.##.####### # .#.##... #..#    #.## .....  #.#.... # #.#  #..# .##.#   .. .# ## ## #..#.#.# .#. . .. # #. #
#.#.  .....#.#.#....#.#.# ##.####..#.########.##### # .. #..#.#.#.#.########..#.# ## #.#.#. #..#.# # #..##.#
##.#.######=.#.##.##..#.#.#  ... .#......  ..    .. #.##.#.##.#.# .......  .#.#.. ... .#.#.# ## # #. ##....#
# . .......#.# .#..##.# # #.# #.#.#.# ## #.#.# ##.#.#.#.#..# .# #.#.#.#.#.#.#.# ##.### # #.........#..# ####
#.## ######..#.##.#  .#.#.#..#.#...##.#...#.#. #.##.#.#..#.##.#.### ##.# #.#. # #  #.#.#.#.######## .##  . #
#.#... .o. #.#....###.#.# # #.  #.#.. ##.#.. #.#.#..# #.#...# #.   ..   ....# #  #.# #.#.# ..  ....#.# .##.#
# .#.###### ..# # ..#.#.#.#..#.##.#.# .#  #.##. ..#.#.# ##.#.#.############## ###.##.#.###.#########.#### ##
#.##..  ...#.#.## ##.# #.#.### #.# # ##.###.#.####. #....  ...... ....... ..   ....... ...... ..........  .#
#.# .#######..   .. ...  .   ....... . .   ... . .# .#.###.#.###.# ######.#.## ###.#.#####.## #.#.##.#######
#..#.#.  ..  #############.####.##### #.## ##.#.##..#.#. ..#.#..#.#......#.#. .#.# #.#. .. .#.#..# #  . ...#
#.## .###.##.#.. ..... ..  #..#.#....#.#..##.# .# #.# ####.#..#.# .####.##.=##.# ## # #### #..#.## # ### ###
# #..#... #. .#.# ########.##.#.#.##.#..#. .. #.#.# #.... .#.# .#.# . ..#  ### #.. ....... .# #.# .#.# #.#.#
# .#.#####.#.#.#  #  . .....# # # #..#.#..##.#..#.#.#.## # #..#.#..## #.##.##.. ######=#.#.#. ## #.#.#.#...#
# # . .  ..#..  #.########.#. # #. # #..# # #.# #. .# # #..#.##.#.#.#.#.  . .#.#.... #.#.#.##....# #.#.# ###
#..#.#### ## ####... ....#..#.# #.#..#.#. #.#.#..##.#.# .# #.#..#.#.#.#.#.#.# .#.####.#.# #.#.#.# .#.#.#.#.#
# #..#..###..# .  #######. #..#.##.#.#.##.#.. . #  .#.# #..#.## #.#.###.## # # .  ... ..... #.# .# #.# #.#.#
#..# #.#...# #### ..  ...# ## # . . ... # .#.##. ## #.#.## #..# ....... ...  # ######## ## #..# ## # #.#.#.#
#.#..#.#.#.#  ..# ## # ###..#.#.#########.#..#. #.#.# #.  .# #..#.# ##.## ### .#......  # #.#.# #..#.#.#.#.#
#..#.# #.##..#.#..#.##.#  .#..#.# .. ...  ##.##.  # #.#.## .# # ##.#.##.###.## ##########.#.# # .#.# # #=..#
#.#. # .. .#  #.# #.. .#.#.## #..#.#.#.## .#..#.#.#.#.# .#.#... .....  .... . . . .. . .....#.# #  # #.# ###
# ##.# ###.#.# .#.#.##.#.#. #.#.#.#.#  #..# ##.#.##.# #.## #.## # #####.######.######.######..#. #.#.#.. #.#
# .#.#.#.###..# # ### #.#..#  #.# # .# .#.#. ... ...#.#.#.. #. #.#.. ..#.....#.... .# .   ..# #.#..#.#.#.# #
#.## #.......#   ... ... #o.#.# #.#.# .# ..###.## # #=# .#.#..#....#.#.#.##.##.# ###..##.##.# # .# #.#.#  .#
#.# ..###### #.## ##.#.##..#..#.#.#..#. # ##.##.#.# ##.###.##.####.##.##.#.## # ##.###.## ##.#.###.## #.####
#..#.# ....#.#..#.# #.##.#..#.#.#  .# .## #. . . .#.. . .......  ... .... . .....  .  ..... .   ...  .. ..=#
#.# ..#.#.#  # # ...  ...# ## # .##. #.#  .#.#.##.#.### # ##.##.##.#.## ##.##.###.##.##.##.##########.###.##
#..# # .#..#.#.##.## #.#.#.. .# #.#.#.# #=#.# #.##. #.##.##.##.## #.#.##.##.### ##..# .# .#. ..    ..# ..#.#
####..###.##.#..#..# ##. #.#.# . .  ........... ..#.#   .   .  .. .. . ..... . ...#.# #..#. # #.#.#.#..##. #
#.. .#.  .. .# #=.#.. .#.#.#.##.#.##############.#. # ### ##.#.##.## ####.###.#.##..# .#. #.##.#.#.#.# . #.#
#.##..###### # ##..#.##. # .# #.#  ..=   .. . .#  # #.#.# #..#. #..#.#..#.#..#..#.#.#.# .#..o ..  .....###.#
#.#..#.   .. # .#.#..#.#.# #....#.#############..# .###.## ##.##..#. #.#. ##.## #.#. ..# ##.##.##.# ## ... #
# .# #######.# #  .#.#.#.#. ### #.  ... .....  # .# ...... .... # .#.# .# .   #.# #.##.# .# #.# . #..#.#####
#.#. ... ..#.#..#.##.#.#.#.#. ..# ##.###.## #.# .#..## #.## ### #.#..#.# .#.##  # #.#.# .#. # ### # #. .. .#
#..#.#####.#.#.#. #... #.#. ###.# #.#... #.##. # ##.#.#.#.# #.#.#..# #.## #...#.#.#.#.##..#.... #.#..#.#####
#.#..#. . .#.#..#.##.#.#.#.##.#.#.#. #.# #.. .##..#.#..... .# ###.##.#..# .####  ......# #.#####.# ##..#.. #
#  #..#### # # #   ##.##.# # .# #.#.#.##..# #.#..# . #.# ## #.. ..# .#.## #. . .###.##.# . ..=.. .. .#.# #.#
# #  #..  .#.#..# #......#. #.#.# #.#... #  #..#.=#.#..#..#.#####. #.# #.. ####.#.#.#.#..#############.#.###
## ##.#####.# ##.#.######.### ##.##.#####.##.##.###. #.# # .....# #. #..#.#...# #.###. #.. .. .. . .... .  #
#. .. ...  .  . .......... ......................   #.# #.#######..#.#.#  ##=#. # ....##.##.## ##.# ##.#.###
#########.###.## ##.##.### #######.####.# # # #.#.#.#. ...........#...  #.....#.##.##.#. # #.###.#.#..#..#.#
# . ......# . #. .#.#... # #.... . #. ..#.#.##.#..#. ##.#.# ##.##. #.####.##.#...##.# .#.#.#. .  # ## ## #.#
## ###.##..### ###.#.####.#.#######.####.#.#.#.####.# #.## #.#..#.#..#....#.# #.#.  ..##.#.#.####... ..#...#
# .# .# #.#..  ... .. ... ......... .... .. . ......# #..#.# ..# . #. #.#.#.#.#.#####.# .. .. ...#.#### ####
##.#.#. #. ##.###.## ##.## #.######### ### ####.###.#.#.##.### .# # ## #.#.. .  ....   #.### ## #. ..... ..#
#..# ##.# ##.#  # # # #.#.#  . .. ...#.#.#.#.   # #.#.#  ....#.#........ # ## #.###.#.#..#.# ..# #.## #.#.##
##.# ...#.#..#.#  ..# ###.##.#### ### .#...###### #.#.#.#.##.# .#.########.#.#..#. # # # #. .###.# # #.#.# #
#  #.###  .#.# ##.# # .....# ....#...#.#.# .......#.#.# ###.#..#..#  . ... # .#.## #.# #..##.#. . . .. ... #
##..  ..#.# .  ...#.#.##.#.#.##.# .#.# #.#.## ##.#..#.#. .. .#. #.########.#.#. .# #.#.#.#.  # ###=# # #.#.#
##.##### . #######.## # #.# ##.#.#.##.#.## #.# .# #.#.# ##### ##  .  ... #.#..#.#..#. ...#### ##.#.## #.#.##
# .. ...# #..... . . ..   .. .. . . ...    #..#.# #.# # #.  .  .# #### ## .#.#...#.#####. ............... .#
## #####.. ###.#.# ##.#.##.#.#.##.# # # ##.# #  ..#.# # # ## #.#  #. #.# #.#..#.#..... ..#####.# ###########
#..... .# ##.##.# ##..###.#.#. .#.##.#...#.#.# ## #...#..#.#.# ##.#.#..#.#.#.##..##.# ##.#...#.#.#. .. .  .#
## ##.##...... .. . #..  ....# #. =.. #.#..#.## #.#.###.#....#..# #..#.# #.#....#..#.#.# ### #.# #.## ######
#..#  #.#.#####.# #.#.#.#.###. .#.##.##.##.#. . .=#.#o .####.# ## #.#  #.# # ##.##.#.#.#.. . #.#.#..#.#....#
##..#.. # ....#.##.#..#.###..#.##.#.#.. .#..###.# #..## .  #.#.#..# ##.#....# # .. ... #.####.#..# #. ####.#
## #  # #.####..... # #..  # #.# .#.###.#..# .. #=# # #.## # #..#.#. #  ## ## #.##.#### .......#.#..# .....#
#.. #.#.#. .. #.####...##### ##.#.#.. . .# .##### #.#.#.#..#.# #..#.#  ### .  #. #.....#.##.# ##.#.# .#.# ##
## #..#.# #.#.#  ...#.#..... ..  .# #.# #. # .... # #.##.##.##.#### ###.# #####.# ######.# #.##.##.###.# #.#
#...# # # #.# #.####. .###.# #### .#.##..#  #.#.#.#... ......... . . .. ....  ....   ... . . .. .  ... .. .#
##.## #.#.#.# # . ..# #.  # #  .#.#  . .#. ##.#.# # ## #.##.# ## #.# ##.## #.#.##### ####.########## #.#.# #
#.##.#.#.#.# #.#####.#.##.# # ## #.#####.###.#.##.#.#.#.#.##.##.#.#.## ##.#.#.#.....#.. .#  . ... .# ##.#.##
#.... ........ ...  ... .... ....   ....   . ... ... . . .....  ..  . .  ..  . ## #.#.# #..######.#.. .... #
###.#.##.## ###.#.## ###########.##.#.### #.##.## #.#.#####.#.#.#.# ## # ###.###.## # .#.# #... .# #.####.##
#.  .#..# .#...# #. #... . .....#.#.##   # #.# ..#.#.#.. ..#.#.#.#.#.#.#.#. .#......# #..= #.##.#..#.#..#..#
######.##.##.###.#.## ####.##.#.#.#.  #.## #=#### .# #.#####.#.# . #  .#.#.#.#.##.# # #### ##.#.##.#..#.#.##
#... .   .. .. .. . . #..#.#.#. # #.#.#.#..#.... #.#.#.#...  #  ##.#### #.##.##.##..#. ..  ........# #  ...#
##.#.##.## #.### ##.#..#.#... # #.## ## ##.# ####..#.#.#####.#.#.... .  ....  . ..# # # ##.###### #...#.#.##
##.##.# ..# #..#. #.#.#..#.##.#.#.... ...#.#..  .#.#.  .   . . .# ## #######.#.### .# ##. #.....# ##.#.#...#
#.. #.#.### .#.# ##.#..# #.# # #..####.##..# ##.#...##.##.# ##.#.  #. . .. #.#....#.#. #.#..#.##. .#.. .#.##
##.#. #.#  .## # #..#.# .#.... .#.   # ..#.#.#..##.##=##.#.# #..#.#.####### .#####..#.##..# # #.#.#..####.##
##.##.#.#.#.#..#  #.#..#.#.#.#.#..# # .##..#..#. # #......  ...#   ...    .#.. .  # #.#..#  # #.#. #.#.....#
#.# #.## ##.##.###.##.#. ..#. #.#.##.###.#.#.##.#.. #.########..#.#########..#=# #. #. #. #.#.# #.# .#.##.##
#   ...   ...   .....%#.##.#.#.  ..... ..#.#.#..##.#.#.....  #.#.. ....  ..# #.#. #.# #. ##.###.#. #.#..#. #
##.#.###.##.###.#.# #.#.# .#.####.#### ##. #.### #.# #.#.#.#.#.## ##.# #.# #.##..#  #. #.#..... ..## .###.##
#.#.##.### #. .#.#. #.##.#.#....#.#. ..#.# #.. ... #.#.## #.# ..#.# #.#.#.#  ..#. #.#.# .# #### # #. #.... #
#.. . .  ..# ###.####....#.# # #...### ..#.#######.# #.. . . #.## ... ... .# # #.#. #..# #  ..#.# .#.#.##.##
#####.## # # ...... ..#.#..# ##.#.#  #.##...... .# # #.#.### # # .##########..## .# #.#. #.#.#..#.# .#.#. .#
#.....#.##  #########  #.#.#....# .#.#   # #.####. # . ### #.#.##.#. ...... .#   #. #..#.##.#.###..# ##.#.##
#####.# ...#.. . . ...#  ..#.#.#  #  #.#.#.#.....#..##. ...#.# .##.#########.### ##.# #..... ... .#.. ..#.##
#  .#.#.##..#.# #.#.#.#.##.# #.##..#.#.#.# #.## #..#   ##.#. #.#..... . . .. ..#..#.#.#.#.#.##.##..#.###.. #
##.# #.#.#.#.# #.# ##.###.#.#.#.#.## ## ##.##.##.# ###.##.#### ################.###.# ## # ##.#.####.. .#.##
#.. . ..  . .   . ........ .............. ..  .. . . . ... .. ... . ... ...... ..  . ... . ..........## #.##
###.######.#.###########.# ##.########## ####.##.####.# ###.#####.#####.##### # ###.#.##.#######.###.# # #.#
#=. #..... #... .. ....#.#. #..........# ...# #.....# #. .#.. . # ....# . ..#.#...#.#..#.# . ....#  .. ....#
############################################################################################################
