####################################################################################################
#...#.#.. . .#.# ..#..#......###. ......##...#.#....#..#.#.##. ..#.#  .##.........#...#...##.......#
#.#....##.#.#...#.##.#..##.#..#.##.#.#.#..#.#...#.#...#..#.. .#.#..#.#....#.##.#.#..#.###....#.###.#
##.#.#.##.#.#.#........#.#.##.......#.. #....##.# ..#...#..#.#.#..##.## ##......#..#....# #.#.#..#.#
#...........#..#.#.#.##.......#.##.#..#..#.# .#...# ##.##.##.=.#.#....##...#.##..#..##.#...##.## ..#
#.## #.##.#  .#.##...#..#.###....##.#..#....#..##. ....#.....#.#..#.#..# #.#.#..#.##.....#.#...#.###
#..#.#..#...#......#...#.....# #.....#...##.#.#...#.##...#.#....#.....#..#.#.#.# ..o#.##.#...##.#..#
##.#. .#.#.#.#.#.##..#..##.#..#.#.##.#.#......##.#. ..%#....## #.#.##...#....#..#.#.#..# ..#......##
###..#.....#...#....#..#=#..#. ....#...#.#.##....#####.#.##....#.#....#...##.###....## ..##..##.#..#
##. ##.#.#..###.#.#...##..#..# #.#...##....##.#.#.....#..#.#.#.#.#.##...#.#.  ...#.#.#.##...#..#.#.#
#..##.....##........# ...#.#....#..#....##...#..###.#.##...#.#...#..###=..#.#.##. .#.#.#..#..# ... #
#.#...#.#.#..###.##...##.#...##..#...#.#...# .# .. ....#.#..###.#..#...#.#....#.##...#..#.#.#  #.#.#
# ..##.....#......#.#.#...##.### ..#....##..#...##.####...##.##..##..#... #.#......#..#.#..#..#..#.#
##.#...#.#.###.##.....#.#..#..#.##.#.#.#.#.#..#.#.......#......#...#.####.....#.###. ##..#...##.#.##
#..#.##..#....# .#.##..#.#..#........#.#.####... .##.#.#..#.#.#..#. ......### ......#...#..#.#.....#
##..#...##.##.#.#...#.#....# .#.#.#.#.##...#..## #....#..#......#.#.#.#.###. .#.####.#.##.#....##.##
#..#..#...#.# ..#.#..#.#.#...#.#......#..#..#.#....#.#.#.#.#.#.#..#...##....#.#....#... ..#.##.#.#.#
##...###.#...##..#.#..... #.#..=###.#.##..#..#.# #........#... ..#..#..#.#.###.#.#..##.##..........#
# .#..###..#...#.#...#.##.#.. #.#.##...#.#.#...#.#.##.#.#...#.#.##.#.#......##....#......#.###.#.#.#
#.#.#..#. #..#....##=##....#.##....#.#..#....##.....#.#.#.#.#..#...#..#.#.#....##...##.#.....#.....#
#...#.## #. #..##..#....#.###.  ##...#.#..##....#.#= ....#...#...#.#.#.....#.#  .#.#.#...#.#..#.#.##
##.#......##..####...#.#...#..#.o..#..#.#.#..#.####.##.##. ##..#... .#.#.#...#.#..#..#.#.# .#..#...#
#...#.#.#...#.####.#..#..#..#.##.#...#. .#..#..##...#.##..#..#.##.##..#.#..#.. ##..#.....#.##.#..#.#
#.#....#=.#.#..##.. # .#..#.......##.##.#..#..#...##.....##.#....##.##...#.#.##..#.#.#.#........#..#
#.#.## .#.#...#...#.#.#.#.#.##.#.#....... ##.#..#.#..#.#. ....#.#......#......##...#.....#.##.#.##.#
##....#..#..##..#.#.....#..#...#..#.##.#.#.. .###..#.####.#.#...####.##.#.# #....#...#.#.##.####...#
#..#.#.#...#...#..#.#.##..#..##.#.#..#..#..#.# ..#..#..#..#..#.#.....#...#. ..##.#.#...#..#...#..#.#
#.#....###...##.#.#.#.#..#.#... ...###.#..#..#.#..#..#..##.##..#.#.#...##.#.#........#.###..#..#..##
#..# #....#.#.#.........#..#.###.#... ...#..#...#..#.#.#....# #...#.##..#....#.##.##.......#..#.#..#
##. #.#.##..#.#.##.#.#.##.#. .....##.#.#..#...#...##....#.##....##.. ##...###...#....###.#.##...##.#
#.#. . # ..#. ..###.........##.##.#......#..##..##...#.#.....##....#....#.. ..##.#.#... .#..#.#....#
#..=##..#.##.#.# #..#.#.#.#..#..#...#.##.##...#....#.##..#.##..#.#...###..#.#.#...#..#.#...#....##.#
#.##...#.##.......#.#....#.#...#..#.........#...##..#...##...#.....##..#.#...#.##..#....=#.#.##..#.#
#... #.#....###.#.....##.#.#.#..#####.## #.#.#.##..#..#.#..##.#.##..##...#.##...##...#.#.#......#..#
#.##.....##. ..###.#.#.......#.#..#. .##.#........#..# .#.#.... #.#...#.#...#.#....#.## ..#.###...##
##.#.##.#..#o#..#..#...##o#.#.. #..#.#. ...#.#.#.#.##.#.#...#.#.....#. #..#.....# #=...#.#..#...#..#
#....#...#....#..#...#..#..#..#...###..#.#.###............#..###.#.#..#..###=##....#.#..#.##..##..##
###.#..#..#.#..#..#.#.#...#..###.#.#.#.#.......#.#.##.#.#...###.##...#..#.#...#.#.#...#.....#.#..#.#
#...## .#.#..#.##.#...#.#...#.#..#...#...##.#.##..##..#.#.#..#..#.#.#..##...#....##.#...## #...#...#
#.#. .##...#.#....#.#.#...#.#.##...##..#.##.#.#.#. .#....#.#..#.. ....#...#.. ###...#.#.. #..# ..#.#
###.#....#. ..#.#.......##.......#.#..#.....#...#.#..#.#.#.###..##.#.#.#.#..# #...##...##...#.#.#..#
#.....#.#.###.##.##.#.#...#.#.##.#...#. #.##.##.#.##..........#...#..#=...#.##..##.#.#...##...#...##
# #.#.#...#....#.#.....#.#..#.....##...#.#......#...#.#.##.#.#### ..###.#..#. .#...#.#.#.##.#.#.#..#
##.#. #.#..###.#..##.#..#..##.#.#...##....#.#.#...##..#..#....#...#..#...#.#.##.#.##.........#..#.##
#....#...#......#..#...#.#.#..#..#.##.#.#...##.##....#..#.##.# .#...#..#.#...#....#. #.#.###...###.#
#.#.#..#. #.#.# ##.#.##.. #..#..#..#. ##.#.#....###.##.##....###..#.#.###..#...#.##.#.......##..# .#
#.#...#.#.#..........####...###.##..# .....#.##...#.#.....##...#.#...###. #.##.##....#.#.##...#...##
#...#...#...#.#.#.#.#.#. .#.##...##...#.##......#...#.#.#.#..#..##.#..#..#..#.#...#.###..#..##.#.# #
#.##..##..#.........#.#.##.....#..#.##....##.#.#.#.#.##.#..##..#....#..#..#.....# ##.##.#..#.......#
# .#.##..#..### #.#...##...#.## #......#.#....##...#....# #.##. #.###.##.#.#.##......... #.##.##.#.#
#.##....#..#...#...#.#..#.##..# #.## #..#. #.#...#...#.#.......##....... #...#.#.#.#.##.#....#.....#
#.#..##.. #..###.#.#..#.. #..# .......#.#.#.#..##.##.#...#.#.#.#..##.#.#...#..............# #..##.##
##..#..#.#. ##....#.#..##...#..#.# #.#.#....#.#...#...#.##...#...#.......#=.##.####.#.#.#.#.# #..#.#
#..###..#.#....##....#....#.#.#..#.... ##.#..#.##.#.#...#..#..#.#.#.###.##.# ...........#..#..# #..#
#.#.##.#....##..##.#...##.#....#.#.#.#.....#...... ..##..#...##.#...#........#.#.##.#.##.#...#....##
#.#......#.#...#....#.#....##.#.......#.#.###.## ##.##..#.#.#....#.#..#.##.#...#.#. ..#...#.#..#.#.#
#..#.#.#....##..#.#.#..#.#.##...##.#.#.#...#...#.##.. #.......##..### ....##.#.....##..## ....#.#..#
#.#..#.#.##....#.#..#.#.#.#...## ....#...#...#.. ...#.##.#.## ###.#####.#......##.#..#....###.#...##
##..#......#.#.....##...#..## ###.##..#.#.#.#..#.###....#.###..##..## ....#.#.#.#.#.#.##.##..#..#..#
##.##.##.#.....#.##..#.###.....#.....##....#..#.....#.#....#.#...#....##.#...#........#..#..#.#.#.##
#..#.....#.##.#...#.#.#.# .##.#..#.##...##..##..##.##..##.#...#.#..##.#..###...# ##.#...#..#...#..##
#.#..#.##.......#...#  ...#....#..# ..#.### ...#. ...#..#...#...#.#.. .#.....#.##.#.#.#.##.#.#...#.#
#.##.#....#.#.#.#.#...# # .###.##. .##...#..#.#..#.##..#..#.#.#.....####.##.#...............#..#...#
#......#.#.# .# .#..#..#.#.# .#...#.#..#..##...#...#..##.#.#...#.##.......#.#.##.#.##.#.#.#...#.##.#
##.###.#....#..#.#.###...#...#..##..#.#.#. ..#...#...##..#..##...#.#.#.##= ...#..#....#...###...#..#
##.......##...##....#.#.#..#..#....##.#..#.#..##..#.#...#..#..##...#..#..##.#.##.##.##.##.  .##...##
#.#.#.#.#..## #..##.#.....#..#..##.#..#.#.#.#....#....#...#..#...#..#...#..#.#.#...#....#.##.#..##.#
#.##.....#......#.. #.##.#..#..#.. .#.........#.#..###.##.#.#..##.#.##.#..#..  ..####.#....##.###..#
#....#.#..#.##.#..#....#.#.###...#.##.#.##.#.##.#.#.....##....#...#..# .#.###.#.#..#.### #........##
##.#....#.#.....#..#.#......##.#.....#..###..#..#.##.##..#.##...#.##...##...#..#..#...#.. .#.##.#..#
#.#..##.#..##.#...#...#.#.#....#.#.#..##.##.#.#........##..#.#.## .# ##...#...###.#.#..#.#.#...### #
#..#..#..#..#.#.#.#.##.#..#.#.#.....#.#.=......##.##.#....# ..#..#...#..#..##..#... .#...##..#..#..#
#.#.#...##.#..##..#..#..#.#...#.#.#.#...#.##.#... #...\##...#.#.#.#.#.#.###..#..#.##.#.#...#..#.####
#.#..##.....#..#.#..###...###........###...# ..##...##.#.##..#..#...........#.#.#....#.##.##.##....#
#.##....#.#.##.#.##..#.#.#=...#.##.#.#..#.#.##...#.#.....#.##..##.#.##.#.##....# .#.#....#. ....##.#
#...#.#.#.#... #...#...... ##...#.#...#......#.##.#.#.###....#.#. .#.#.#.#.#.#.. ##..##.#..# #.#.#.#
#.#..#.....##.###.###.##.#....##....#.###.#.#.............##.#..##......##.#.#.#.#.#... ##.........#
#.##..##.#...###.#.##..# ..#.#...##.##..#....##.##.#.#.#.###.#.#.#.## ##.......#.....#.#...##.#.#.##
#...#.##. ##..#......#.#.#.#. #.#... ##...##.#.# ......#..#....#...#...#.#.# #..#.#.#....##.# # ..##
#.#.....#...#..#.#.#. #.. # .#.##.#.#..#.#.....#.##.#.#.#..#.#..##.###........#..#...## #....#.=##.#
#.##.##.#.# ..#... ..#.##...#......###.#.#.#.##.. #.....#.##...#.# ....###.#.#.#...#. ....#.# #....#
#.. ###.#.#.#. ###.#....##.##.####..#..# #..#...## .#.#.#....##....##.#..... #..##.##.##.#.#...##.##
#.#..#....##.#.....#.###..#. .. ..#.##...#.#..##...#......##.##.#.#..####.#.##.#.#.......#...#..#..#
#..#..##.#...###.#.......#.#.#.##. ....#....#.#..#.#.#.#.#.#....#...#.#... .. ...##.##.##..##. #..##
##..#..#.#.#=....#.###.##...##.#.#.#.#.#.#.###..#..#.....#...##.#.#. .##.##.##.##. ....#.#.#. #.#.##
###.=#...#..#.#.## ...#.#.#....#.....#.#...##..#.#..###.#.#.#.#... #.#....#..#....##.#......###....#
##..#..#...#...#..#.##. .#.##.##.#.#..#..#....#...#.#.# #.#.#.. ####..#.#..##.#.#.. ##.##.#.#...##.#
#..#.#...##..#..#......#...#.# ..##.#.##..###...#.#.#.... ...# #.....#....##...##.# .....##.#.#....#
##...##.#.#.#.#...#.#.#.#.#...#.#.......###..#.###...##.##.##. .##.##.#.#....# .....#.##......##.#.#
#..#...#..#....#.#..#...##..#.#.. #.#.#.... #...#..#### .#....#.##......# #.#.###.#.#.##.##.#......#
##.###..#..#.#.#..#...#...#...#.##. ...#.##...#...#..#.#.#.#.#.....##.#.......#...#.....#.#. #.#.#.#
#.....#...###...#...##..#.##.#....##.#..#.###.###..#.#......#..#.#......#.#.#.# #.##.## ...#.#...#.#
#.##.#..# .#..#.#.#....##..#..#.#....#.#....#....###...##.##.#...##.#.#.....#...#..#..## #..#..#..##
#..##..#.#..#..#..#.##.#.#...#. ###.#.#..#.#..##. ..##..#......#....#...#.##..#..#..#......#..#.#.##
##..# #..#.###...#..#..#..#.#..#....#...###..#..#.#...##.##.##...##...##.#...#.#. #.#.##.#...#.....#
#..##...#...#..#..#.##..#.#..##.#.#.. #.####.#.#. .# #......###.#.#.#..#...##...#.#........##.#.##.#
#.#...#.#.#..#. .# ....#...##.......#....##......#.....##.#..#... ..##...#....# ....##.###.... ..#.#
#...#.#....##..#..#.##.. #....#.#.##.#.#. ..#.#.#..#.#.#..##...##.#...#.##.#.#..####......#.#.##.# #
#.#....# #....###...#..##..#.#.......... #.#...#..#......#...#......#......#..#..=...#.#.# ..#. ...#
####################################################################################################
