############################################
##.#.##.#.# #.## #  ...#   .#..#..#.##.#.#.#
#. .... .........#.#.#.. #.#..# #.   ......#
# #######.##.# #.#.#.#.##.#.#.#  o#.#.#.#.##
##...    .. #..#.#........  #.### ## #.#...#
## ########. ### #.### # #.#. ... .... #####
#%.#........#. ..#.. .....# #.#.#.#.##.... #
##. #.##.## .#.#.#.#.#### #.# ##.#=#  .#.#.#
#. # #.###..#.##.#. .. ..... = .. .# #.#.. #
##.  .....# ...... #.#.##.### # ##.#.. ..#.#
#..#.###.#.####.##.....#.##.  ... = .###.#.#
##...#.#.#.. . ... ###. . ..# #.#.#.##.##..#
#..#..  ...# ##.##  . .# # # .#.## # ..o.#.#
##.#.### #.##.#.##.###..#.#.#.#  . ..##.#. #
##.# .. .. ... . ....# #......#.# ##= #..#.#
#..#.# # # #.#.##.#.##...#.##.# ## ### ##.##
##...#.#..##.## #.# ...##.#.# #... ... .  .#
#. #.# ..#.....o..#.##. ..#....## ##.#.# #.#
##. .###.# # #.# #...#.##.#.#.#.#.#.#.# # ##
# .#. .. .##.##\#.##.#...o. #=.... .. .. ..#
##.# # #.#....   .. .. # ## #.##.##.#.##.#.#
############################################
