#####################################################################################################################################
#....#.. ..  ##.#..# ..#...##.......#. .#..#.#....##.#.#... .. ....# ..#.#.....#......#.. .........#.#.....#..#.... #........... .#.#
#.#.##.######....#.#.##.#.#...#.#.#.#.####.#.####..... ##.##.# #.##..##..#.###.##.##.# #.##.#####.#...####.##..#.#.#..##.####.#.#.#.#
#.#....... ..## ##.#.. ...#.# ....# ....#..# ....##.#.#......#.#....#..#.#.#.#..#. #......#.... ...#.#.... ...##.##.#.#.#.. .##...#.#
##.###.###.#.##. .. #.###.#.. ####.##.## #.#.#.#. #.#.#.#.##.#..### #.##.#.#.### ##.###.#.#.##.#.#.#.#.#.#.##.......#.#...# #...#. .#
#.. ...# ..#...#.#.#..#...#.#.......#........#.#.##.##..#.#.##.#.. ...............#...#.#..#....# # .#..##.#..##.##.# #.# #..#.# ####
###.##.####.#.##.#.##...#.##..##.#.# .##.#.##..#......###.#....##.#.# #####.## ##.#.##....#.#.#....#..#.#...#.###...#..#.##.##..... #
#.#.##..... .#...#...#.#....#.#. ...# ..#..#..##.#.# #.. .#####.##.##.# ...##.# #.#.. .##.#.#.# #.##.#.#.##.#..#..# #.#........###.##
#.. ...#.#.##..#...#..#.# #....######.#..#.###...##.#.#.# ..... .....#.# #.. ...#.# ##..#...#.#.##... .....#..#.#.# #.########.#...##
######.###.#.# #.#.#.#..# #.##........#.#.....##.......##.#.#.##.#.#.#...#.####.#..# ####.#.......#.## ###..#.#.# #.#. . . . ..#.#..#
#............... ..##.#.#. .#.##.#.##.#..#####.#.##.#.# ..# .#....##.#.##.........#.... ..#.####.#...#  .#.#..........##.#.#####.#.##
##.#.#.#.###.#.#.##...#.#.#....##.#.#.#.#........#.# #.###.##.###.#.....#.##.####.#######.#.#..#..#.#.###.#.#######.#.#.#.#.....#...#
#.# #..###.####.#.#.# ...# .# #.... ..#..##.#.#.#. . ... .. ....#.##.#.##.#..#..#............#.#.#.. ..............## ....##.#.#.#.##
#....#.......#.... ...##..#.#..#.##.#.# # #.#.#.#.##.#.####.###.##.#.#.....#.#.#.##.#.#.##.#.#.#.#.##.######.#.#.#.#.#.#.#.#... ....#
#.####.##.####.#.##.##...#..#.#.##.#..#.#...#=#.#.#.##.#...#.. .. ...#.#.#.#.#.. ..#.#.#...#.......##....  .#..## .....#.#.#.#.###.##
#......#.... ...#. #.#.#.##.#.......#. ..#.#.##.#.#.. .#.#..#.##.##.#.##..  .###.#.#.#.##.#.#######...#####.##.. #.#####.#...##..#. #
# #.###.#.##.# #..#..##.... ########..#.#..# . .#.#.##.##..#.#.#.#..#....#.#. ............... ......# ....#...###..#......###..#...##
# .#.......###.##.##...#.##...... ..#.#.###.##.#.........#.#......#.####.###.##.#.#######.###.#####.. #.#..#.#...## .###.#...#.#.#..#
#.#.## #.#.. ..... ..#.#....##.##.##..# ...... .#.#.##.## .###.###... ...................#....#.....#.#..##..##.#.. #....#.##..#.####
#... . ##.####.###.#.#.####.#.#.#..##..## #.#.#.#.#......#........#.##.#.##.######.#.##.#####..###.#..#.##.#..#.#####.# #..##.#.....#
#.#.#.#. . ....#.#.#..#...#.#...#.#...## #.#.......#.#.##. ##.##.##.#.#.## #.... .#.. #..#...#.#....#.#.#..#.##... .. .#.#.. . #.##.#
#..#.#.#####.#.# ....#..##   .#.#.#.#.. ....##.##.#.##.#.#.#.#.#.#...... ...##.##. #.##.#.#.##.#.#.#..#.##.#....###.###..#.##.##.#.##
####. .........#.#.####.#.#.##..#...#.#####.#.#.#.#....#.....#.#..##.##.###..# #..#....=...... .....#.# .#.#.#.#.......#.#.#.#.. #.##
#....## ###.#.#..#...#.....#..#.# #..# ...........####.###.#.#...#..#.###.##..###..#.##.#.# ## #####..##.# #.# .#####.##.#.#...#.#. #
#.##.#.#..## #.#.#.##.#.#.#..#.#..###..#.###.##.##.........#.#.##.#.#.. .....#.#.o#.#.#.#..#.#.#....#. ....#.#.#.. ...#.....###.#.#.#
##...#...# ....#.. ......#.#....#.. .#.##. #.#.#..#.##.##.#..# .#.....####.##...# ... ..#.# ..#.# ##.### #.#.#.##.###.#.##.#........#
##.#. .#.# ###.#.#.#####.....#.##.#.#....#... ...# .#.#..#.#.# #. #.##....#..##.#.#######..#.#..#.#....#... .##..##.#.#. #.# ##.#.#.#
#..#.#...#...#. #. #.....#.#. #...#..#.#..##.###.##....#.....#..#.#.#.###.##......#.......#...#.#..#.#. ##.# ..#........#..# #..#.# #
#.##..##.#.###.#.#..#.####.#.##.# ##.#.#.#. .... .#.# #.######.##.#.........#.####.#######.##.#.#.##.#.##.# ##.########..#.#..#.#...#
##...#.# .#....#.#.#.#... ......#....# ##.##.####.#.#.# .......#..# #.####.#..#..  ...........#..  ... ......#........ .#...#.#.#.#.#
##.#.#.#.#..####.#.#.# #.#.# ###..##.#.. ..#.#..#.......##.#.#..#  .#.#.....#..#.##.###.##.##..###.#####.###..###.######.#.##..#. #.#
#...#....##.#....#.#.#.#..#.#...#.#..#.#.##. #.#.####.#.#.#.#.##..#.#.####.#..##.#.#...##.#.####...#... ...#.#...#...........#..#.###
##.#..##..# #.####.#.#.####.#.### ##....#..#.#................#.#.#.#.......#....#..##..........##.#.##.##....# ##.###.##.##..# ... #
##..#.# .##.#.#....#.#....... .......#.###..#..##.#.#.#.## ##.#.# #..######### #.#.#...##.###.#....#.. #.# #.#..........##...#..#.#.#
#.##...#.#..#.#.#.#..#.#.#.###.#.#.#.#.##.# .#.##.#.##.##.# . #...#.#.......#.##.#.# #.#.##.##=#.#...#.#. .. #.####.#.##..##..#.##.##
#....###..#.# #.##.#.##.#..#.# # ##. .......#.#...........#.#.#.#.#.#######......#..## .... ....#..#.#.#####.###...#.#.#.#...#......#
#.##.#...##.#.#. .....#..#.#.......#.#.####.#..##.#.#.#.# ..#.###.#....... .######.#...#.######.##.. ...........##.......#####.######
#.#...##....#. .#.#.#.# #..#.#.#.#.#.#.#.. ## ###.#.#.#  ##... ....### #.### ......##.#..# ...#...#.##.# #.#.##...#.#.#=#........ ..#
# .#.#..#.#.#.#.#.#.#.#..#. ..##.# #...# #.#...#....#.#.#.#.##.##.#..##..#..#.###.# ##.#.#.##.# ##...#.##.#..#..### ##.#.##### ##.###
##.#..#.#.#.###.#.# #.#.#..#.#....#..###.##.#.#.#.##.... ..#.##.#.#.#.#.#.#.#.#...#......#..#.#...#.## ....#..#.... ...... ...= ....#
#..#.#..# #.....#..##.#..#..#..###.#.#......#.#.##.. #.###......#.#... .......# #.#.#.#.# .#....#.##..#####..######.##### #.##.##.#.#
##.#.##.##.##### ##.....#. #.###.#.#.#.#.#.#..... ##.#...#.###.#..#.#########.#.#. ...##.#.#.##.#.  .#.....#..#... # .. ..## ..#. ..#
#..#...............####..#.........#..##.##..#.##..#.####..#.##.# #=#...=.....#...###...=......#..####.#.###.###.#.#.##.##..##.####.#
#.#. ## #.##.#.##.#... #.#.#.##.#.##.#.....#.##.#.#......#.#......#.#.###.###...# ...####.#.## ##.#...........#...#.## ##.# #.....#.#
#.###. #.#.## #.# #.####.##.#...#.#...#.#.#... ...##.#.##..#.#.##.#.#....#...##.####....#.#.#....#.####.##.#o#.#.# .......#..#.##.#.#
# ..#.#..#. ..#...#...... ....#..#.#.# .#..#=####..##.##.# ##.#.#.#.#.####.##.#....#.###..#.#.## .. ..#. .##.......##.#.###.#.#..#.=#
####...#..##.##.#..##.#.# ##.##.# ...##.#.##....#.#...#..#........ .#.. ...##.#.####.#..#.# #..#.##.#.####. #.##.#.#.##... ..  #.# ##
#...#.#.#.#..#..##.####.# ###. .#.##. ..#....#.#...##...#..##.#.#.###.#.##....#..... ..#..#.#.#....#......# .#.#.#.#..=.##.#.#.#....#
###.#.#.#..#..#.. # #...##.#.##.# .#.#.##.###.#.###.. #.##.#.#..#......#.##.#.#.#.###.###.#.#..# ##.#######.##.##.#.###.#.## #.#.#.##
#.# ......#. ##.#.#..#.#......#.#.# .... . .......#.##.... #..#.# ### # ...#..#.# #.. ##..#.#.# ............................##..#...#
#...#.# #. # #..#.#.#.##.####..#..#######.###.#.# #.#.####.##.###.#.. . ##..#...##..# ..#.#.#..#.## #.######## #.# ## ###.#.#..#.#.##
###.#.##..#....##..... . #....#.#... =....=. #.#..#. ..............#.##. #.#..#...#.###.##..#.#..#.##........#.#.#. .##..##..#.#.. .#
#...... #.#.##.#.#.##.#.### #...#########.#.#...# .#.########.###.#...#.#..##.#.##........#.#..#.....##.##.#.#..##.# ...#...#.. ##.##
#.#.##.#.... ..#.... #.#.##.#.##....=........#.#..##.. . ...# #.#..#.#. ##....#.#..########.#.#..#.###.#.##.. .#... ###..## .#.##..##
#.#.#.#.#.#.#.# ## #.# #.  .#..#.#.#.#.####.##.##.#..###.##.#.# #.# . #..#.###.#.###........#..#.###.......#.#.#.#.#..#.#.#.#....#..#
##.#......#.#.# ....#..#.####.#..###.#.#..#.#...#..#...#.# ##.#.#  #.## ##.#.........#####.#..#.... .#.####..#.#.#.##.#.#.#..#.##.#.#
##...#.#.#..#.##.#.#.#.#.#.....##...#. .#.#.#.##..#.#### ....#..#.#. ..#...#.####.###.....#.#.#.##### ... .#.#.#.#....#.#...#...#. .#
#..#..#.#.##... #..#.# #. ###.#...#..#.#....#.#.#.#. ....##.#.#.#.#.##.###.#.#..#.# ###.#.#.###.#....#.###.#.#...#####. #.#.##.#.## #
## # #....#.###.##.=.#.#.#..#...#.#.##.####.......##.##.#.........##.#. . .#.#.##  ....#........# ####...#.# ##.#.....# ###..#.#....#
#..# .#.#.#...#....###.#..#.#.#.#.#.#.....#.#.###..###.. .#.##.##......#.#.#.#....#.#.#.##.##=## .... .#.#.#. ..#.### #.....#..##.#.#
##.#.##...#.##.#.#.......##.#...#.#.#.## #...#..#.#...####.##...#.#.### # ....#.# # ..#.....#.#.###.## #..#..##.....#...##.# #..###.#
#..#.#..#.#. .....#.#.#.#..  .#...#.#..#.##.#.#.. .##........#.#..## .....###..#..#.##.####...#...#..#.#.#.# #..#.#.# #.#.#..#.#.. .#
#.##.####.######.#...#.#..#.##. # ..#.#.#.#.#..##.#.#####.##.#..##...#.##.. #.###.#.........#...#.#.#..#.#. .##.##..  ......#..#.## #
#..... ... ...=....##...#...#.#.#.#.#.#...#.#.#.#.#...... ...#.#. ##.#.#..#.#..#. #########.#.#.###.##.#.#.#..#...#.# ######.##.#...#
##.#.####.#.#.##.#.#.#.##.#.#...#.#..##.#.#.#.. .. .##.#.#.#.#.#.#.. .#.#.##..#.#........ #.. ##.....#.#.#.##.####.#.#............###
#. #.. ..# # #.#.###.#.#. #..##..##.#.....#.#.#.#.#.#.#.##.##.##..##.# .#...#.#..#.#.#.#.####...#.#.#..#.#. ..... . ...# #.##.###...#
##.####.#  ..........#.#### #...#...##.##.#..##.#.#.#... .....  .#...#.####.#...#.# ##.## #.# #.#.##.#..#.#.#.##.##.##..###.#.#..##.#
#.....#.#.###.### ####.. ...#.#.#.##.  ...#.#...##.#.# ##########.##....#.###.#...........#.#.#.#....#.#.. #.....#.#.##.##....#.#.#.#
##.#.##..#..#.#...#....#.####.#.#.# #####.#.#.#............... ......##... . .#.#.#.###.#.#.#.#.#.##.#.#.#.. #.#...........##.#=#. .#
#..#.#..#..##.###.# ##.. .....#.# #. .......#..#.#.##.#.#.#.#.##.#.#..##.#.##..#.#..#.......#.#..=..#...##.#.# #.####.#.#.###.#.###.#
##...##..#......#...#.##.#.##. .#.#.##.#.##.#.#.#.#.#.#..#..#.#.#.#..#.###.#.#....#.#.#.#.##....###.##.# ...## #..  ..#.##.#.......##
#..##.. #.#.#.# .##.#.#.#.#...### # #.#.##..#.#.#.#. ..#..#.#......#.=... ... .##...#.##...#.#.#.........## ...# #.#.#......#.##.#..#
## #..#...#.#.#.#.#.#.#.#.#.##. ..#.......#\#.#.# #.#.#..# ##.####.##.#.##.###....#.#...# #..#.##.###.###.#.##.## #.# # ####.##.#..##
##.##...###.#.#.#.#.#.#.#.##.#.###..#.###.#.#...#.#.#..#.#........#..#..#.#.. .##.#.#.###. #.#.......... . ......................#.##
#...# #.#.....# # ..#..........#. # # ....#.# #.#.##.#.#.#.#.####.#.##.#..#.##.## # #.....#.#.####.#.#.##########.#.#.#.#.##.#.#.#..#
####..####.######.#.# ## # ####.#.#.# # # #.#..... ....#.#..#.... ..#..## ........##.## #.. ......## #..... ....#..#.#.##. ...#.#.###
#...# ..#.#...#...#.#.#.#.........#.# .##.#.###.##.#.#.....#.#.##.#.##.. ## #####..#.##..#.###.##.#.. #.#.#######.#......##.# #.#...#
#.##..#.#.###.#.##..#....#.######.#.#.#...#........ #.###.#..#.#.....#.#...#....##.#....#.#...#....###.##.   ....  ##.##..# #.....# #
#...#...#. ...#.#.#..###.#.......#..#.#.##..#.## #.##.#. #.#.#.#.###.#...# #.##..#..###....#.# .###.......##.# ## #.#.#..###..####.##
#.##..#.#.##.#..#. .##.# .####.#.##.#.#...#..##.#..#   #.#.#.#.#.. # .####.#.#..# .##.#.##.#..#.#..##.#.#.# #.#.#.#.#..#.##.#.#..#..#
#=#.#.#....#..#.#.#... #.##..#.# .#..##.###.#... #..#.##.#.#...#.##..#. ...#..# ## #..##.###.#...#. #..#.....=#...#. .##..... .#.##.#
#...#.#####.##..#.#.###....# #. =#.#.#..#...#.## ..#  #.....##.#...# #####.#.#.#.#..#...  ... #.#..#..#..#####.##.#.#.#.#.#.##.#....#
#.# #..........##.# ...#.##..### ..#..#.####.....#.##.####.#.#.#.#.#.... #..... .. #..###.#.#.# .#.##..#..........#.#.#..##...#..#.##
#..#.##.###.##.#. ######...#.....###.##.....#.#.#o. ....... ...#.###.# # .#.####.#.##.....#.#.#.##....#.#########.#.#...#...#.##.# .#
#.#..#.## ##.#.##..   ...#.#.##.#....# .#.#.#..##.###.#.#.#.#.#.....## #.##.#..##...#.### #.#.#. ..##....... ...#.#.#.##.###......#.#
#..#.#.... .......###.###.#.##.#.####.#.#.##..#...#....#....#.#.#.##.. # #..##...#.##.# #.#.###.#.# .#.#.# ##.#...#.#.......#.#.#.#.#
#.#..####.#.#.###.#.... #.#.....  ......#.  #..##.#.#.#..##....#.#...# #.###.#.##.##.....###.....#.#.# #...##.### #..##.#.###.##..#.#
# .#......##..#.#..## #.#..#.#.#.#.##.#. #.#..#.#...#.#.#...##.#.#.#.#.# ..  .... ...###..#..#.#.#.#.##.### .#.. .#.#.#.#.#. ...#.#.#
#.#.##.##...#.# #.##.#.##.#.##.##.#..# .#.#.#...#.##..##..#..#.#.#.#....####.#.##.###..#.#.#.#.#............##.#.##....#...## ## ## #
#.#.#.#...#..#. .... ...... ..#...#.#.#.....#.##...##...#..#..##.#.#.## . .#.#.#..# #.#..#.#.#.#.#.#.#.###.##.......##.##.###.......#
#......##.#.#. #.###.#.##.###.###.#.#.#.##.#..#.#.# ..###.#..#...###.#.#.## ## .#.#.#..#...#.#.#.##.#..#...#.##.### #....#.#..#.#.###
#.#.## .. #..#.#.#.##.#.....#.....#.#.#.#.#.#.#.#.###.#....# ..#. ......#.... .#. #.##.#.#.#.#.#.....#.## #. =..#....#.#... #.###...#
#.# #.#.#.#.#..#.......#.## #.##.#..#.#.........# ..#.# #.#..#.#.######.#.##.#..#.#. ... #.#.#..##.#.#...#..###.#.##.#..#.###.  .####
###. . .. ..## #.#.#.##.#.# #. #.##.#...#.####.#..#...###..#.#.# .. .. .#....#.#.#.###.#.#.#..#...#.##.##.###.# ..#.#..#......##.. .#
# .##.#.#.#....#.#..#. .... # # #.#...#......##.###.##....#..#.# # #.##. .##.#........##.#.#.#.#.#. ..#.......#.#....# ###### #.#####
##.#.#.#.# ###. #..#..#.#.#. .......# #.#.##........##.###..##.##.##.##.#.#..#.#.#.##.. ........ #.##.#.##.###..####.#..... ... . ..#
# ... .........#.#..#.###..#.##.#.###.# # ..#.####.#......#....... .....#.###..#.#..#.#.####.#.##...#.#....# ##.... .#.##.#.#####.#.#
##.#.###.##.####.# ##. ..##..#..#.. ..#  # #.#...##.###.##..####.##.#.##.....#...##.#.#....##.##.#.#..#.##.#. ..##.#.#.#..#.....#.###
##.#.#..#..#........ .#.##..#.#.#.##.#..#......#... ...#..#.# .### #.## ##.###.##...#.#.##.........####...#####.#...#...###.#.#.#...#
#..###.#.# #.####.#.##.#..#.#.#.#..#.##...##### ###.##.#.##.## ...........#. ...#.#.#.#.#.##.#.##.#.... #..#.....#.#.#.#....#.#.#.###
##.....#.#.#....#.#.#...# #.#. .#.#...#.#..... ....#.#.#..... .#.#.## #.# .###.#...#...#. .. #.###.#.##. ## ###.#.##.#.#.##.#.#.#...#
#..#.###.#.#####.##.#.###.#.###.#..#.#...#.#.####.#....#.##.###.##...#.#. # ....# #.#.#.###.# #.##.##.#.# ... ..#..... ##..  .#.#.###
##.#.....#....................#.#.#...#.#.##....#..#####.##.#......##...#...##.#..#.#.... ............... ##.###.#.##.#.#.#.#### ...#
#..#.####.## ####.##.#.######## ##.###.......#.# .#.........#.# ## ###.#..#.#.. # #..#.#.#.#######.#.##.##..#.=...#.#...#.#.#.#..####
##...#............#.#. ...... ........##.##.#. .#.#.##.#####.# #.#..## ###.###.#..#.#.#.##.... .... ....#.#.##.## #..### #.#. .##...#
##.#.#.#.#.#.##.# #.#.#.#.##.#.##.###. #..#.# #.#.# #..#. .........#....  ..##. #.#.......###.###.#.#.#.#........#..#........#.. .#.#
#..#.#..#.# .#...#.. #.#.#.##.#.#...#.#.#.#..=#...#..#. ##.##.#.# #.##.##.# ...##.#.#.####.. #. ..#..#...##.#.##..#.#.#.##.#.#.##..##
##.#.# ##..#.#.####.#......... ...###......####.# #.#.###.##.#.#.#....# ..#.##.#. #.. .....#..#.#.#.#.###.#..#.# ##.##.#.##.##.#..#.#
#..#.#....#.##.#.#...#.#.#####.###. ..##.#......#.#.... .. ......#.##..##..#.#.##.#.#.####.### .###.#. .....#..................#.##.#
##..#.###....... .#.#.# #.....#..#.##.#.#.####.##.####.###########.##.#...#.....#.......... ...#......#.##.#..## #.#.#.##.##.##..#..#
#..#......##.#.####.#.# .# ##.#.#.#........  #.#......#..  .......#..= ##.#.##.##.#.#.##.#.#.#.##.##.#..#.##.#....#.#.# #...#.###.#.#
##.#.##.#...#.#.....#...##.##.#.#.# #.#.##.#.#.# #.#.##.######.## #.###..#.#.#.....#...#.## #.....###.#.# .....#.#.... ...#.#.....#.#
##.##...#.##....#.#.#.#....  #....#.#.#.###..#.#..#.#...#......#..#.....#.....#.###.#.#.#.#..#.#.#.##.. #.# #.#...#.##.## #...###...#
#... ##.#..####..#.##.#.#####..####.#.#. #.#....# #.###..###.##.# # ## ##.####.# ...#.......###.#....####.#.#..#.#. ..#...#.#.#..## #
##.#.##.#.#. .#.#. #..#......#.#....#.#.#....## #. ..=..#....##.#.# .##...#......##...#.##.###...#.###....#..#. ..#.##.# #.## .#.#..#
#.# ....#.###.#.##.####.#.#.#..# #.#..#.#.#.#...######.#.###........#.###. #.###.#..##...##.#..#.#.#...#.# .##.#.#............# .##.#
#..##.#.#.... ....  .....#.#.#...##.#.##..#.# #......# ... .##.#.##.#.. ..#....#=#.#..##. ...#.#.#.#.#..#.#....#..#.#.##.#.## ##....#
##. # .#.# ##.###.#.##.#.....##.#........#.#.#.###.##.##.### .#  ...#.#.##.#.#.#...##.# .##.##.# #. ...#. ..#### # .#  #.####..#.##.#
#..#..#...##.#...##.# #..####.###.##.###................# . #..#.##.#.#.....#.=#.#..# .##.###..#.##.##..#.#.#....##.#.#....# .#.#.#.#
##.####.#... ..#....#.##..........# #...##.# ####.##.##.#=###.#.# ....#.###..# # .#..#.......#.## ##.#.# ##.####... ....##.##.......#
#.. . ....#.## #.###. ..##.# #.##... .#.#.#.#.....#.#.#.#.#.......###.#...#.#.## #  ##.### #.#....... ..... .....####.#.##..#.###.#.#
##.###.## .........o.#.#.##.#.#.###.##.#.....#.##.....#.#.#.#.###.#...#.##..# ...## # .#..#...## ###.####.#.#.#.#..........## #...#.#
#....#. ######.#.### ....... .... .. ....### .#.#######.#.##.#......#...#..#.###..#.##.#.#.###.#.#.##.....#.. #..#.###.####...#####.#
#.##.#.#.. ...#...=.###.#####.##.## #.##...#.# ...... . .......##.#..## .#....=. #............. .....#####.####.#..#..#...#.#.... ..#
#..# #..###.#.##.#.#........ # ...#.##..##.#.# #.##.#%####.#.#.#..#.#..##.####.##.#.#.####.# ##.#.##.. ..#......#.##.#.##.....##.#.##
####.#.#...#.....  .###.##.#..=##.#...#..........#.#.#.....#.#..#... .#.. ..... .....#  ..#.. ..#...#.##..##.##.# ... . #.####..#...#
#......#.##..##.##=#..... .#.#...#..# .##.#.##.#. .#..#.#.#.#  #. #.## #####.###.#.##..###.# #.#.### #.# # . #.#..######.#.=..#.##.##
##.#.#.#.#.# #..#.#.#.# ###.##.##.##.##..#.#....####.#.#.##.##..# .#... .. . .. .#...#...... ..........#. ## #...#.......#.##.#....##
#.#.##.#......# ...... ......=..........#..#.#.#.......... ....#..#.#.###.#.# ###..##..#####.######## #..#.#...#...##.##.# #.#.###..#
#.... .#.#.#.# .### #.#.###.#.#.##.#####.#.#.#.#.#.##.####.#.#..#...###.##.#..# ##..##.#.. #.........#.#. ..##.#.#.#.......... #.#.##
# #.##..#.#.#.#.#.#.#..##...# ..##..........#...##..#.....#. #.#..#.... ...##.... #. #..##.#.##.#.##...#.#.#...#...#.###.##.###.....#
#..#...#..........#.#.#...##..#... #.##.##.#..#.#..#..#.#..#.#...#..#.##.##...#.# .##..#.......#...#.#.#..#..#..#.#....#.#.....#.#.##
#####################################################################################################################################
