####################################################################################################
#  ..# #. #..  .  . # #   # ..      .# .   ..... .#.# .     .   # ## #.#.  . #.#   . .  .# #.##  . #
###.# .# #  ###.#.###. ##.###.#.# ## # # ##.# ####   ## ## ##.# #.. .#  ### ## .#.# #.## # #   .####
# .  # #. #.#. #.#    #   . . ##.# ##. .## ## ... #.# ##.### ##.# #### #. .... #.# # # # # # ##   .#
#### #.#.# .# ## ####. ##.###. . ..  # #  .   #.# # # . .  .  .   ..  .#.# #.# #.#   # # # # #. ## #
#  #=..#.## #.   . .#.# .# .# ######## #######.#.## ################## ## #..# #o###.#=# #.#  #  # #
##.#.##   # # ## #.#..# ##%##.. .. .   .. .     .. . ..  .  . .  .   #.....#.# #.   .#.# #.####.#.##
##.# . # ## ## # ##.# #..  . .# ##.##.##### # ########.#.##.#.## #.#.# #####.#. ## #.#.#.# .. ...  #
#. # ##... .... .  .# #.## ##  #.## ##  .  #.#  . .  # #   # ## # # .# #...  # # .##.# # #.#########
##.# # #.###.##.#.##  # .#  # #    . ..# # #. #.#.##.# # ###. .    # #  ###### ##o   # #.    .. . .#
#  # #.#.#.. #.##.# # ### ###..####### ##.## # # #.# ### #   ######..#.#..  ...  ### # # #.#.#######
##.# # #. ## #.   #.# ..      #    .. .  ..   .   ...  . ###. .... # # .#.#.####.#.  .   ## .#   . #
#  #.#.# #.# .# # #.### # ###  # #######################   # #.#.##..# # # #    .#######   # #.###.#
## # . #.# #.#. #...  .#.# .# #  . .  ...  ..    . .. .#.##.=#.## .#.# #.#  #.##o. ... #.##.## #.###
# .#.# #.# ##.### ###### #.# ..#.##.### ##.## # # ## # # . # # . # #.# # # #.# #.### ## . ..     ..#
## #.# #.#.     .. .. ...   # #  #..# #.# # ## # # ## # .##. #####.#.#.# # #  . .# . # # #####.## ##
#. ..# # .###.### ########## ..#..#.#.# #. . .    .   .# # #.....  . # #.#.#####. ## #.#.#.  # # # #
# ## #.#.# ... .#   ..  . ..#.#. # .#... ## # ## ## ## # #. ######.# # # #.   .# #  # ...# ## .  . #
##.# # #. ## ###.###########. ## .# ###.## #.# # # ## #  # #  .. #.#.#.#.# # #.# =# # ## #   #.## ##
#..#.#.#.#  #   .  .. .. . .# .# #. . #. . .   ...  .  #.# . # # #.# #.#.# # #.# ## ###  # ##  # # #
## # ### # ## ###############.#.# ####.################.# ## ## #.#.##.#.#.# #.# # ... #..   #.#   #
#. . ..  .   .. .  ....    . .  .  ...  .         .. . . .   .. .  .  .#.#.#  #   # ####.##.#..#.###
#.# ##.#.####.# ## # ##.## ##### # #.#####################.# #### #### #.# # # # #   .  .# # #  .. #
## #  #.# .  # ## ## # # #    ..#.#  #.  . .. ..   ...    #.#   # #. # #.# # # #..# ####.#.  #.##.##
## # ## # # # .  . . #     ###.#.  # .########.# #.##.# #.# ##.#.##.## #.#.#.#.# #. #. #  ## #.#.# #
#... ...##  .# #.#.#. #.## # ##.# #  #  ..   .#.# ## # ## #. .  .      # #.# #.#..# #.# .# # # #.# #
# ##### ..# #.##.# #.#.#.. #. . #.##.# #.##.# #..   ...   # ######## #.#.#.#. .#.## # .# #.#.# # ..#
# ..=.# ## .#. ..# # #.### .### #. #. # ##.## .##########. #...   .# #.# #.# ##. #  #.#. #  .  # ###
# ##.#  ..# #.## # #    .#.#.     ## # ..  . .#. .    . ..## ####### # #.#.###.#  # #  #. ####.# #.#
## ## # ###.### #.#.###### .# # #.#  .### ### .#### ## ##.#   . .  . #.. .. . .#.#..# #. #. .  # #.#
#.    .. .      .  ... ....#.# ## ## ##.### #.# . #.# ##  ##.### ###.# ### # ##o ## #. #. ####.#...#
##########################.#   ....#  .     #  ##.#     #. # #.   .# #.#  # #. #  # #.#  # . ..# ###
# .. ... .  .. . ..  . ... ######.## ##.#### .# # # #### .#.  ######.# #.##  #.# ## # ##.##.## #.# #
# #.### #.######## ######## ....      # ... # # . ..#   # .# # ...  .# #.. .##.#.#..#. # ..#  ..   #
## #  .#.#       #.# ..  ..#####.# #.# ###### ######.## #.# # ####### .# ##    #.#### ## ## ########
#  #.#.#.#.#.# # #.#.### ##  .  #.##  . . .... .. .. .  ..=   .  ... # # #..###..  .    ... . .    #
##.# #.# # # ## # .# #   #.##.#.#.#.# ## ###.##.#.#.#.# #.#.## ##.### .# .# #  #.##.## ##.#.### # ##
#. ## .# # #.   .# #..##.#  # # #.#  # .## ##.##.# #.# # # ##. #=.# .#.####.# #..# # #.# . #.. # #.#
##   #.# # ######  # #.=  # . # #. #  # .   ..     . ..   .. #  # .# #      .. #.#... ## #.### # # #
# .###.# #. . .  # #  #### ####.#.##.## ##.# ####.##.##### ## .#  ## #.##.###### .## # .   .  . .# #
## #.  # # # # # #.#.#.. .. . .  .   ...#  .#   #  # # . # ..# .#.#. #  #.#  .  .# #  ######## #.# #
# ..##.# # ##.# ##.#  ##### ## ###.# ##  # #. #.#.#. #.# # ##. #   #.#.# # ##### #.  #      ..#. # #
##.# . #.. .  .. ..# #.... # #  ..# #   #. .# # ##.### ##. . #  # ##.# #.. .. ...#.# .# #.### .# # #
#   ##. ##.# ### #.#.##### #.# #### ### ## #. #..... .   #.# # # .#  #  #.## # #.##..#.# ## # #  # #
##.# #.#.###  .#.# #.....  . #.#         # .#.# #########. .## .# ##.#.## #.##.# ..# #.  . .#..# # #
## #.# #. ..### # #  # ## ###  # #.## #.# .## #..  . .. .# #...## . .# # .#    #.### # ###### ## #.#
#  # # ####.  ..  .#.##.# .  #. # ##.##.## # .#.####.### #. ## #.####  .#.#.## #..  . .  . ..  . ..#
## # #    ..#.#####.  . #.###  # .   .  .#  # # #.   #.#.# # #   .   # #   # #.# ### # ########## ##
#  #. ## ##. #     # #.# .#  #  #.#.#.#.## #..# .### # # # #..#####.#.  # #  # #.#.#..##  . . ..#.##
## # #.## #.## ####..# .#.## # #.## # # #. .#.#.#  . # # # .#.#. . # #.#   # #.# # # #.. ####### . #
## .  ..      .....#.#.#.  . #.#... #.#  #.#. #.# ##.#.#.#.#..#.###. # .# ##.# # # # #.#......  # ##
#..# # # #.# # ##.## # .# ## # .# # # #.#. ##.#.# # .#.#.#. #.#.# .# # # .#  #.#.#.# #.# ##.## ##. #
##  #.# ## # ###.##...### #  # # ##.#.# .#. # # ## ##. #.# # .# ##.#.# ###.# ### # ##.## # # ### ###
##.#  #    #..  .  # #.    #.# #... #.# #  # .#   .  # #.#. # # ... .. .  .  .. .    ..    ...  .. #
# .##.##### .#.# ##  .#.#=# .#.#####.#   #.### .##.#   # #.#  # ##.#.#.#####.####.##########.## ##.#
##...     .# #.#   # # .#..### .      #.##. . # # #=####.#..#. ## ## #. . . #... #..    ...#. #  # #
## ########.#.#.####  # # #.   ##.## #  #. # #. #.    .. #.#  #.    .#.## ##  ## #.#### #.## # ### #
#..  .  .        ... #..# ##.# # # #.##.## .#.#. ####### #..#  # # #.#.# # ##..#.#.#   .#.#  #   . #
####################.###.# ## ## # ##.#  # ##.# #.  . .  # #. ##..#  # . . .# #..# .### #..# #.### #
#   =.    ..   ..   .... . .  ..... .  .#. #.. . #.##.# # ..# # ##.###.# ###. ###..#  ..#.#  #   # #
#.## ## #.##.# # ##.## ########## ### # .# .# # # . # # .# #.. . ....  # # .#.   #..#.#.##.# #.#.# #
##.###.#.#.## #.## # ###.. ..  .. #. ##.## #.# . # # .#.# .#.## ###.## ## #.# ## #.##.#   .# #. # ##
# . .  .  . .  .    .  .## #.##.#..#.#. #..# .#.#  ## #. #.# #..# #. # .....#.# ##.#.# #### .# ## ##
#####.####.## ###### ## # #.##.#.### ##  # # #   ## ## ### # .# #.# #. ###.#..    ...  ..  #.#...  #
#   #.   #  #.#    #..#   .. .   .  .   #. # ##.# .  ..  . #.# .#.#. # #  ..#.# #.##.#.#.##..# ## ##
### #.#.##.#.. # # ### .######### # # #  # # .# # ## ## #.#  .# # #.#  ######.## #.## #.# ## # #.# #
#.#.#.#.#.  # #  #..  #.#. ...   # #.# ##  # # .## #. #.#  # # ##.#. #..  .. ...  .   ..   # #. .  #
#.#.#.#..#.#  .#.# ##.#.########.#.#.#.  # #. #    # #  # #.. . . # #. ## ## #.# ## ########.#.###.#
#.  #.# #   # ## #.# #  .    ..# #.#.# #.#.# ##.###.# ##.#.####### # #.#.#. # .#  # #....   .# # . #
### .#.#.# #=.# .# # ##.###.# #. #.#.#.### .  . .  . . .. . . ..  ...# #..#. # # ##  ## # ## ##.####
#. .#  .  .##  # #  ..# ..#.# .#.#.. .     # ###.## ## # #.## ### ###. # ## #. #.#. #.#.#.#    .  .#
###. #.###. # # .# ## #.#.#.# ##.#.#.#.###.###.## ## ## #.#.###.### ## # .   ## # # # # #  #.### # #
# #.#  ...##  ##.#.# .#.##. # #  #  # # .#..     . ...   .   .....   # # ###  ..  # #. .# #. . #.# #
# . .# ##.#.# .#.# .# #. .#.#  #.# #  # #  ## ##### ##### ## ## # ###. .## # #####.#.###.#.# #.# #.#
###.#. .#   # #  #.# ##.##..#.#..#. #.#. # #.#  ..    . # #....#.#.. # #    ....      ..  . .# #.# #
# #.## # .##.. # # # .. #.#.#  #.#.# .# #. # # ## #.# #.# ##.### ## # .## #########.######.##  #.# #
# # .#. #. .#.#. #  ###.# ## ###.## #.# ## # ### #  #.# # .#. .   . .# .#.#...     .#. .. #  ## #.##
# # # .# .## .##.# #   .#         . .    # # .  ..#.#.#.# #. ## ###.#  #  .#.##.###. #### .#.   . .#
#  . # .#.# # .# # #.##  ### ###.##.######.# #.### .#.#.#..# # # ...##..# # ##.## #.#..   ## #.# #.#
#.# #.##.## # #=.# ###. #  . .  # # #. .   # # .. # # ##..#  # # ##. # #     . ...#.#.### #..#.# #.#
# # #    .  . ## #  . #  #.#.####.## #####.# # #.## #.. #. #.#..# ####.## ##.# # #.. #. #  #.#.#.# #
# #  ## #####  # #.###..# #..#..       ....#.## ##.#.####.# .#.#.   . # ### #.#.#.#.#..## ## ## # ##
# #.#.#.#.. ..#..# #..#.# .# # ##.###.# ## # .  . ...... .## # # ####  ... .    . # .#.#. . .. .   #
### # ## #####.### ##.#.#.## ### ##.## # ##.### #####.### .#.#.# ...#.############ .#  ##.## # #.###
#.  ..  .. .. ... .   . ... .  .  .. .... .  . #  .. # .#.# .#   ##.#.#..  .  .  .#  #  #.#.# # .#.#
##############################################.##### # # # ##.####.## ###########.# # .##.#.   # . #
#  ..  . .  ..    .    .            . .    . ..  .  ...  ..   ....   ..     .   .. ..# #.. ##.## #.#
#.### ##### ## ## ## ##.# ## ## #.# # #.## # #.##.# ## ######## ####.# ## # ####### #..##.#    ..# #
# # ..#.    #. . #.# #.#.##.#.## #.#.#..# # # ## # #..    .. .#.#  .#.#  #.# .. . #  #..# #.#.## ###
#.#### ##### # ### #.  .   .   ... # ##...  # #. # .## # # #.#. ###.#..#.# #.###.#  #. # .#.# .#  .#
#.     ..    # #   . # #### ##.# ## . #.#### . # # # . ##.##  # ... # # ..  .#.## #..#. #.# #.# ##.#
# ########## #.###.# #.# .#   # #  # # .#...# ## # #### #.#.##  #.## .#.##.#.#.. .  ## #. #.##.. #.#
# #. ... ..# #. .# # #  #.#.# #.## # .#.# #.#. . . .    . .   # ### # ### #  .#.# #.#.  # #. # # # #
# #.######.#.# ##  # #.##.#.##.    # # ##.### ## ##.# ## ##.##    . .   . .# #.#.## ##.#. ###.## ###
# #    . #.#.#   # #.#.#  #.. # ##.#.#........ ##.#..# # # ##.# ## # ## ##.#..  . ...# ##.    ... .#
#.#.#.# #  # # #.#=#.##.# ##### #.## ######## #...  #  .. .   #. .# ##   #  ###.# #.#  .# ###### ###
## #.# # # ###.##. # .... .. . .  . .. .   . .##### .#.#.#####. # .  .#.#  #. . .##. # #  # ...  ..#
#.  ... \  .... .#.#.######## # #### ##.######     .# #.   .  #.#.# #.# ##.####.# ..##.##.# #.##.###
#.#.# # # # ## #.#.# #  . =.  # ...# .#.   . # # ##    #.#.##.#.# # # # .#... # #.#    .  # # #.  .#
####################################################################################################
