########################################################
# #   #=   # # # ..    # .. #   .  #  #      #.## . #  #
# # # # ###.    # ## # #.###  # # ###  .## ##. .  ##  ##
# #   # #. ## #. # # # .     #  .#.# #.#.  #.#.#### # .#
# = ##.. .#  ##.#    .#.###.#.#.#..  ##  #. .  ...  .# #
# #    # #.#. . ### #.# #   #. #. ##  . #### ## # #.## #
#.# # #.#.. .# #     # #.#.#.# # #   ## ##..#    .#    #
##  #. . ## #. . ###    .. #     ### .#   .#..## #  ## #
#..#.#.# #   ## #    ##.##.# ## # .. #  ##  # #  # # # #
# #. # # #.# #.# # #    # #  #.# .# # # #. #  .#   # #.#
## #   #..#.#.    .#.##  . .## . #.##  . #.# #.# #  . ##
#  # # #=# .###.##. #### ##    #. .# # ###  # .#.#.## .#
# #  ## . #.  . . #  ##. . =##  ## #.. #.. # # # #.# .##
# # #.## # .# # #  #. .## # #  #.  .## .# #.%#   #  # .#
#..=#. # .#. ###.###.## ## #  # ## # # ## # # ###. ## ##
## ## #  ## #.#  # .  .  ..  #. .# #.  #      #  ##. ..#
# .# .# # .   =#   ##### ##.# #.#   ## .# #.# ##  # # ##
# #  # .#.##### ##.#    ...# ..  ##    #. #  .  # ### ##
#. #  #.#.#   #  . # ###.#### ##.#  ### # .## ##.  . . #
# # .#  #  ## #.###  #   . #.   .#.## ..# # #.#  # # #.#
## .#. #  # . . # .#..## ##  # # #    #  # .  # # #. .##
# #. .###  # # # #  .## ## # # ##  # ## #  ## #..   #  #
#..=# .# ###. #   .#.   #\.  .#   #       #  #..# #.#.##
# ## #.. .  .#  # # # ##..### # #  ### ### #  #..    # #
##    ##.## ### # #. . # ##.#    ##   #  .. #  # # # #.#
# .##. .  #..#   #  #.#.  ..# ## . ##.  # # .#.# ##. . #
#.#  # # #. #  ##. #   ### ## .# #.# ## #  #.   .  # #.#
#   #. ##.#  ### ##.# ##.#   # .## #.    #...# #.#.### #
###.# #    # . ..##   .  ###.###    # ## .# #  .# .    #
#..  .#.# # ## # .  ##.## .#     ## ..#  # . .#.## #####
## # #. .#.  # ## # #o # .# #.###   # .## =##... #     #
# ## ###  # #.   ###. # #     # ## #. #...## # #  ##.#.#
#. o     ##. .## .#  #..## ##.   #.##  # #  .#  # # .# #
#.## # #.#..## ## # #.#. #. # ##. # ..###. #  #  #.#.#.#
# . #. ## .# . . .# #  .# .#  # #. .## #### #   # . . .#
# #  ##. #  # # ##.  ##  #  ###.  #..   #. .# ##  # ## #
## #.# #  ## .# ### #.. ### # ..##  # # .#.# .# .##    #
#   .   .#  #..# #. #.#  ##   ## . #.# # # ## ..## ## ##
# ##.###  #= ## .#.#  #.#.. ##  ##.#.#  #  . ###. .   .#
###     #   # # ##  ## . .#####.. #=  # ..###   # ##.# #
#  #.## #.# #.#    # .# # # ##.# # ## .##    #.# #. # ##
# #.  # #  . . # ## #.# #      # ... #.#.###..    # .  #
# . #.#.# ##.# ## #   .. .# # #o# # #   .#.# #.##  # # #
#.# ...##.#. #.  ..##.## # #.# .#  #. #.## # .# .# # # #
# # ###    ##.## # # #.  # #. #.. #####   .  # # #..#. #
# #=..# ## .   # #... ## . # #.## .#..  ## #.# .  #   ##
# # #   # #.## #  # #   #.##o. # # # # #.# # .## #.#.# #
# # ## #     .  .#. . #.#.   #.    ##  #...# ##. . ##..#
# .   #.##.## ## .# ## #.##.#  ###..# ##.###  .# #.. # #
# ## #   # ..  ##  #     .#  # #  .# # . . .## . #.#   #
##. #  # # # ##.#.#. ### # #  #  #  .  ### #   # ## # ##
##.#.#  #  #  #  ## #..#.    ## # #.# #.. # # #.# #. # #
#   .. # .#.# .# # . .# ## #  ..# # .# .#   # . .   ## #
# # # # #.#  # . ## ### .....#.## ##.# #..#.#.# ##.# . #
#  #      . # .# .  .   # # #  #  ....  #..###  # .. # #
########################################################
