######################################################################################################################################################
#.. ...   ..#.. .#.#. #  ....#.# .. #.#...... #.#. . #.  # ##.# #.##.#  .#.##.#... .#.#.#...  ...#...#.. #..# #..#.. # # ......#.# # #.#.##.# ## ## ##
#### ##.#.#.#.##....#.#.# ## #.#.#.#.   #.#.#.# ####.#.#.# .. ... .....# # .. .#.#.##.#..# #####.##.#  #.#.## .# .# ##..#.#.# ##  ...... ... .... ...#
#. . ...# # #.#  #.##.#.###.##.# ##.#.#  .#.#.# . .......# #### #.# # # ..###.#.  . . #.#..# . #..#..#.#.#.#  # .#. #..##.#.### .#### #### #.#########
# #.#.##.##.#.##.#.#..#..    .. ....#. ## ##..# #########.....# .#.# # # # . ..# #.##.#..# .# #..##.##.#.# ##.##.##..# # .#..  #.# .....  .#. . ... .#
#... .   .. #..#.#. #..# #######.##.#.#.#...# #.   . ... #.##.#.#. #. ....### #. ##.# #.# .#. .#... ...# #.. ..   ..#...# # #.## ########## ##########
#####.## ##.#.#..# #..#..#....  .# ##.#.#####.#.#.##.# #.#.##.# .# #.###.# .. .#.   # # .# ##.#. #.##.#...### ##.##..#.# .o. .. . ... .... .   ..   .#
# ...  # #....##.# ##..#  # # ## # #.. . .....#.###.#.#.#...  ..# . . .#. ###.#..####.# #. .# .#.#..  .#.#....#.#.#.#...#.# ###.##.#.##.###.#.#.## #.#
##.##.## ## #    .#.#.#.##.#.# #... # ##.#### #...... . .# ####.#.## #.# ##.#.## #... # ##.#. #..#.# ##..######.#.# ##.##.#.#. .  #.##. .. #. # #.# ##
#.#.#.#.#.# .###.#... . .........## # #.......#.########## .  # .# #.##  #... ..  # #.#.=# .#..# #.## ##.  . .... ... ....#.#### #.....###..# #.#.. .#
#.... .  .# #..  ###############.#.##.#######.# #...  .....#.#..#.. .. #..#.#.## #.#..#.#..#..#..#..#. # ##.#####.#####.##..  .#. .#.#. .#.##...#=# ##
# #.#.##.#...###..  . ....    ....   .....   .#.##########..# ## ###.# #.#.##.. ..  #.#..#..#.##.# # .# ...... .#.#.. . # #.##.#.#.. ..#.# #..# #.## #
##.# #.##.#.#....######.### ###.##.##.#.##.### ... . ..  # #..... .......  ...##.###. #.#. # ..#.#.## ##.##.##.#. .##.#.# #   #. # #.#......#.#.#. ..#
#.......  ...#.#... ..#.#.#.#.## ###.#.#.#... #.#.##.##.#...#.##.##.##.#.#### .#... #.#..#..#.##.# .#..# #.# ##.#.# ##.##.# # ##.#.#.#.#####. #.#.##.#
# # #.##.##.# ##.#####.. . ...  .... . ..#.# #..##.##.##.#.#.#. ..##.### ...# # .#.# .# #..#. #=.#.#..#  .. .. ...... ... #....#.# #.# .....#.#.# # .#
#.. #. #..#.# .  ... .# #.###### # #####.#. # #. .. .....#.#. ##.#.......##....##.# #.#  #. # .# #. #  #.######.# ##.# #.# .####..## #.######.#.#..#.#
# #.#.#..#... ##.## # . # .......#.#...#.#.#. ..##.##.# ##.# #.# .## ### ...#.# ...... .#. ##.## #.##.#.......#.#.#.##. #.# #.   # ....#    . #.#.#. #
##.#.#.##.#.## #.#.#.#.# ########.## ## # #.#.#.# #.# #.#..#...# ## ## #####.. ## #.#.#. # #. .  #...  #.######.#. ....# .. # ##.#.###. ##### # #.####
#.......  .  .... . ...... .. .... ..... ..  .....  # #.##.# ## ............#.# #.## # .#.. #.##.#.##.#... .... #.##.#.#.## ###..#.#.#.# ..   # # ...#
## #.#.##.#### ##.# ###.##### ##.##.###.# ###.#.###.# .....#...#.#########.# .# .. . .# ##.# ..#.#.# # #.########.# ## # #... .#.#.# #. #####..##.####
#.# .# ..# . #.#.#..#   #  ..#.# # # ...# #.# #.. #.#.####.# ###.#. .... #.##...#.###.#..#..#.#..#...  #.#......  #... #.## ##.# #.#.#.# ...# #. .#. #
# .#. #### ###.. .#..##.#.#.## ##..###.#.  ...#.###.#... #.# .. .#.#####.# ...# #.#..#..#. ##.## # # #.. ####.### #.##.#. #.. .# # #.#.###.#...## # ##
#.##.# . ... ..####.#.. ... .... #.... .#.### #. ...#.## #..####.#  . .# .### #....#. #. #.# ..# #.# #.#...   ..#.# ##.  #  ## #.#.# # . .. #.##. .. #
#.  .. #.#.#.#.# . ..####.###.##.#.######  ...#.###.#.##.#.#. .. # # #.#.#..#. ##.#..#..#...#.#..#.###.#.#.##.##. #....#.##.#.#..# #.#.##.#.#...#.## #
######.##.#.## .#.# #. .#.  #..#.#.#...  .# #.#.#.#.#. ..# .# ##.## #.##.# #. #.## #.##..#.# . # #..  .#.#..#.  #.## #.#..#. ..#.# . . #.#..#.#.#.#.##
#.. .........  ## #.#.##..#.#.#..#. ## ##=#.  #.# # #.##.#.#.# #  ..........#. .. . ..# #...#.# .#.##.# .###.#.#.#.## #  ## ####.##.## # # #. # #....#
#.###.#.##.#.# #..#.  ..#.##.#.##. # .. . . # #...#.# .#.# #. ...# ###.#.#.#. ###.####. ##.#  .#.# #.#.#...............#.#. # ... #..# #.. .# ..#.## #
#.# ..##....#..###..###.#........#.#.# ##.#.#.#.#.#.#.#..#.#.###.#....#.#..## #.... ..#..#..# ##.# #.#.# ## ### # ###.##.##.## #.#..##.#.#.#..### #..#
## ###.# ## ##. . #.# #.#.#.## # #.##.##.# ## . #.#.#.##.#.#.#.  ..####.##..#.###.####. # .#..#..# #.#.#..# #.#.  #.# .. .# .# #. #.#..#.##.#.#.. .#.#
# .... .. .... #.# .# # # ###.#.##....  ......#.# ..# .#.#.#.# # #. ..     #..... #. .# =#.##. #.#.....#.#. # #.#. . .##.#..#..#.# ..#... ..#..##.#  #
# ###### #####..# # #...#.. ...... # #########. #.#.#.## #..#.#.#.#########.#.## ##.###.# . #.#. #.##.#..####.# #.#.#..#.## .#.#  #.#..# #.##.#.# .#.#
# .... #.....#.#.....##.#.## # #.# #... . ... #.###.#. . #.# ..... ..... ...... ....  . .#.## .#.#.#.# #..... #..#.# ###..# #..#.#. .# ## ## .#.#.#..#
#.#####..#.#.#.#.## #.# ..#. ## #. .###########. ...#.##.#.# #.#.##.########.#.#.##.### #..# .#. #.#. . .## #.# #  .... .##..#.#..## #......# #.#. #.#
#=#... #..#  #.# .. #. .# ##.....#.# .... ... ..#.## .#.##..#.##.#.#. .......## .#  #.#..#  #. #.#..#.##.#..  #. ## #.##.#..#.. .#.... ###### #  .# .#
##.###.##.### # ## # #### .#.###.#..####### ###.# ..#.#. . #...  #.#########...#..#.# # ##.## #..#.# # #.. #.## #.##.#.#..#..# #.#####.... ....##..# #
#. .... ... ..... . . ....# ...#.# # ..... .#.#..#.##.# ##..##.#.# .   ..  #.# #.#..# #.#. ....# # #... .#.... ....  . ..#..#. ....... ##.###.#.. # .#
#.#.##.#.# # #.#.#.# ## #..#.#...#.#.######.    #.....#. #.###.#.#.##.##.##..#.. .#.#...########.## ####..# #.#.##.# # # .#  #.#.#.### #. .  ..##  # #
##.#.##.#.#.#.# ## #..#.#.# . ## # . #....#.#.#..#.##.# #..##.# .#..#.# ...#.#.#.#..#.#... =.. ... . ..#.# #.#...=#=.#.#.##.# # .#...#.#.#.##.#.. # .#
#   ..... .. .... ..##.#...#.# ..#.# . ## #.### # # #.#..#. ...#.# #. .#.#.# #.#. #.#.#.# #.##.# #.#.#... ....#.#o #.#.#.. ....#.#.###.## #.##.##o.# #
##.####.##.#.### ##. . .#.#. #.#.#.###.#..#. .......#.###..#####.#.####.# #.# ##.#....#..#.#.#.#.##.##.# #.# #.. .##.#.#.##.#.#.. # . ...  ... .#.#  #
# .#. .#..#.#. #.. .# ## . #.#.#.  .. .### .#.#.## #..  .#.#..  .#  . .  .  ....  #.##..#..#.#.#. #.# ...#.#.##.#.#. #.#.#.. . #.#. # ##.#######.. # #
##.#.###.##.##.## #. #.##.#. # #.# #.#....# #.#.# # # ##.#..#.## ..### ## #.## ##.# #.#. #.#.## ##. .#.#.#.#..###..#.#.#..#.##.#. #. ..# ...... #.#..#
#. # . . ...  .  .. #. .#.#.#..# # .##.####.# # . .. .#.#..#  #. # ...#.#.#...#.#.#.#.# #     .. .#.#..# #...# .. #..# #.#...#.#.##.## ##########..#.#
## #.# #.#.#.## ###. # #..##.##.#..#..   .. #.#.##.##. ..#.##..# #.#### ###.###.##.##.#  #.### ###.. #.# # # ## #.## ###. #.#. . . .. . ....  ..  ##.#
##  ##.## .#.# #... #...#  . ....#.#.#######.#...#....###.  #.##. . .. .. .. ....  ...#.# .. .. ..#.#=.#..##..#.#..   .  #. #.##.#####.########## #..#
#. # .   #.#.. ..## .#.##.## ## #..  . ... ...#.#..##....#.#..#.## ###############.## # .# # ##.###  #.# # ..# .# ##.#.#..#. #.# ... ..... .... #.####
##. #####.#.#.##.##.#.  . #.# . .# #.## # ##.#. ##..#.## #.##. . #.# . ...  ...  #.# .  ##.# # #.. .##.# .## ####.# #.#.### #  ..####.#####.##### .. #
##.#......  .........##.#.#.##.# #.# #.#..# #.#..# #..#  #  # ##.#..#.### # #.## #..### # .### ####.#..#.# . ..      ... ...#.##.#.....   ....... ## #
#. . #.#.#.#.# #.##.#..##.#... .. .#....#.#.... #   #. #.#.# ..#.# ## # ## #.#.##..#.. .## . . ...  ##.#.##### #.###.#.#.##.#. # #.## ##.## #.### #..#
##.##.#.# ..#.#.##..##.#..# #.# ##.# ##.# ##.## .# #. #..# ## #..#..... .  ... ..#.#.##..#.#####.##..#.#. .  .#..#..#.#.#.#.##.#..#.#.#. .#  ##.#..#.#
#. .#....#.# ...  #.....#.. # # #..# # # ... .#.#.. #. #.#..#.###. ##.##.##.##.##..# #..##.# .  ..#.##.#.#### # #. ## # ..#... #.#..#. # #..#.. #.##.#
## ##.###.#.###.##.###.##.## # #.#.### ######.# .#.##.#. #.#.....#. #.#.## #.# #.#.#..#.#. .#.##.#..#. #.# .. # ##.# .#.##..## #..#.#.#.# #.###.#... #
#. ..  . ... .......... . ...... ........   .. .##.#.. #.#. # #.# .# .# ...#.#. .#.# #..##.#.#.## #.##.#.#.##.#. #..# #.  #.   # #..#. .. #.... #.##.#
####### ## ##.###.##.##.#.###.###.#.#####.#.###=#...#.#..#.#.  # # ##.####.#.#.# #.#.##... . .  .....#...#..#.#.#..#..#.#.#.#.#...#. ###### ###...#=.#
#... ...# # #.# #.# #... #  #.#.#.#..... .#.. #..#.#  ### ..#.##.# . . ......# #.# ##.# ##.#.### # #.#.#. ###.#..#  #.#\#.#.#.## ##.#. .. .. .#.#..#.#
#######..   # # #.#.# #### ##...#.#.###.#.# #.#.#. .#. ..#.## #  #.####.######.##.....#.#.#.##.## # ## #.#. .. .#. #  #.#.  ... .#.. .## # # #. #.#..#
#.... ..# #.#.# # #  .#... ...#.#.#.#...  #.#.# .# ## # #..#...#.#.... ... ... . #.###..#. .  .   . .... .##.##..#. #.#  .#.#.##. #.###.# # #.#.#..#.#
###.#####.##.##.## ##.## #####.# # #.###.##.#.#.#.##.#.#.# ##.#..#.## #.#.####.##.  ..#. ###.#.#### #### #..#.# #. #. #.#.# #..# #.. ....   ......#.##
# .# ..  ....... . ... ......  ..  ......................   #. #.# ..#.#...... ..#.#.# .#  ..#.#.. .#  #..#.#.#. #.##.#.#.#.# #..#.##.# #.#.#.#.#.. .#
##  # #######################.##.#.###.##########.### ##.#.## ##.#.###. #### ## #..#  #..### ##.# ### # .#. #.# #...#.#..## .#.#.###.#.#.#.#.## #.#.##
#  ##.# .. .  .....  ..... ..#.##.##.#..   .   ..#..#. ### #.. . #.#...#...   #..#.#.#  #  #.. .. .....#..#.# #.## ##.# # . # . ......  .......   .#.#
## #. #.#.######### ## #.###.#.. ... # ### #.##.##.# .#.. ..###### #.#.########.#..#.##..#.# # # # ## ##.#.  . ...... # ### .## #.#.#.#.## ######.#..#
#.. #. #.#.... .... #..# #.#.#######.#.#..#.#..# ..##..#.# #... ...#.#.. .... ...#.# .# ##.#..# #.#.#.. .#.##.### ### #...#.##.#.# #.#. #.#. ... . #.#
##.#..## ##.####.## .# # #..  ........ .#.#.## ###..# #.#. # #####.#.#.#.# ##.# #..## . # ...##. ...# ## .#.# # #.. #.#.## . ..  .....#.#. #.##.#.##.#
#.. #.....#.# .   #.#..#.#.# # ###.###.#..#......# ## #..# # .= ...#.# ##.## #.#.#... # .###.#..## # ..# ##.###.###.#.# ..# #.##.#.#.#..#.# ## ## #  #
## #..##.# #=#####.# ##.#.## #.#.#....  # #.##.##. #  #.#..#.#.#.#.#.  ..  . .. . .#.# .# ... #.# ..#.# .#......... ..# # # .#.#..#.#.#.#.#... . ..#.#
## ##.#.. .......... .  ... . ##.########.##.#.#.#  #.#..#..#.#.#.#.####.####.##### #.# ##### # ## #.. # # #.# ##.# #.#...#.#....# . .. #..# #.## # .#
#. .. ## #.#.#.## #.##.#####.# .....  .   ... .... #..#.# .# ... .... .. ......... .  ... ... ..... # #.. #.#.#.##.##.#.#.# ..##..#.#.#.#.#.#..# .##.#
###.# . #.#.# ## #.##.##...# .# #.# ##.#.# #.#####  #.#.##.#.# ######## #.###.#.## ### ##.##.#.# #.#. .# #.. ...  . ..# ## .## #.# # #. #.#..#. #.. .#
#.#.#.##..#. ........ # .###.#.#.#.#.##.#.#... ..#.# . . #. #  ..... ..#.#. .... .    .#.#.## # #.. #.#.. ###.#.#.#.#.#.  #.#... .... #.#.. #.###.####
# # #.#.#.###########.##.#...#    .. ...   #.#####.##.#.# .#..#### #####.###.####.#####...  . ...#.##..#.#  .  .#..##.#.###..#.#.#### # #.#..... ... #
# #.#.#.... . ... . . ... .#.#.##.#.#######..#..  ..#.#..# ##...  .... .. ....  . .. . # ##.##.##..#. #..# #.###..#...# #.. # #.  . .#..#.##.####.# ##
#...# #########.##.#####.# #.# .#..... ... #.#.# # ##.#.#.. #.#### #.#.#.#.#.## # ##.#.. # ##.##.#..#. # #.#....#..##.#.#.#  ..#.#.##.#.#. # #. ..## #
### #.. .. . .... ...  .#..#.# # .##.## # ##.. # # # .#..#.#. #...  # ##.##.##.#.# . ..#.# ...  .# #..#...## ####.#...# #.#.#.#. #. ..#.# #...#.#... #
#.#.#.# ####.##.# #.###..###.#.####.##.# ##.### ##.##.#.#..##.#.##.#. . ..... .. ..# #.#.#=# #.#.# .#.##.#. ... ..# #.#.### .# # #####.## .# #..#.## #
#.#.# #.#.. ..#..#.# ...#..  ..  .. . ..   ... . .....# ##..#.##.##.######### ####.##.##.##.# ##.# #.  #. ######## ## #..  .#. . ....  .. #=..#.#.#.##
#...# #.#.##.#..#. # ##. ##.#.#.###.# #.# ##.##.##.##.   #.#.. ..   . .. ..   . .. . ......... . . .#.#. #.....  .....#.###.#### # # ##.#.##.#... # ##
#####  # #.##.## # ##.# #....#.# ..#.# #.# .    .# # .# #..  ##.#.## # ##################.#.# # ##.##.## #.##########. #. #  ....##.#.##.#.#.#### #. #
# .. .# ..  ...... . ... #.#  .. ##. ..#.#.#.##.##..#..  #.#... ## ##..#  ......  .... ...# ## # # # . #.  #....... ..##.##.#### ...... .. .....#.#.##
# #.#. #### # #.##.####.#.#..###.#.#.### #.# #. #  #..## #..###..... #.#.#.## #.##.##.#.# #. .  .#..#.##.#..####.####...... # .# ##.# #.#.####.## # ##
##.##.# .. .# ##.# #..#.#..#.#.....#.#...#.## ##.## #.#..# #. ..#.#.##..##.#..#.#.#.##.## #.####...# .#..# # ..#.#..# #.# #. # #.#.#.  # .    ##. #. #
#......## # # . .#. # # #.##.#.#.# # #.#.#. .   . . # .#.#..# # ...#   # ..## #   .. .....#.. .. #.## ## #.#.# #. # #.#.# #.#. ... #.#.#.# ##...# #.##
# ###.#  .#.# ####.#..#.#..  .....  .....#.# ## #.## .##.#.#  #.##.###.#.#..#.#.#.# #.# # #######.. #..#.#.#.#.####.#.##.# . #.#.##. # # #.#. ###.#  #
#  .#. .###.....  .##.#.#.## #####.# ##.#..##. ##.#.# #..   #.#.  ...  #.#.#..#.# .# #.#  .. ....#.#..##.#. ....  ..#.   .#.#.#....#.#.# #  #.. ..#.##
#####.# ... ### ##..#.#. . ..#.. #. #.##.#. .# #  ..#..###.#.#.########.#.## # #.# #.#.########### #### .#.#.#.#.#.##.##.#..#.##.#.#...#.#.##.#.# # ##
# ....#.#.#.#..#. .#.. .##.#..##.#.# ... . #.#..#.# # ## ....... .  ..........  .... ...... ...........# # #.#.#.#.# ..#..#.#..# # # #.#.#.#..# #.#..#
#.#.# # # #..#.###.# ## .#.#.# #.#.#######.### ##.##. #..#.###.####.#.# ##.#######.#####.# ###.##.## # #. #.#.#.#.#.# #. ##.# ## #.#=# #.##.#.#.# # ##
#...#.#.#.#.#... #.#.#..# .# . ........ .. ... .  . #. #.#.#...#  .#.#.#.##......#.#..  #.#...#.#..# #.#.#.. .. ...    #.#..#....#.# # #...=#.#.#....#
#####.## #.# # ##.#.#.## ### ##########.## ## ##### #.##.#.#.#...#... .#  .# ###.#.# ####.#.#.#.###.#.#.. #.#.#.#####.##..#..###.#.. #.#.###. # #.####
#  ..............    .......... ..  .. ##.#.##.  ...# #..#. ##.#.#.#####.##. #. .# .. ........ . .... .#.#.#.#..# ..#.#..#. #  #.. #.#.#.#..# # #... #
#.### #.#.######.####.###.## # #.#.#.# . ... #.# ##.#. #.#.# . #.#.#... . .# #.# #.## #.### ## #.##.## #......#.#.#.#..#.##..#.# ##. # #. #.#.#.#.####
###.#..#.##..  #..... #..#.# #.# #.# #.###.##  #..# #.#..#.#.#.# #.# # #.##....# # #.. # .#. #. ...#   #.#.###..#...#.#.# #.#......#.# #.#..# #.#....#
#. .#.#...  #.#. #%## #.##.#.   .#.# # # .# .# #.#. #..#.#.#.#.#.# #.  ... # # #.#.##.##.#.##..#.##.##.# .  ..#.# ###.....# #.## ###.###.## #.#.#.#.##
#.#.#..## #. #.#..... # #..####.#.# # .# ## # ..#.#.#.#. #..##.#. .## ##.###.#.#.#  #..... . #.#.#.   .# #.# #..#.... #.# # .#.#........ .# #. .#.# .#
# #.# #. .#.#. #.###### ##...... ... #.#.#..##.#... # ## #.#. .#.# ......#...#.# #.#  #.######.##.###### ## #.# .####. # ##.#. # #######.#..#.#.#.#.##
#.# # .####.##.#.# ... . ..# #.###.# #.#..#..#.####.# .# # ###.# #.# ###.#.#.### #. #..........   ..  ...  .. #.#. .. # ..  .#.#.#..     ## #.#.#.#. #
#.# #.# ..  .... .##.#####..#.##.# #.#.# #. #... .# # ##.#. .#...#.#.#.#..  .....# #..#.#.# ##.#.####### #.##.#.# ### #####.#..#..# ####....#.# #.####
#.#.#.# ## #.###.#.  ... # #...  .  .#.#..# .#.#.## #.#..#.#.#.##. #. .#.###.##.#...#.# #..  #.#.#...  ...# ## .#.#.. . ..# .#.#.#..#  #.### .# #... #
#.#.##.##.#.##.##.######.#.###########.#.## ##.###.#.#.# #.## #.## ###.#.#.###.#.###.#.#.#.##.#.#.######.#.. .#.#.# #.#.#.# # .  .#.#.##.# .# #...# ##
#. . .... .  .. . .. . .  . .... .. .......... .... ......... .. ..... ... ..... ....   .....   . ... . . # ### #.#... # ##.####.# .#.#...# #.#.#.##.#
######.######.# ####.########.# #.#.## #.#.#.# ## ##.#.##.####.#.#.# #### #.## #.# ###.### #.###.#.#.#.#.#. #. .#...#.#..    ..#..#....#.#..#.# #..#.#
# .. .#. . ..#.# ..#.#. ...  #..##.#. #.# # #.##.#. #..# .# .# #.# #.#.... #..# #.##.### ##.## ## # #.##. # #.# #.# ..# #.#.##.#.#. #.# . # # # # ##.#
#####.#.####... #.#.  # ####..#......#  . .. .....#..## ##.# # #. #.#.#.#### # =. . . .... . . .   ......##.#. =#. .#. #.##.   #.###.# #.## # ##.... #
#... . .  .  #.#.. #.#.... #.#..####..##### ### ###.#.. . .. #.  #. .....   .#####.# #.##.### # #.##.###.# .# # #.#.#.#.....# ##... . . ... ....# #.##
##=#.#.##.## .#.#.#...######.##....# #....#.# .#....# #.#.## #.#..#.#.#.##.#... .#.#  #.#.# ## #.#.#...#=## # #.# ###.#.#.#.#..  ##.### ##.##.##. #..#
#.#.#.#.##.#.# ...=#.#.  ...   .##.# #.#### ##.####.## #.#.#.##.##.# #.## #. ###.# .###.# . ..  ....#.# . # ## .#... .#.. .. ###.  # .# #.#.## ##.#.##
#.. ...... ..#.## #.. ##.## # #.#..# ......  .. ..... . .  . .. . ..   ....# # ### #  . ..#########.#..#.#.. .# #.### .# ##.#. # #.#.##...#... ...#.##
##.#.#.#.###.##  . #.#.### # ##.#### #.## ####### # #.#.##.###.#.#.## #### #.#.. ..#.####.#.    . # #.##.##.##. #. .# # . #..# #.# .....##.######.##.#
#.### #..# #..# # ##  .....#.#... . ..#.#.#. .... ....#.# # .#..#.....# ...#.#.###.# .....# ## #.##.# .. .  ..# # ###.##.#..#..#. #.# # #......  .   #
# .## ##.. #.#.... ..#######.###.###.##.# ############.## #.#.###.###.######.###.##.###### #.# ###.#.### #####.## #. . #..# ##.. #.# #..#.# ## ##.##.#
#.#.. .# ## ..#.#.## ...... . ..      .... .  .  .. .. .... ...   .. . .  . .... .... .... ... .... ...#. . . .  #. #.#. #.. ..#.# #.## #..#.#.#.. #.#
#.###.#.##.#.## #. #.##.#.# #.###.##.# #.##.##.#.##.### #.##.####.## ###########.###.###.########.##### ### # ## .# #..#.##.###..# .... .###.##.# #..#
#..   ...  . . .. ## #.#..##.## ##.## #.#.### #.#.#.# #.#. .. .. # #........  .#.# .#.. . ......#.#.   .#.. # #  #..# #...#.#..#.#.#.##.#..........#.#
## ############.# #..# .#  .. ...  ... ... . .. #.#.#.# #.## ##.#. #.##.###.#.## .#..#.#.#######..# ####.### ..#..#.#..#.#..# ##..#.#.##.######## #..#
#...  . .  . .. #..#.#.##.## # #.# #.#.#.## #.#.#.#. .#.#  #.  ..# . #..# . .# ..#. ##.#  ......#.#.. ......#.# .##.# ##..#.# #..# . ...  ....... ##.#
###.# #.##.#.##.# #..#.# #.##.#.#.# #.##.#.##.### #.### ### # ####.##.###.### #.# #.#.##.########.# ### #.#.#..#.#  ..# .#..# ##..#.#.#.#.##.##.#.  .#
#.#..##.#.# #.#  # # # ..... . .  .... .... ............  ... . ........  ....   .  . .. #. ......#..  # #..# ## #### ##.##.#  . # #.#.## #....#..##.#
#...#.  #.   .#.# . . # ##.#### ##.#.#.#####.# # ### #.###.#.### ###.# ## #.# ##.#.#.#.#. ### ##.##.##.#..#.#.# #  .   ... .#.##    .#.#.  #.# .#.#..#
#.# .##.#####.#.#.##.#.#.#....#.#...#   .. #.#.#.#.# # ...# .#.###.## #.#.##.## #.# # # .# .  .#.. . #.#.# .#.#.########### ## #.#####.####.##.## ####
###.#..  .  . # #.## #..  .###...#.##.####.#..# ##.#..####.# .. . ..... #.......  ..  .# .##.#..# #.#..#..#.#...  .. ...  ..... .....  ...  . .. ..  #
#....## ##.# #..# .. ..# #.#..#.#.. .....  ..#.    # # ... ..## ###.##.#. ##########.##..#.#.# # #..##.#.#. # ##### ### #.##.#.##.#.##.## ##.#.#.#####
#.#.#. .#. #. #.#.##.## #..#.#. ##.#.#.# # #...###.#.# ##.##.#.#..... #.#..  .   . ... #.# . #.  .#. #.#.##.#......# .. #.#.#.##.#.##.# #.# #.# #   .#
##.#.####.#.### ##.#    .#. ..#..##.#.# #.## #.#.# #.#.#  # . ...#### # #.## #.#.###.###.# #.#.#.#..#. # .. #.####.# ###.. .. . .... ...# #...#.#.## #
#..... ..... . . .  .####.#####.#  . ........#.# #.#.#.##  #.###.    .  ..# .#.# . #.#. .# #.# .#.#..#.#.###.. ....#.. .# ##.#######.##.#.#.#.#..#.# #
#.#.# #.#.##.# ##### . .... ... .#.#.#.# # # #...#.#.#. #.#..#.### #.# ## .##.## ##.  ##.#.# # ##.#.##.#....#.##.# # ##.#.#.. ....  ..#.#.#.# ..## #.#
#..#.#.#.#..#.# ...#.#.#.#### #.#..#.##.#.#..#.###.#.#.# ..#.. . . #.#  #.#..   .#.# # # #. .# ...#.# .#.##..  #.# # #..#.############ # .#..##....  #
#.##.# #  # #.#.#.#..#.#.#....#.## #...  ..# #.#  .#.# .#.## ##### #.#.#.  # #.#...# #...### # #.#.  #.#.# .#.#..#.#..#.#... ..  ..  .. # #.#.  ######
#.. .#.#.#  #.  .#.#.#.# # ##.# .#.# ######. #. ## #.#.#....=  ..#.# #..#.#.# #.####..##..     . .# #..#.###...#.#.#.#  #.#.########.###..# #.#... ..#
# ####.#..#.### ## #.#.#.## ###.#..# ..... # ###.# # .#.#########.# #.###.#.......  .# #.#### ####.. #.# . .#.#..#.#. # #..#.  ....# . .#.#.#.#.######
#.... .#.#. ....#. #.#...........#.#.## ##  #...  ...# .   .... .. .... . .### ## ##.#. ..... .. .#.#....##.#.##.#.# #..#.#..#.#.#.#.# # .#..##   .. #
#.#.##.#.## #.#.##.#. #########.# #.## #.###.######## ################### ##.##.## #.#.# ##########.##.#..#.# .#.#.#..#.#.##.#.# #.# #..#.# # ..##.# #
#.##.#...  .. ... .#.#.   ... .= . .... ..... . ... .. ...   ...   .......#  . . . #.#.#.#. .. .. ...#.#.# .#.#  #.#.# .#..#.## #.##.#.##.#.#.# #.##.#
#....#.#.#.###.## #.  # # #.#.###.# ##.#.##.###.# ## ##.# ### ######## ##  ######.##...# .####.####.##.#..#.#..# #=#..#.# #. ....... #.# .#. .#.#....#
######.##.##.##.##.#.#.#.# .### .##.# .###   . #.#.#.#.#.#..#. . . .  # # #...... #..# ..#     .... #..#.#.##.#.#.##.#.#.#.#####.####.#.###.###.######
#  ................. #.#..#  ..#.#. .#... #.### .  .......#.# #.###.##..#..# # ##..#.###..#### # ##  #.# #. . .... ....... ..   .... ... . ...... . .#
#.##.#.#.##.## ## ## #  .#  ##.# .#.# .##.# . .#.#####.### .#.#.#..#..#.# #.#.#.#.##  .# #...#..#.# #. # .#.# #####.# ###.### ## #.####.#.##.##.##.#.#
##.#.#.#.# #.#.# #.# #.# ##.#..#.#. .#  #.#.###   .. .#.. #.#.##.#.#.#..#.    ..#.#..#. .# ###.# .#  #.#.#....#.  .. # ...  # #..##. .##.## ## ##.#.##
# .## .# .... . .  #.#.#....####  # #  #..#.  .#.# #.##.## .#........ # #=#.##.# .##..## #... .##.#.#. #..# #. #.##.##.#.#.#. .#... #... .. .. ......#
##...#.#.###.# ##.# .#..# #... . # . #.##.# ##.# ....... .#.# ##.##.#.# #..#.# .#..#.#.  # #.#....# .#.#.#..#.#  .#.#... . .# #..# # .#.#.# #.# # # ##
#..#.#.#.#.#.#.#.#.#.#.# # .#.# ###.#.#.###.#.##.##########.##.#.#.# ##.#.#... #. ##..## .#.##.#.#..#. #  # #. # #..#.## #.##..#.##.#.#. #.# .#.#  #.#
##.## .#.#.#.#.# #.#.# ...# ##.# #..#.. ........ . .. .   .. .  .. ...  ..#####.#.#. #...#.. ..#..# .# # # .#.##..#..#.#.#.#  ##... # #.#...# # #.# .#
#.  .# # #.##..#.# #...##.#..   ..#  ##.#.#.#######.#.#.# # #.## ## #.# #.......#.## ###..####.# #..##.#..#...#..#..#....#. #.. .# #..# .#.#. . #. #.#
##.# #  . ...#. ...# #.#.#.######.# # .# ..# .. ..#.#.##.#...#...#.##.##  #######..#. .. # . #.#..#.# .# #..#..#. # #.##.#.#..###.#.#.#### ###.#.### #
## ###.### #.. ###.#.#.. . ... ...#..# #.#   ##.#.#.#.. ..# #  #.#.... .#.#.......#..###..#.##  ###..# # .###.#.###.###.## ##............ ..= . . ...#
#   .. #.# #.#.# ..#.# ##.##.##.## .#..#.#.# #.# .# #.###.#..#.#.####.##  #.# ###..#.#.. ##.#.o#....# .#.#. .... ..... ... .#.#############.#.# #.#.##
# ##.#.#.#...#.# #.#...#..# # #.#.#..#.# ### # ###.##...... #. #.   #. .#..#.##.#.##  ##.#...#. #.#  #.#.#.## #############.#... ..  .....# ##.#  #..#
# .#.#.#.#.###.# #.# #  #...#.#.#.#.#...  . ... .... .#.###..#.######.# # #...  . ...# # ##.#.##.## ##.# ##.#. ....... ... .#.##.##.##.###......#.#.##
### ##.# #.. ..#.#.#.# #.#### ###.# ####.######.#####.#.# #.# . .. .. #.#  .##.### # #.#...   . . ..  .... .# ##########.##.# #.#.#..# .  #.# ### #. #
#........  # #.#.#.#.# . . ... ..... .  ...... .... #.#...#..# ## # #.#.#.#..  #   #.#...#.## #.#.#.#.#.# ##  .. .  ...#.#..#.#.... #..##.# #.#...#.##
######################################################################################################################################################
