########################################################################################################
## #.# ##.## ##.# ##.# # # ###.## #.#.  .   ..#.#  . .    ..    .   . .  . .  . . ...    ...   .       #
#. ..    .    .      #.     #. ...#.#.##### ### # ###.# ##.## ###########.#.#.### ###.## ## ###.#.# ## #
############## ## ### ####.##.####.. #    # #   # # # #.#.# #  .. ..... #..#.#. # # ##.### ## ## #..#.##
# ....  ... ..  # #    ..  .. .. .#.##.####.### #.#.#.#.#...  #.###.#.## .#  #.# .... .= .   .   .#.# ##
## ### # ## ## #. # #### #.###.#### ..   .    ..# # #.#..####.# #  # #..#  #.# .#.#.#.# #.# #.#.####   #
#. #. # #.# #.. #.# # ...#.#  #  o ###.# ## ### # # #.# # .  .# ## #.## # #. #.##  # #.#. ## #.## # .###
## .# # # #..# ##.#  #.# #. # # ##.#  # #.#.# # # # # # # # #.#. # #. # # ## # #..# .#  #     .  . #.  #
## ## # #.#.# .#  # #  #.#.#... #. # ##.# #.# #.#. .# # .# # #.###.#.## ##.# #. #. # # #  #.#.###### ###
# .# .#.#.#..#..# #  #.#.# #.##  #.# #  #.# ..# #.##  #.# .  .    ..   . .. .  # .#  # ##.#.# #     .  #
## .# #.# #.# .#. #.#..#.## # # #.## ## #. ###. #   # #.##.# ## ### ########## .# ##.#  #.## ..## ##.###
#  # .#.#.# .#.##.#.##.#. .  .. .  .    #.# ..# #.#.#.#. .# .# # .# #  .   .  .##  # # ##   # #. . #.  #
##  # #.# #.#  .# #..# #.## # ## #.# #.#. .# ## ##.##.#.#. #.# # ##  ### # ### #..#  .    # #.#.# #. ###
#..## #.#.#. # # .# #..#.. #.#.# # .#.#.#.#  #.  = .. #.#.#  #.#.  .#. # ## .#  # # # #.# #.#.#.#.## . #
##  ....#.#.#. .# # ##.#.## .# ##.## .#.# .#.## #.# ### ## ###.###### #.# # ## # #.# # # #.#=# #.# # ###
#..##.##. #. # #  #..# #. .# ..  .  #...#.#   # #.#.#     ...  ... .. .     . .. . .          .    #.# #
## # ##.# #.##.#### # # ####.######## ### ## ## ##.#.###############################################.# #
# . .  .#.# #..      .   .   ...  .   .   .. . ..        ..    ..  . . .  ... ...      .   .. .. . . . #
#########.#.##.###.#.# # ##.##.#.##.#.## # #### ##.# ##.## ### # ## # ### #.###.#.#.## ### ###.## # #.##
#. . ..   #  #.#  # # # .# #  # # .# # ## # .. # .# #.#.#.##.## #  #.#. .# #  # ##.#.# # .#   #..#.#.. #
#.#.# # # # # . # # # .#.  ## # ##.# #..#.# #.#..#. # # # #  .. ## #  ## .  # #..# # ## #.###.#.##.#####
##.#.##.# #.## #..  #.# .##  ..  # # # #  # #  # ## # # # ## ##... # #.  ####.#.# .    ......   . .   .#
# ....  # #  #  # ###.###.# ### # .# # ##.# #.# . # # ###  ## # ##o#. ## #    # .##.##### # #.## #### ##
##.# ## # #.#  #  .   . ....#. .##  . . # # #  #.#   =..  # = .. #=# #.# ## #.#.# #  .. #.#.##  #  ..#.#
# # # . #.# .#. ############ ##. #.# ## #.#.# ## # ####.#  # ##.#. # #. ..# # #.. #.#.##  # . #. # # # #
# #.##### #.## #...   .  ...... ##.# #. # # # # .#... #.#.# # #.###.. ##.##.# # ##  # # # #.###.# ## # #
# ... .   # # .#.#.##.## # ## # # . #.# #.#.# ##.# # #  # # # #....# #.. # .#.#.. #.#   #.#  . ....  . #
#.##.#### #. #.#  # # # ##  #.#. #.#  # # #.#. #.# #..# #.# # #.## #.#.#  # #.#.##.#.####.##############
#.#. #   .# #  # ##.###.# .#  #.# .# # #..#.# # .##.## #..# . # # #..# # #  # #.  ....   =  .   ..   ..#
#..#  #.#.# .#.#.... . . ## ### ##.  .  #.#.# .#   ..   # #.#.#.#  #.# # .# # #.## # ####### ##.##.# #.#
### ##.## #.## #.##.## ##.  . . .# # # #. #.#.##.#.## ### #.# # # #. ###.#.##.# #  # #  .    # ##.# # ##
# . =. . .  #   ## ## # # ######## ## #.# # # # .# .#.#.. #.#.#.#  #.        .#..#.# #######.#.#.. . .##
#####.#####  #.#. . . .. . ..  . .o.....  #.#.## # #. #.# # # #.# # .#.## # #.#.#. #.  . . # # .# #.#  #
#.  ..#   # # ..##.# ## ## ###.# # ###.##.# #  #.#  #.# # # #.# # .# .## # # #..## #.# # ##  #.# #.##.##
#.# #  ##.#  # ## # # ## ###.##.# ## ## # #.# # .#.#. #.#.# # #.#.#. #  .. #..#. #.# #. #. #.#.#  ... ##
#.#.# #.#.# ## . . ..     . .      .    # # ##.#.## ## ## ###.# #.## ##.##.#.#  # .# # # .# .# #.####..#
# #.#.#.# #.#  ### ##.# # ####.#.# #.#.#..#.. . . .   .  .     . . #  # # .  .#. #.#.#  #. # # #..  #.##
### #.# #.#. # #. #. # # #.   #.# # #.  #.#.### ##.# # # ## # # ##.#.## ##.### .# .# .### ##.# #####. ##
#. .# # #.# #  ## #.# .# # ## .  ..  # # .#.# #.#.#.#..#.# # #=#.##  #  .# # ##  # # #   .# .#  . . # .#
# #.#.# # #..#..#.# .# # #.#  ## ## #   #.# # ### # ### ..     ..  #  ####.#  # ## #.## # ##.#.# # #  ##
##.##.#.# #.#. ##.#.#  #.# ##. ### # #.## .  ..... . ..# ##.### # # .#.    # #  #..#  # #..# #. #.# # .#
# . ....# # ##.#.   .# #  #.#.#   ...# # ## # ## #.# ##  # ## #=#. #.#.#.# # ##  # #.#  # #. # #  ..  ##
#.###.##. #  # .### #... #. . # ## ##  #. #.###.# # ## #.#     .#.# .## #  #  #%##.# .# #. # # ######. #
# ..# #.#.# #  #. ..## # ## # .# #.. #.#.#  .... . ..  # .#### ##  #   . # #.#..#. # # .#.# .#  .  .# ##
#.##   .#.#..#.#### .# #  # #.#    ### # .#.#######.#.#  #     #..#. ### #.#  # .# #..### ## # #.##.# .#
#  ##.## .#.# .   #.#. # ## #.#.## #   # #  #   ..  # ##. #####.#..#.# .#. #.#. # .# #....   # .# # # ##
# #   . # # ##.####  #.# # .#.## #.### #..# #.#####.## #.#.      .#  ## ##.#  #. # #  ## # #.#.# .# #. #
## ## # # #  # #    #  #..#.# .  .. .# # #  #  .  #.   #.#.##.# # .#..  .# # ## #.# ## ##.#.## ## ###.##
#.    # #.# # .####.#### #.##.#######. #. #.#.## ## ####. #  #.# .#  ####. #  .. ..... ......  .   . ..#
# ###.# # # .# .. . .... .    .  .. .# #.#  # #  #  # ...#  #   # .#.  . #. #.# # #.##.# #.## ###.# ####
### # #.# #.#  # ##########.#.## ####   . # #..# ##.# ## ##= # #..# .### # #.#..#. #.##.# #.##   # #  .#
#.   .#.#.#. #.#..... .    #.#  #..  #.#.#  #.# . # #. # .#.#. .# .#.#.. #....#.# #   .  ..  . # #. # ##
## ## # #.# #  #############.## # ###.#.# # ## ### # ## ### ##.#.### ##### ### # # ########.##.#.#.##  #
#   # ### #. #. .....     ..    ..  ...  .  . . .  . .. ... ....     .   .. .  ...       . ###.#.#.#  ##
##.#  .   # #. ##.#.###.#### ## ## ##.####.#.# ## # # # ###.##.# ##.# #.#.## ## ##.# # # # ##. #.# .# .#
# # #.## ##..# . #.#. # #  . #.#.### #.  #  # ## #.# #.## ### #.#.## #.#.#.##.### #.# # #  ..# ### ##.##
#   .. .## ##..###.## ## ###.#.#  .  # ### # .    ..    .  .  =  ..    .   ...       .. .# #.#      .. #
## ##.##  .. #.#   .   ..... #.#.# ## .#..  # # ###.# ##=#.# #.### #.### ## # #.#.###.### .#.# ##=#.# ##
#...# #. ###.#. # ##.## # ##  .# #.###  ## #.# #  #.#.#.# #.#.#. .# # . #. # .# #.# .. ..#.### # # # #.#
##.#  ##.. #.# #..# #. # # #.## .#  ## # # # #.# #  # ..    # ###\#..## .# .#.#.#..##.#.#.   . ...  .  #
## ##  # #.# # .# # # #. # # # # # #. .# #.#.# # ##.# ### # #.   .# #  .# .#  #.#.#. .# .# ## ## #.##.##
#.# #.#  .## #.## # #. #.#.# # # ## ##.# # #... ... #.# #.# # ##### #.#.##  # .##  ##.# #  #.#.# ### #.#
# .....# #. .#. .#  #.# .. #   # . ..#.# #  ####### # #.#.#.# #. ...## ..# #  #.. #.#.#..# #.  #.. ..#.#
#####.#. .## #.# .# # .# # # # # ## # .# #.#   .....#.#.. #.#  #.##  .# #. .#..##.# ..###..# ##. #.##..#
#..   .# #. .# #.#..# #  # #.# #..#  #= .#  ##.## #.# ####.## # #.# ### ## #  #.#.#.# .  #.#.# # ## ## #
#=#.# # .### # ##.# #  ###.# ###.#.##  ##  #. #.#.#.#      .  .  ..      # .# # #  ## ###  #..   ...   #
## ##  #   # #..  . # # .. .. .   .  # # #. #.#.## .# ##.#.# ## #.# #.#.#  #. # #.#. . ..#  #.## ###.###
#  .. #..#.#.# ## ### .### # # # ##.# .# #.#..  ..# # # #.# ## # ##.#.#  #. #.#   ### ###  # #.# #. ##.#
##### .# # #.#.# #  . #.  #..#  #.# ## #    # # #.# # #.     ..    .# #.#..#.. ##.  # #.## #.#.#.#.# . #
#.. ..#  #.#.#.#.####.### ##.# ## #  # .##.## ## #.# # ##### #### # # # ##  #.# #.# # #.. .#   #.#..## #
######.# #.# #.#  ...        # #. #.#..# # . ..   ..   .   #   .# #.#.#  #.#  ..# #=#. # # #.# # # # # #
#   .... # # #  ####.##.# ## #..#.# ## #.# ####.###.#.## #.##### #.# #.### ##.## #.#.## #. #.##  # #...#
## ##.## # # # #. .. #.#.#.#.#.# .# .# # #.# ..#. #  # #.#    .   .. ... .   ..  ...     # #. .# #.### #
# #  . #..##.# #####  .. ..#.#..#.# #=.  # .## #.#  #  ..# ### # # ## # ### # ## # ##.# # .#.## .#..   #
#. ##.# .# . #  .  # #.#.##  # # . ..# ##. # . ...#.#### #.#.##.# ##.#.##.## # ##.# ##.# #.# # # #.#####
# #.#  #  ##.#.#### #.#.#.### # ##### .# # .## #.#  .  # # #..  .        .   . .  ..  ...  #.# # # #.  #
# ..  # .#   # .. .   ..    .  .     # # # # # # ## ## #.#.#.##.#.## #.## ## ####.## ## ##.# # #    # ##
##.##.## .##  # # #.## ## ##.# #### # .. #.#.###  # # ## #  #. #.##.# #.##  #. . #  #   .# # # #.## # ##
#  #  .# #. .#.# .## ## .# #  #  .#..# #.# #   . #  # # .#.#.#   . .  #  #.## ##.# #  # #..#.#.. # .#  #
##  # #. ###.  .#    .# ##.#.#  ## .## ##.. ## #  #  . #.#.#  # ######. #  #. .# # .# #..# #.###. # #.##
#  # ..#.. # #.# .#####.#..##.#   #......# #..## ## ##.#.# #.#  . .   #..# ##.#  #.#..#.#..#...#.# .#. #
##. #.#. # #  #.# .  ..  #.  .# ###.#.#.#  #.# ..#. .#.# # # .# ####### #.  # ### ..#.# .#.# ##   #.#.##
#  ##. #.#.#.#.   # # # #..#.# .#. .# ##.# # ### .# #..# # # #  . . ..   # #. .. #.## # ##.# #.#.#  #..#
##.#..#  ##.#.###.##.# #.# ##.# ### # .  #.#.. ..#. .# # # #.########## ## ## #### # .# #     .# .# # ##
#.  #. #. .  ...#.. .  .....  . ..# #### #  ## #  # # #..# #  .    .       ....  .. # #..# ## #  #..# ##
##.#..# .##.#.# #.#.#.#########.##. .  #.# # # #.# ... # # .# ## ###########.# # # #..# ##.#.# #. # # .#
#.  #  #.# # #..#. # #.... . ..##.#.# #. # # #.#  # ###  #.# #.#  .   . .  #.##.#   # #.# .# # #.#..#.##
## #.##..# #..# # #  #.###.### #   .#  # # #   # #..# ## # # # # #####.###.# ..  # #..#  #.#   #. #.# .#
#..#. .#.#.# # .# .#.#.#..  .# # ## ### .#. ####.## #..# # # ..# #.  . # . # #####.## #.#. #.##  #..#.##
## # ### #.   # #.# .# # # ## .#  #....# # #.   .  .#.# .#.### # # ###  ## # #.   . ###  #.# #.# .# #. #
#  # # ..#.#.## #  #.#  ##.# #.# #. ## #.#.# ##.#.##...#.#  .#.# #.# #.#.#.# # #.# # .. #. #.#   #. # ##
##.# # # # ### # .# .# #     # #. #.# # #..#...# #.#.##. #.## .# # #.#.#.. # # #.#..###. #.# ###. # #  #
#  #..## #  ....# .#.#. ## ##  #.#. .    #=# #.# # #   # #.# # ## ## ## ### #.#.## # .  #. #. .#.# ## ##
##.#.#  .# # # #. ## #.### ###.#..# ## ##..#  ## # # ##..# #.  ... ......     . .. # ##  # #.##  ..    #
#. # .## #  #.#.#.# .##.# # ## ###. # ## # # #.. ..#.#.# #  ######################.### ###.#.# # #######
##.# #...# #....   #.   ..    ... # #.   . #.# # ###.# # # #  ....     ...  ..    ..      ... .# . .  .#
#  #.#.#.# # ##.#.#. #.# ## ##.#.#. .# # #.# # #    .. #.# .###.##.# # ### ####.#### #.# #.## #  ##.#.##
#### ###.#  ## ##  #.#.### # ## # # # # # ## ### ###### .#.#  # # . #.## #  o # #..# ## #  ##..#.# # #.#
# .    ..# # ...  ##.# .  .   .  .# #    .. .. . ...  .# #. # #  #.#. ...  ### . #.#    .#  .# # .     #
#.##.#.# # .# ###.# .# ## ## # # #..#.# ## # ########### # # . .#  .#.## #  ..# # .# #####.#.# # #.#####
# #.## # # # ## #. #.##.## ## #.#.# ##.#.#.# #.  . .. ...# .### .#.# ## # .####..# # #.  .. #.##.#..  .#
#.# .. #  ..  .  .#  .   . .  .  .  .    # #. #####.#### #.#    ##. . .  #.#.   ##.## ####.# ..  # ###.#
#.# ## # #.## # # .# #.# # #.#.#.## ##.# #.# # .. ..# .. #..# #.#..# # ##  #.##.# ..    ..  #.## #  .#=#
########################################################################################################
