################################
#.#.   .  # #  . #   #.# .#.   #
# ### ##### #### ### #.##.##.###
#..  . . .   .. ...   \. .. o. #
### ##.#######.#.## ## ## ##.###
# .#   #      #.# #.# ##.  #.# #
##o### ### ## # #  =    # # .# #
##.  #..  # # # # #.# ###. #   #
#%.#.# #### #.# # # #.# ..#. ###
## ###.# .      #.# #  ##.##.# #
#.     ##### ## # #.# # # .=#  #
# ##.#..  .#.#. #.#.# #.#.#o# ##
###.# #####.# # ## # ##.#.#.# ##
#     .  =..  . ......   .#=  .#
# ## # ## # #.# ## #o#.##.#.## #
################################
