####################
# ## #o#  #.#.....o#
#.  ....\#.  # ## ##
########.##.# .#. =#
#...  . ....### # ##
###.# ##.## ..  .= #
#. ...... #.#####=##
## ## #%# #.....=o #
# .  . .#o..#.#.#.##
####################
