########################
#o #.# #. #.#.#.##.##.##
## =... #.#.... ... ...#
## ## #.#.o.##.#.#%#.###
#=#.###.#.#.#.#.#.#.## #
#o .... # #..o  \..... #
#=#####.#.#.####.#####.#
# . .=. # #.#. . ..... #
####.## ###.#######.####
#    # .... ... .......#
##.# .#.#.##.# ##.#.##.#
########################
