###########################################################################
# # ##        # #.  ..          .     #.#  #.=    #...  .   #  # # # .  # #
#  .   #.## #.#  .# ## ##.#### # # # #= .#.# # # #  #.# # ### ##.# # #### #
## # # # #  # # ##  #    # .  # #  #  # #  ## #.. #.# # # #   ..        . #
# # # .# .# # # . # .### ####.#.## #=##  #  .  # ## # # # ######### ### ###
# # ## #.# ## # # # #              #==  ## ##### #  #.# # ..   .  ..      #
# #. #  ##    #.# # # ### # # ## # # ## #         # #.# # # ##.######### ##
# # ## #  .## #.# # # # .#  #  # # #. # # # # ## ##.# ..#.#.# #.    ...# ##
# # .  ### .# # # # # ## # #  #  #.#.# . # # # # #. ##.#  # # # ### # #   #
#  ###   #.## # # # #      .# ## # # ## #         #     # # #.# #   # .# ##
# #. # ### # .# # #.# ##### # .#.#.  .# # # #### #  ####  # # # #.## # # ##
# # ## # .  # # # # # #   # . # ## # #  # #    # .#.    # # #   .         #
# #     ##.#. # #.# #.  #.### #  . #  #.## ####  ## ##### ### ########### #
#. # # # #  # # #.# # #.#  ... ###.  #  .  .   #   .   .      .   o  .   .#
#.# ## #.### ## ### # #  # ##.#  # #  # ## ## #. # ## ##.#.# # # ### # ####
#                   # # #.## .#.#    ## # ##.# #.#.   # # ## ..# # # ##.  #
# #####=# # #.## ## #     . # .  #=#.#         #  # #  .     # # #  #.# ###
#   .    . #   . #  # ### # # # # .# .## ## ## # # # #########  ## #.   # #
# #### # #..# ##  # # ..   #  # ##.# # ### # #.#.# .       . . #   ####. .#
# #    # #.## #  #   # #.# ##   .# # # .      .#  ########## #  ## . .# ###
# ##### ## #   #  # #        # ### #.# ##.## # # ##  .       # # = #.# .#.#
#    . .  . # ##.#  .#.##.##      .# #  # #  # #  . ####.# #.# ### ## #   #
# ## ## ## #. #  ##.#.# ## # # ## #  ### # ### ### #   .# #. #        . # #
# # # #.# # #  #        .  # # #  .#     .      =  # ## #  ## ########## ##
#   # #.# #.#.## ## ## # ##   ## ## ########## ### # # .# #.     .    .  .#
# #  . .  . # #   # # # ##.# #..    ..        .    #. # # # ##.# ## #.### #
#.##### ## #   # #  # . .  .  # ################## # #.## ## ## # #  #. # #
#.    # # . # #. .# ######## #.# o. .=.     =.. .                 # #  ## #
#.### #  # ##  # #   .     ..  # ####### ### ##.## #.### # ###.# #   #= . #
# # # # #  #  #   # # ## #.## # .# .. o. #  # . .# # #. # #    # ## ## # ##
# # . #  # .# # ###.###.# ## # # #### ##   # #### ## # #  #.###   #.  .# ##
# .## # # .#  # #.       ..    #  . # # # #    .     #  #      # ## ## #  #
# #   #. # ## # ### ### ## ##.#  ## #.     ##### # # # #  #.## # #  #. # ##
# ### # #   #   =.#   ### ## # # ## # # # #     # #  # ## # ## #.##  #    #
#   #.# #####.### =.#      . . #    # # # # # ##   # #   .#     ..#.#  ####
# ##  #.     #    # # #.#### ##  ### ##.# #.## ##.#.# ###. ##### ##  # # .#
# # # #.##### .# #  #.###  # # #    ..                 .# # ..      ## # ##
# #  .# # .  # #..#      #.#   # ###.## ## ## #### ## ## . ## ##### # o#  #
# #### #.###   # ## #####  # ### #     # .# .#  ..# #  .# #  #    # ##.# ##
#  .   .     #   #  #    # # #   ## ## ## ## # ####.## #  # #  ##.# .# #  #
# ## ## #.## # #. # # ###  # # #                .       # # .# # ## #  # ##
# # # # ## ##  # #  # .  #   # # # #### # # # # # # ## #  # #  ..   .# # ##
# #    ..    #=   # # ## # # # #.#    #  # ##.# # ## ## # #. # # ## #.    #
# # #########  #.#. # # ## # #.# #\### ### # # #     . .#.# #. # #   # # ##
#  . .   .   # #  # #     .# # #      .    . =  # # ## #  #  # #  # #. #  #
#.## ###.### # # #   ##### # # # ## # # ## # ### # # ## # #.# #.###  # # ##
# #    #   # # # .# #    #.#.# # # # # # # ### . . ..          %  . ##.## #
##.# ##.### ##.# ##.## # # ## ## # # # # # .  # ### # # ### ### ####      #
# .      .         ..      .    .#.#     # ## #.#.## ## #   #     .# # ####
# ## ##### ### ## # # ## # ## ## # # ### # # ## # ..    # # #.# ## #.  #  #
# ##.# . ##  # #.# # ## #  ..# #   # # #.       ### ### # #  .# #. # #  # #
#     ## .# #.       .   # #.  # #.# # ##### ##   # # # # #### # ##.## # .#
## #.#   #  ## ##### ##.#  # # # # # #     . .  ##. # # #   .         = #=#
#    #.#  #  # #.   # #  #.# # #   #   ### ## # # #.# #.# ### #.### ## # .#
## # # #.#..#  #.##   # #  # . #.# # #.# ## # #   #   # .##.# # #.#..#.## #
# .# # #  #  #  #.# ##   # # #.# # # # #  # #. .#.####  #.    # # ####.. .#
## # # # ##.#  ## # ## ##  # # # # # # #.##.### .     #   # #.#       .# ##
#.## # # #   #  .  .     # #.# # # # # #     .# ## # #  #. .    ## # #.## #
#    # #  # #  ## ## ## #  # # # # # # #.## ### .## # ##.# # # #.## #     #
##.#  ## ## ## # # ### # #.# # #.#.#.# #        # . .    .     .     #.# ##
# ## # .   .       .     #.# #   # # #  ##### #.# #################### ##.#
#  ..# ## # ##.## ## ##.# .#   #.#.# # # . .  #  .     .   ....  .        #
###### #.# #.### #.### ## ## #.#   # #.###### # ##### # #.## ## ###.# # # #
#... . .           .. .  ..      # # #      # # #    . # #.# #     # # # ##
# ##### #####.###.##.# ## ## # #   # # ## ##  # ##### #      ## ## # # #  #
# #   # #   #.# ## #.#.. # # # # ##. # # # ## #   . # # ## #. # #  # # #.##
# # #.# # ### #. . #.# ### # # #   #.#   #. #.# ## #  ##.# # ##   ## # #  #
# #  #        # ### ##   . # # #.### # # # #  #.# # # .    #.#  #    # # ##
# # #  ####.# #        ##### # # #   # #.   # #       # ## #  # # ## # #  #
#.# ##.     # ##### ##      .  # .## # # ##.#   ## ##  # #.# #  .### # # ##
# #.   # # #.=.    #.#=###.# ##  # #.#.# # ## #  # #  # .#   .# #.#  #.#.##
#  ###  # # # ##.# # #.# ## # ##.#  .# #.#.   # # . # #.#  # #  .  #.#  . #
# ## # #     . # #.  #.#  .    . ###.# ## ##### .# #     # # ## #### # ####
#    #.  # ## #==# ##  .# # ## #.    ..      .. # . # # # .#.     .     . #
###########################################################################
