####################################################
# #.# # #.# #  #.## # # #. .#. .# #    # # #  #    #
#   . #.# #  #.#.      .. # # ##. # ## # #  #.# ##.#
# # #.# # # ## # ### #### #    .#  #.. #.#.## # ##.#
# ## ## # #    # #  #   . # ###.# #  # .           #
#    .  # .### #  #.# ### # #   #  # #.# # # # ### #
### ###  .#   .# #  #   #  .####  #  #  ## # # # # #
# # . # #  #.#.# .# # # # # ..= #  # #.#   #. .  # #
# # ## =#.#.## # ##.## # ## #####.# ## ####.##### .#
#.   .# # #        .  .        . .   . .   .. .  # #
####### # # # ## ####.##.#.#.# ## ## # ### ##### # #
#.  . = .  #     #   # #  # ## #    # # .. #  .    #
### ## ##o#  # #  # #  # #.      # #  # ## ## #### #
# . #.  # .#.  # ##  #.#  #### ##.  #   .#        .#
# #  #.#  #  ### #..#  # #..   # #.#  # #  #.#### ##
# #### ##  # #   .# .# # .# ##   #  #  # #  # . # ##
#....     ## ### ##.## # # # #.##  ## ## # #  # #  #
## #### #      #.#.     .#   .   # #.    # ## ## .##
# #     #.#####. .#.#### ######### ##.###   #   #. #
#  .## #       # # o#. # .  .   ...  .   # #  ## .##
# #.#.#.# # ## # ## ##.# # #### # # #.## #  #  .#  #
# #    .# # #.##  #  . # #.#   #.  # # # # ##.###.##
###.## # .#.#  . ## ####.#.# #  # ## # ##  .   .   #
#.  ..# # #. #.#.#  #  .   = # #     .   # ## # # ##
# # # # # .## #.# ##.### ### # ## # ####.# # # #  ##
# # # # #.# .  =.   .  ..# .    .   .   .#   \  # .#
# # # # #.######### ##### ##.# ######### # ##### ###
# # # #.#  .   .           .               .  . ...#
# # #   #.# ### # # #.#### #### ## ####### # ## # ##
### ### # # # ## #  #     #     #.#   .   #  . # # #
#   . # # #.#. .  # # ###  ## #.# # #####. # ##  # #
#.# ##  # # #### ## # . # #   # # .   .   #  ###.# #
###   # # #    # #  ####  #.# # ###### ##.### ## # #
#.  #.# # # ## # ##  .  # #   #   .=         .     #
# #.### #.#. #.#  #.## #  . # # # #.# #.###### ## ##
# #  .  # # #.#  ## #.# # ##  #  # # # .#.    ## # #
#.# ##.## #    #.#  #   ..# # # #. #  #  # ##      #
### # ## .# ###   #.#####.#   #  #.  #.## #.#.######
#       # # #..# #. . ..  # # # #  #          .    #
# ##### #  # # #.##o### # # # # .# # # ###### ### ##
# ..  # # #  ..     # # # # # # # .  #    .  .  .  #
#.####  # .### #### #     # # # # ## # # #.# # #.# #
#.  . # # #  # #     ## #.# # # ## # #.##.# # #.# ##
# ##### # ## ## ### #   # #   #.  . .  . .  .      #
#    .    . .   ..# # #.# ## #  ####### ## ## # # ##
# ##%###=###### ### ## ##    .# #      # # #  .#.# #
## #. .# #  . . #.       .# ##    # ## #  . #.#  . #
## # ### .#.#.#  ## ###### # ## #.## # .## #   ### #
#   o    # #.## # #          .#  .     # # ##.## # #
######## #     .  # ### ### ##. ### ##.# #  #      #
#.   ..  # # ## # #  .# #.   .# #. .       #  # # ##
####################################################
