##########################################################################################################################################################################
# #         .    .#    . .      ...     .   ...    . #.  . ....    .#.      .  # #.#  # #  #.. #.## #.# # # # #     .## ## # # # # # # #.## # # # # # ## # ##   # ## # # #
# # ### ## ###.##.########################## ####### # # ## # # #.#.  ## ## # #  #.#.##..# # ###    .   .    .# ##.#.    .         . . .   .     ..    .  .  #.#     . # #
#      .     .      =     . .    =   . .     .    .  # # # ##.## ## # #.## ## ##.# # #  #.       ######=# # # # ... # # ## # # ###.## # ## # # # # # ## ## #    .# # # #.#
### # # ## ## # # # #### # ## ## #.# # #### ### #.##.#  .. .    .     . .      #.# #  # #.## ###.#.      # # ##.## # #   #  ## #  .  #.#.# .  # #   #.# #   ## # # . # # #
#.#.#  . # # .## . #    #  .# # ## .#.#   # #.  #  # # ####### ##.# # #.#######  # # #  . .      # #.## #  ..      # #.# # #=  # # ### #.  ##    # #  # .# #.  # #.### # #
# # ## #  ..#  # #.# # #  #.    .  ## # ##.## ### #.. #  .      # #. # ..   .. # # # .# # ### ## #.#.# .# # # ## #   . . # .## #.  .   . # .# ## ..## # # . .# #.    .. .#
#.# ..   # #. #..# ..# ## # # ## #     . .. ..  .  # #  ##### #  ## ## ####.# ##.# # #  # .  #.# # ...#.#   .. # # # ## # .#  .# # ###### #.# # #.#.# ##.# ##..# # ## ## #
# ##### # # #.##.  #  ..  # #  # # # # # # # # ##.##  # #  ...# # . ...     .   .# # ##.#.## #.#. ## ## ### ## ##   # # ## .## #    .    .   . .  ..   . # ..# #      .#.#
#.  . .   .. ... ##. #### # # #. # ## # # #..# .#.#  ## #####.# ### ##.# ### ### # #    #   .    # #.#  ..       #.#  #   .# #.#.# ## ## #.## ## ## ### #  # #.## # #.#..#
# #.###### # # #   # .. .  .#. # ..      . # # #  ##.#.      . . ..    # #.#   #.# # ##  #.# #.#  .   # # ####.##   # ####   #.# # #. # # #      .# # # ## ##        . # #
# # #  . ##.#.##.# # ### ## # ## # ##.## #.# #..#  # #.# ######## #.# # .# #.##  # # =  # #.# #. # ###     .     #.# .   . ##  # # ## #.  . # # # #.       . # ## ##.##  #
# # .# #.      . ##. # #.#  #   .#.#   # # #.# #  ##              # .# # #   # # # #.##=. .    # #... # ###### # #  ## # #  #### #.    #### # # # #.###.## #.#.# # # # # #
# #### #### ####   #.#.#. # #.# #   ##.# # #.#  #.#  #.# # # #.# #  #.   #.#.  # # # #  ### # #  # # #  # .. . ###.# ### #.#     ## #.#   #       #    .  .#  .# # #.#=# #
#         .   .. #  .# # #  #=## #.#     # # # ##. # # ## # # #.#.# #.## #.# # # # # .# . #. # # #   .#. #.#.#.    #  ..  .### #  #    ## #.# ##.## ## # # . # .      .# #
# # ## ## # # ## # #.# #  # #. ..# # #.#.# #.# # .#  #      . .  .# # .# # #.  #    .#..## #.# #.# ##.# ##.# #.###. #.## #.  # # #..# #  ..  . . .   #   # ##. #####.#.# #
## ## # ## # # #.# # #.# ## # # # # # # ## # ## ## # ## ### #.##### #.# ##.### # # #  #       .  #    #     .#. .# #.# ##.# # ## ##.## ######### # ## ####   # #.    #.# #
#.         . . .   . .  . . .  .        ..       . .    .    . . .  ...  ..    ..#.# #  ###.##.# # # #  ## # # #.  #     . .  .. .    .         .   . .   .###  .### #.  #
##.####.# #######.##########.#.#.# # # # # ##.# # # #=# # #.# ## ## # # ## # #.# #.#  #     . .     # #. .##.## ##.# ## ## ## # # # ### ## ###.# #.# ## ##     # #   # # #
#      #      . ..        .# ## # # #.##.# # # # # # # # # # ## # ### ### # ## # # # ## ###.#### ##.# #.#          # #.   #. # # # .  # #. #  #   .  # #.#.###.    #     #
# #### .# ## ### ## #### #  .            #.. .   .  .  .          .  . .  .   .# # #     ..          .   ## # ##.# #  ## #..#..# #.## # ####.## # ##.#     #.  # # # # # #
#.. .# #. #  # # # ##.    .# ## # # #.####.####.## # # ##.# ## # ## #.## ## ##.  # # ##.###.## ### # ### #. ##.# # # # .  # ##.#               .#  # #####  .#   # # #.# #
# ###   #  #   . ..  .# ## # . .# # #    .  .. . # ## ##.#. .# ## # #  .# # .# #   #. ##. # #    ..       #.. .  .   # # #      # ## # # # #### #.# .. .  .##..#  . .#.  #
#    # # .# .# # #.#### #   .## # #.####### ######..       #      # # #.# #.#  #.#   # . #    #.### #### # .# # ## # #.   # ## # .     # # #  . #  # ##### . # # ### #.# #
######. #.### ##  . .   .# #   .# #   .   ..  .    # ##.## ### ## # # . #  .##   .## # #. # ### #. .   #  #  .#  # #  ## ## # .  ### # #.###.##.# #  .  .. # #.# #.  #.#.#
#      #   .. ...# ## #.#    ###  # ## # ## ### ## # # # # .    #   # # . #    #.# # ##. #. #   .## ##.# #  ###.#  # # # # .## #  .  #      . # #  # ##### # # #.. # # # #
# # ##.########## #.# ## # # #.## #.. # ## ##.## # #   . #.### ## # . # #   ##.# # #  .#  ## ##.#      #  #    ..# # # #  #... # # # #.# # # # .# # .#     ##  # # # # . #
# # #          .              .   # # .     ..  . .#.###.# #    . . # . #.# .= # # # # # #.    .###### # # ##.# #..#.#. .#  ## . # #.  . . #  # #  # ##.## . # #   #   #.#
# #. # # # # ## ## ### ## # #.## #.  ############# # # ### # # ## ##.#### ## ###.# #.##  #.# ##. . .   #        .# #   # .#.#  #.## ### #.## ## # # ..#  # # # # # #.# # #
#.# #. . #  ##.## # ...           #.# . .        . .     .   ..  .  .. .      .  #     # # ...# ##.# ### # # #.##   #.## ##. #       . .   .       # ##.#. #   # #  .# #.#
# #.## #   # .    . #.###.## #.###  .# #### # #### ######## ###.######## ####### # #.#.#.#.## #    #  =.  #.## # #.#    .   #  ## ## ## # ## ### # .     # # # # # # ..  #
# #  . #.#.#.#.## # #.  #. #.#   .# ## #. # # #. . . .   o     .        .     .#. # ##    .   # # #.## #.# .   #.# ## #.###. #. .#.##   .     =   .# ####   .# . # # # #.#
# # ## # # ### # # ## # # #  . ## #   .## # # ## #.#### ############## #####.#  .# .   ## ## #  . . .  # ##.## #.# . .    # #. # .  ..# ######## ###  =  # ###.# # # #.# #
# #  # # #.  . . .  .      # ## #  .##  .. #            ....     ..  .        .#..#### # # #.##.# #####   #   .#.#.##.#.# #  #   ####.# #      . # . #.## .#.. #.. #  . .#
#=#.## # # ######### # ##.#       #.#. # # .# ##.##########.##.## # ##### #.##   # .          #.#   .. # # ## ## #  #.#.# # #  #       ## #### # .##.# # #   #   #.# # # #
# # #.. ## #   . . . ##.# .#.#### #  # #.# # .#. #  . ....# ##.   #.#      #=  # # ### ##### ## # #####        . # #.# ## # ## # ##.# # . #  #   # #...   .# # #   # # # #
#.# .# # ..## # ## # ..   #.       .# .#  ..#  #   #### # #  ..##  .###### # #.# #     #.    #  #  ... # ### #.# # #  .      .  # #.#.###  # #=# # # ## ##   . # #   #.# #
#.# #  # #       #  # # #  # # ## #  # # # #. #. #.# .    # ##..  #  .     #.# #  # ##  ##### ### ### ##.#.# #.  # ### #####.# #  ..#.  #.#.  .# # #..   # # # #  .# #.# #
# #. # # #.## ###  ## #  .#. # ##.# #    #..#  ### ### ##.## # ##.# ### # #  #...#     #   .         . .     #.# #.. #       # . #### ## # #.# #.# # # # # #.#.# # #.#  .#
#.# # .#  . #.#  # .  # #  # #    #  # #   #  #       .   .   .##.### # ## # ###.# ###   # ######## #### ####.#.## # #.## ####.#  .  .   .  .    # # .    .    #   ..#.# #
#.   #  .#.#  =#.#.# ## # ##  ### # # . ## ## # # # ## #####.#.   . .        . # #   #.# .    .  .    .        .  .#.   #. =   # ## # ## ##.####.#  .# # # ### # # # # # #
#.#.# .#    # #  #.# .    #  #    #  # ###. # # # #.#  #  .  # ## # ## ## # ## # #.# #. .## # # #.### ## ## ## ###  ## #. ####.#  # #.# ..    .#   #.# # # #.# #  . .  # #
#.   #  .# ## ## #. # # # .# # ## # #  ## ###  # ## # # #### ##.# #  ..   # #. #. ##.  # # # # ##   .#.. .#  #.#.# # .=##  . # # #. #  #.## # #  # ..# # #    . # ## # #.#
#.#.## ###.# .   # ##    .#. # .  # ##   ...  #.        ..       .#.## ##.#  #   #   # #. .  # #  ## # # #  #. o.  . ##=###### # ##.### ##.## ### # ##.# #.### # #.  # # #
#.     # .  #.##.# # .# # .#  # # # .. #.# ##.# ######## ## ## ## #..# #  # #  #   # #   # # # .#    . #  # .# ### #..   .    .      . . .  .     .      .. .# . ###.# # #
###### # # #  #    .#.#.# #  ## # #.### # # # #       . . #.#   # # #. .#.#.##   #  =#.# #.#. .#  ## #.# #..# ..    ######## ##.##### #########.#####.##.# #  .#.  . ..  #
#  .   #.#  #  # # #    .  # #  # #.#  .       #.####.# #.##.# #  #. # #    .#.# # # #.  #.# #  #.# # #  .#. #.# #.#  ..   .  .  ...  .   .. .     .  # #  ### #.###.### #
#.#### # #.#..#   =  #### #  ##.     ## #.### #.....  .    .   ## # #.  # # ## # .## # # #   # ##.     # ## #. # ..## # ### # ##.# # ####### ### ##.#    #. .# # ..    # #
#.  .# # #  # .# # #      ##  #.###.#.#.#.#. ..# ## ##.##### # =# #  # #. #.# ##.#.  # # # #.# #  # # #  #  ##.###    . . ..     #.# #.        .#    .#.#  #.# # # #.##  #
# ## #.# # ## #.##. # #.# .# #  .   # ... . # #. ##.# #.       ##.# ##  #       .# # ..# ..   . #   #  # .#  #.. #=## ######### # # ## # #####.##.### #.## ### ##.# ## # #
#. #.#   # #   . ..#  # ..#  . ## # # # ## #...#.    ..# #.###.# .. #  #  #.##.# #.# #  #.##.#.# .#.# #  #  ## #   #            .         ..    .       . . .  .    .    #
# ## # #.# ## ##.# ##.## # ## # ###.##.## #.# ## ## #### ###.## ## # ##.# # # ##   #.# #.# # ## ## ##.###.# # # ##.## # #.# ## ## # # # #.# #### # # ####.##.### ##.## # #
#.=                 . .        .      . .     .    .       .  . ..    . .     .  #    ...  .   .   .     . . .      # # #   .# #  .#   # #  ...# #       #  #...   .#  # #
# # # ### # ##.## ## ####.### ### ###### ############ ##### # ## ##.# # # ###### ##### ## ## ##.### ## ## #.# ##.#.#. # #.#.#.  # #..#     ##.#..  #.# #  .#. ## ##  # . #
# ### # #.# # #. # # .. . . .#  #.#  . .    . .    .#.#.  #. ## # # . . # .   .          .# ..   .  .# # #. #    #. # # # #  # # ..# #.### #.  # #  .#   # ## # # ### ## #
# ...   .     ## #.# ###.## #  #   ## ## ### # # ##.# ###.# #    .  ### #.# #### ### # ##.# ## # ### #    #  # ##  ##.#   # #.# ## # # # # ## ##.# #.###   .    ..     #.#
#.# # # # # #       .. .   ..# .#.# .. # .  .# .  # .. .  #.. # # #    .# # .  # #.# #..     .  . .. ..#.#  # .  # #. #.# #  . .          .  . ..  .  . .# ##.# ### ##  .#
## # #.# ## # # ## # # ##.## # #    # #  ### #.#.## ## #.##.# #.# #.## ## # ## #.#     # # #.### # #.# #. #  #.# #  #.## ## ##.###### #####.#.### ## ##### # ##.#.# # ## #
#           # ##..# ##.  # # #  #.# # ##. . .# #.#   . # #..#   # #. ..   # #  # ### # #.# #.. # # # #.# #. # .# # #.      ..     .  .      .    .                .    ..#
# ### ###.# # .  # .   # #   # #.   .    # #.     # ## # .#  ##.# # # # # #. #. .. . # # #.#.### .   #.# ##  # #.#.  # #.# # # # # # ## ## # #.#.#.### ## #.## ## # # ## #
### ### # #.#.## ####### ### # #.# #.#### # # #.### ## # ## # #.    # #.# #.## # ### #.# # #o#   ###.  #  # ##     ## # # # #.# #.. #.## ##.# # # #      # # .     #.# . #
#      .. ..       ... .   ...   .  .  .  . ..   .     . .. #   #.# #   # # # #      . # . # ###   # # # ## # .#.#     .   .     # #         ..  .# #####   # #.# #.  .# #
# # ####.### # ### ##### # #### ##.# ## # # ###### ######## .## # #  .#     ...# ###.# # ###  .# # # #.#.#  ## # # # # #.# #.# #.#. ##.### # #.##  .     # #    #  # #.  #
#...   #   . # # .#       ##.  #   #  # # #   ..  .       . # # #.  #.#.# # #.#    .  .# #   # #   . ..#  #      # .# # ## #  # ##.#   . # .#     # # ##    # ## .#    # #
# ##### # ## ## #.# ## ##  . # # #   # ## ######### ## ## # #    .#. #.# # # # # ### #.#.#.# ##  # # # # #  ## # # #... .. .#.     #.# # ##   # #.#   ...# #  . # ## # #.#
# ..      ..     .     . .## #.#.###.....  ...     ..  .# #.# #.# # #  .    .   .       #.##   # ..  #.   #.# #.##  # ###.#.# # ##.# # #    # # # ##### #.. # ##   #. .. #
## ###.#.##.#.####.## ###  ..  #   # #.##### # # ## ## #..# . ### #.###.# #.## # # # # #.  . #.# ###.###### #..   .#  #.  . # # ## #  ## #.#. #.#    .#. # ##.# #.## ###.#
#.#  # ##.#.#       # . # #.##   ###.   . .  # # # .    #= .#..  .   .# # .  # # .# ##  ## # . #.#   .. ..  #.#### ##.# # #.# ##   # #.     # # # # # #.#  .        .  # #
# # #        ## # ### ## ..# # #.#   # ##.##   #..## # ## #.#####.# #   # # # .#.# .#  #.###.# ## #########  #   #  #.## ## #    # #.###.# ## #  .## ## ## ## #.# ## # # #
# # # # # # #  . .     .# #   .. # # ## ## # # # #      .. .   .  #.. # # #  #.#  # ## #  ..     . . . .    #  ### #    . .   ##   #.    . . .# #  . .        #.#     #. #
# # ### ###  ######.# # #  # # #. ..   . .  .=.#  #.## ## # #.# #.#.#.. # # # .#.# .   # # #####.##### ## #.##.# .  ## # # ##    #  ## ## # # . # ###.#.# ####.#  ###.## #
#  .   ..   #     #.# ### #.# #  # # # ## ## ##  ### #  # # #.# # #.. # # #  # #.# ###.   ..  . . .  . # #   #  ##.## # #.#.# ##.# ## #.## ##.###.# .# # #      #   .    #
#### #.####   ##.#..# .  .#.   # # # # # # #.  #. ##.# #. #.# # # # # # # #### #  # .# ## # ## ##=# #.#   # #  #    .       .   .# .     .   .   .# ##     # # ## #.# ##.#
#   .. #   .#.#   # # ### # # #  # # # #  .# ##  #   #. # # # ###=.   # .   .  # #  #  # # #.# #.# # # #.##. #  ## ### ## ## ## #  #####.## ### #.# .. # #   #  . # #.#  #
###.##.#.##.#  #.## #.  # #.# ##  .# # # #  .  #   # #.#  # #   . #.##  # ## # # .# ##   ..  .    . . .  #  #..# #   # # #  # ## # #   # #.#.   # # ## #.# ##. ##   # ## #
#   #..# #  # ## #.   # .      # #.#       # #   ###  . # # # ### ## # # # ### #.#     # # # ## #### ###  # .# #   # #  .  #       # # # .  # # . #  . # # ## # #.#    #.#
#### #.#. #    .. #.# #.# #.## # #.# # # ##... #   ..# #.    . .. ....         # .# ## #    #  #. . #  # ## ## # #=#  .#.#.### # # #.#.# #.#  # # # ## #.   .     # #.# .#
#  ... # #  #### # .#.#    .##    ## #.# # # # # # # #  # #.####.#### ## # ##.#  #. .. .#.#=# #  ##. # . #=.#. # #.# # #.#     # #.### # #.## # #.## #.#.# ###### ##.# # #
# # ## # ##.    . # #   #.#    #.#   #.#       # ###. .## # #  #     #.## # ## # # # # ## = # ##.## #  #.##. # #   #.#   # ##.#. #       .     ..  .      ..             #
#   #     #.# # # # #.#.#.#.#=#  # # # #.# # #     . #  .    # .## # #    .   .# # #     .# #.     ..# # .# #  #.# ..##.## # #.# # #####=### ##.##### ### ########### ## #
## # ### ##.### # ###.# #     .#.#.#..# # #.#=## ##### ## # #  # .     ##.# ##.# .  .# # #  . # ### ## #.# .## #   #        . . .      #.   .#  .  . ..         .        #
#  .     .  .       ..  # ## ##. # #.#       .  .   ...   #. #.#.# # # .# # .  # # #   # ## #  . .   ..#  #  #  .#. # ## # #.##### ### ## ## ######### #.#####.# # ##### #
## # #.# ## ## # # ## #  .# ##.# ##.# ###.# # ###.#### # # #.# ## #.## # ##.##.#.#. .# ## #.### ### ## # #  ## #.# #       # #  .  .      #  .         #    = . =      # #
#.# ## ##.# # ## ##.# # # #          .              .            .  . .    ...    ####.  .    . .  .    . #        # #.### # # ### ### ## ##.# #.# ## #  ##.# # # #### #.#
#       ..   .        .....# # # # # #.#.#.######.###### ## ##### ########### ## #.... ##.##.## # # # #.#.#.## #.# #.   ..    .      .  .. #. # ##..#= # . # # ##.       #
# ##### ## # ####.# ##### #.# # # # # #.##  .. .           . .   . . .  . .    #  ## # #.# #  #  #..# #.#   # .# ..# # ###.# ### # # # ## #  #.    #. #. # .      #.## # #
#      =...  # .=.  .  .     . . .  . .  ..# # # ## ## ### ##.# #.# ## ##.##.# # # ### = # # ## ##.#  #.  #  #   # ..# #.  #   ..#  # #.## # # # #  #  # # # ##.# ## # #.#
### ###### ### ### ## # # # ## # ##.# # ## # # ### #        .# #.# ..#       # #   ... # # # #  #  .#. .#   ## # # # # # # # ##### #   .  .....    #  #  # #   ...     # #
# .               =      .  # # # ## # ##  . #.     # ## # #.  # ####  ##.# ## #.####### #.##.## # # ## ##.##  # #   #. .#..  .   .# ## ## #.#####  #  #.# # # ##.# ##.# #
#.##### ### # #### ##.### #  .# .  .. ...# # # ## ##  #.# ##.#.....  #.#  #   .#        ..   .        .      # # # # #.#. # #### # # .# #.## #   . #  #       .     .#.# #
#     ..  #.#  . # #. #. .# #.#%##.## # #. # #. #   #  .# . . ## ##.#. .# ####  ##### ##.# ## # # ## ### # #.# # #.#   # # ##  # .. .#   ...  ##.#  #  #.# ##.### # #. #.#
#.# # # # # ####.## # #.# # #    # . ##.## # #.# ##.#.# # ## #.# # # # #       #     ##   #. #.  #.# #. # #  #       # #     # . #.# .# # ##.##.#.###.##.#.# ## # # ##.# #
# #.# # #. .   .    . . #.  # # # ###... . # #        #. .    . ...   . # ## #  # ## .  # # #. ## .. # #   # .## # #   # ### #.#   #.# # #=# #.  . .   ..#   ..   .. .   #
# #.# # . # # ## # ## ###.#  .# .  .  # ##   #.# ####  ##.## # #### ## ##.#..  # # # ##.     # #.# #   .# #  ###   . # # # # #.# #.# #. .    ## ##.#=###  # # #### ## ## #
# ....  # #  .#  #    #    ##.#.## #### #  ### ###   .# . .. .  .   ..      ##     . ## # # ## # . #.# ## ##  # ## #   #     . . #.#.# #####. #  #       #   .   #..#.#  #
## ## #.  #.## ## ## ## # #  .#.  .  ..  # .       ## ##### ## # ## # #.# #.  .# # #.        .   #.# # . .   #. . . # ## ####.#### #   .   # #  #  # # #.# ## #.# .#   # #
# ##.## #.         .    #. =#.# #.# # #.#..### ### #       . #      #.#.# # ## =# ## ###### ## #.  # # ## ##  #### #     . ...=   .# ### # # ### ##.## #.# # # # ##.# #  #
#        ## ### #.##.# ## #.# #.## # #.#.#.   .. #. # ## ## #  #.## .    .# # .#  .  . .. ..# .. # # # ..  # # ..    # #####.###.#.      .    .  =  . .  .            .#.#
# # ### # # # ### # # # .        ..      . # #####.#.       .#    # ### # #  # ### # # # ##  # # #.#.# ##.#  ###.#.#   #     .  .# ## ## ###.# ## ## #.####.#### ###.#.. #
# #    .# .       .  .  # ##### # # #=# ##.#        # ## ## #. # #  #   . # #..    #. # # #.# .. # # # . . #.    #. ##   ### #### .. #.   . . . .#.#. .     #.   ... . #.#
### ###.### # ####.# ###       #.# #  .# # # ##### ##  .  # .# # ## # ### #  # ###.# #       #.###.#.# # # # # #   # . # # # # . # # # # ## ##.# .  .#.## # # ##.## ## # #
#...   .. #.# . .   . ..#.# #.#    # #. .. #  .    #. #.# # ##.  .  .   #   #  # # # .#####.#  # ..#     # # #.# # ### #.#.# .#.## #      .  # # #.# #  # # .. #.#   ..  #
#.# ###.##  # #####.##.#   # . # ##  # ### # # # #  #   .   #  ## # ##.## #  #...  # #    #  #.. # . # # #.#... .     .   .  # .#. #.# #.## #  #.  #   #  # #.#   # ## # #
## ## # . # # #   . . . # ## #   #.# #.. # ## # ## #..#####.## # # #.###  # #  # # #.# # ## ## #.  #.# #.#.# ##### ### # # # ##  #   # # # .##   # #=#  # # # ##.# ## ## #
#  .   .# # # # # # # #.#      #   # # # # .. ..    #     #.  . . ..    #.   #  #.##.# ### ## ##.#.# # #   # # ... # #.    #  # #= # # #  #.   #=#.#.# #. # #  # .   .  .#
###.### #   # #  #.# #.#  ## ##  # # #   # # # ### # .# # #.# ## ## ### # # #  # .   .  ..   .     #.# #.#.#  ## # ..# # #.# #.. # # # # #.###.#.#.. # .# # #.#  # ## ## #
#..  .#   # # # #       #  # # # . # # #.#.#.# # # .# # # .   ..   . .  # . .#  .######## ## #.### . #  .# . #  #  # #.#   # ##.## # #   ..    #.# # # # ## .  # # .  .  #
#.# #=  ##. # #.# ## #.#  #. #.. ### #.# # #   # ####   #.# #.### #.# #.# ### .#.           .  # #.###.## ##  # ##.#  .# ###  #.#  #. .# ## ## #.#.# # #    # ## # ## ## #
#.# # #   # # # # # . # #..#..##..   # #.# #.# .  .   # # # #    # # #..# #.##.# ##.## ## #.##   # #  .      #     ###       #  .# # ## #.## #  .#   #.. ## # #. # # #.# #
#.      # #   # # # #   # ## #   # #.#.# # #.# # ## # # #. .# #.# .  .# #.#   ..## ## ## ##.# #### #.#######. # ##   # # # # ## #..       ..   #.#.# # ###. # .#   .   . #
#.#.# # # # #.#.# #.. # # #. #.# #   #.##= #   #    # ##.## #. # #.# # .# #### #             .    ..  .  .   #. #.=##  ..#.#     # # # ## #.# # .. #.# .  # # #..####### #
## #  # #    .# #   ###.#  # #   ###.#.  #  # # #####   .  .# #.  .## #.#... # # # ### ##### ## #.## # ## ##. #  # #.# #..  .## ##. .# # #.# # #.## ## ##.# # .# .       #
#   #.  # # # # # #.    # ## #.#     . #  =#     ..   ## ##.#  #.#.   #.#.#.#  .  #  .     #   . # #   ##  # ## ##   # # # ###.#   #.    . .  .   . . .# ## # #  ## # ##.#
## ## # . #   #.# ##### # #.   # #.#.# #.# # # ###### #     #.# ## #### # ## #.##. .## # # .# # #    # .  #  #     ## ..   .  .  # ## # ####.## ######   ..   .#   ##.## #
#       # # #  . ..       .## ## #.# # ### #.#      ...## #.# #    ..   # .  # #  #.    # .#.   ## # # ##  #. .###.. # # ## # ##     #  .     .#  .  # ##.# # #  # .  . .#
## ## # # ..# # ## # ##.# # .    ...     ..#  # # ###.# . #.#.####.#### # ## #. #   ###=.# . ##  #.   .#  #  #.  # ###   # # # # # #.. #### ###. # # #  # ## # #.##### # #
#.. .   ..# # # ..  .#    .# ## ## # ##.## ### ## # #   ### #     .  .# #  # # ##.#  .. ## #  #.# .#.#.##  #..##.# #   #  .          #.       .#   # # ##  .   # .     # #
#.### # #  .### ##.#.# ## #...# #    # # #.   ..      # .   # ## ## # # # # .# #  # ###  ..# # . # # # . .#  # ..   ## ## ## #.# # # # ##.# # #= #.# #   .## #.# # # # #.#
# #.# # # #.  .   ....  #.##.# # ##.## #.########.###.# ### ## ### # ## #.### # # ### # ## # #### # #.## # # # # # # ## # ## ##.# #.##.# # #.#.# ### ## # # # # ## ###.# #
#.  #.#.# # ## # #.####.# .  .        .          ...    . ..    ..  .   ..    ..       .. . .     .         .  .          .=.  .  ..  .        ..         .          .  .#
#.##. # ..#  # # #     .# ## ### ###################### #####.#########.####### ### ##.## ## #.##.## #.##.## ##.## ##### # #.## #.### # ## #.### ## #.##### #### # ### # #
#   #\# ### # # # ### # # #..#.      .     . . .=       . ..   . .  .             ..#.# ### # # ##.## #.# #.#.#... # ..#  #   # #  .  .  . #.  #  .  ..    .     .  .  # #
# ##. .   . ..          # ##  .##.# # # # ## # # #.#.## #####.####.# ### ####.### # # #    .....  .   . ..  . # #.#.## ## # #.# ############ # ####### ######## ## # ### #
## # #.# ###.# ## ##### #    #..  #  # #..    #.#  .  ..#  ...#   # .  # #    #   .   #### ###### ##### # # #  ....    ..  ...#    .. .      .        .                  #
#. .       ..    ##. .. # ## ##### ### # ###### ## #.## # # # # #   # #   # #  #### #  . ..      #. . . .  .. # # # # # ## ## #.###### # # # ####.#.# # ## # # #### ## # #
##.# #.## ######.#  ###=# # ..       .     .    ....# # # # # .  .# #.# ### # #  .  # # ## ## ##.#.# ## #####. # # # ## #.## ## .  .  # #       .# # # #.   # #  .# # # ##
#.##  . # #    #  # # . # ##.### ## #.######## ### ## # # # # #####.        #  ## #.# #.. .# # . ## # # # ..#.#  .   .      .  =##### # # ##### #. .  ..#.#.   # #    .  #
#    # #   #.# #.## # # #. # #      ..    .  .   ...        . . . . #### ## . ## #  #. ###. .  #  . # # ###..  ## ##.# # # # ##   .        .     #.###### # #### ## #.####
# ##    #.# ## # .     .. ##.#.#.# ##### # # # # # # ## # ## # ####.        # .   #.#.# .#.###.# ####    . .#.#.# #.##    # # # ####.### ####.###. # .   . .   . .#. .#. #
##.# # ## #    #.## # # # #   .#.# #  ..#.# ..# # # ##  ### # . . # #### ##.# # ###.# #.#  # # #.. .. # ### # # # #  . # #  #.. #  .   .     .   #  # # #.# # #.#.  ### ##
# . .    . # # #.#.# .#    # # #.# # #### # ### #   . #      # # #.     ..         .# # ## . #   # #.#   .# #.# #.#### #  #  ##.# # # # # # # # #. ## ### #...# ###   .  #
##.# # ## # ##.#.   # #.# ##  .# # # .    #  .= #.# # # # ### .## # # ##.# #### # # #    # #   # ## # # ###.  #      #.#.#. ## .##.# # ## ## # # # .. .   # # #   # ### ##
# #.##.# .#      #.##.#.# #  # # .  ###.# # #.# # # ### # .. # .. #. #.# # #  .#  # # #.#  # # .   . ..   . #.#.# ###  #. #   # .             .    #.# ##  .  # ##  # # ##
#      .#. # ### #    # # .#. .  # #  ..#.# # #.#.#     # #.#  # #. #  # #.###.### .# #.## .   # # ## ## ###  # #   .#   ## ##  # ## # # # # ###.#.# ###  # ## # ##   # .#
######## ## ## # ###### # # ## ###.#####  ### #.  #.#### ##.##  # #..#.  .    .  .# #.#    # # # # ##.= #.  #.# # ###  #    . #     ..  . .#.  . #     .# # . .   . #   ##
#  . . ..  .      .  . . .   . .        # . ... # # # . .      #    # .### #.# ## # # .#.# #.#.# #.  .### ## .#.#    #. # # #   ### ## #.## ##### #.##### # ######### ## #
##.### # # # ###.### # ##.###.## ####.## # ##.# . .. # ####.## ##.# .#     #     #  # ##   ### # .# #  .    # # # ## #.#  # ###   ... .        .    .    . .   .  .     .#
#  = ## # #  #  #   . # # # #.#  #. #. # #  # #.# # # #.. #  #. # # ## # #  .# # .#.#. ..#      .# ## ##### ..#.# .  # # #.  .  ## #.#.# #.# ## ## #.## # #.##.## # # # ##
## #  =   # ## # .##### # #.#  #.#.## ## ### #  # # # # ##  #. ##. .# .# # # # #.# .# ##.# ## ##    ..  .   # #   ##. .#  # ###.# # #.## # ##    # # # #.#.## # #.# #.## #
## # #### . . . # #     # # # #. #       .  . # # #.#.#  .#  #   .#  # #  .. #    # # # .# ##  #.###### # # .   # ## # # ##.# #.#       . .   # # .#   .    ..      # . .#
#. .  . . #### #.. # ##   # # ## # ##### # ###. # # . # # # ## # #  ## ####.## #.##.#  # #.   ##   .  . # . # #  .      ..    # #.# # # ##.###.# ### ###.# ### ## #   ##.#
# ## # ## # .  .# # # #.#.# #      .     ### ## ##  ##.  .#   o#. # #   .    . .    #.##.# ## #  ## ## ## ##= ## ##.# # # # # # #  .#.   # #.     ...# ##.## ## # ###  #.#
# .       #.## ##.  ..#.  # # ##########          # # # ## #.# # ##.# ## ######## # # #  #  # ## #    .  . .# .# # ## # # # #.# # # #####    # ##.## .   . . .. . . #.# .#
### # # # .#.#    #.##  #.  #.# ..     . #.#.# ## # . .      ..     # #      .    . # .# # ##     ## #### ### #.   .        .. . .    . .# # # .#.#  #.########## # # ## #
# #.##.#  # .  ##  #  # # ##.   #### ###.## # #.### ######.###### # # #.# # #### ## # #. # #..##.#   .. .       ##### ##### #.# # # # #.#  #  .#  .#      . .     #  .   #
#  ..   # .# #  ..#  #  #  .# #      ..     .    . .#   .      .    #   #...     . . . # #  #..#  .# # ## ###.# .     . .     #.#. # ## ##.# # ## # =##### ## # #   # ## #
#### ## # #.#  ##. # .#   #.#.#.######### ### # ### ### ###.# #####.## # ## ####### # # # ## ### ## ##.# ## #.#####.### ### ## . # .    .. # #    ##     ..   #.# # # #  #
#.  . .    . # # .#. #  #.# #  ...    .           ...      .  .  . .    .  .                    .  .          ...       ......# ##.####### ..#.##  # ## ## #### # #.#  # #
## # #.## ## #  #  #. #.#.# # ### # ##### ## ### ### #.### # # # # # ## #### #.# # ## ## ### # # # ### ## # ## # #.## ##.# # #     . ..    #.# #  #   #. #.# .  #   # #  #
## # # #  #  # # .# .#  # # # #  #.   .  # .## #. . #     . #. # .. #     .  ##.#.## ## # .##.# #.##.  # ##  # #. ##.## # #.#.# ## # # ##.## ### #.# ##.# ## ### #### ####
#     . #  #.#  #  #. # # # #.# #. #### ##.#   # ## #.### #. #   ## # ## #.#.. =   .     #.     . .. # # #..#  #.# .               .    .  ... .  .   .  .    .      .  .#
## ###### #  # #  #. #  # # # #  #         ###.#  # # # # #.#.=# #   .   ..# #.#### # ## # ##.# #### # . .#=.# # ####### ## ### ##.##########.#####.### # ### # ### ##.# #
#  #    ..##    #.## ##..  .  #.##.# #.# #   . . #. # # #   ##    # # ## ##  #     .  #. #..# #.# .    # # .# .#    ...      .# # .       ..    ..# . #.#.    # # .      #
### ##### ...#.#. .     # ###      # #     ##.##  # #.# # #  #.# ## ### # # # ######## ### #.## #### # #  #.##.# #### ### ## #    # ####.# ## # ### # #  # ## # # ########
#      .  ## #. #.##### # #.# # ## # # ### # # . # .   .  # ##..   . ..     ..  .          .  ... . . .. ##    #. . .  . #  .## #      # # #  #.      ### ## ##       . .#
#### ####   ## #  #.    # # #  #.# .    .  .   # ### ## # #.#  ## # # ## ## ## ###### # ## # ## # # ## # #  ## # ### ### #.## # # # #.# .#  # #.# # # . .  . .  ##########
#.   . .# #     #  # ##    =# # .  ## #####.###           . .#   # #.##.# ## .#     .#   #  #. . #. .     # #  #   . .   .   .# # ##   # # ##.# # #=# ## #.## # . .      #
#### ####. # #.## #     # #.#  # # .#  .   .   # #### # #.##.. #.         . .#  #.## # #   #  # #  #.# ###   # #.#.###### # ##   .  # # ##.#  ## ## # ## ## ## #.# ## ## #
#. . .    #  #  .  # ## #   # #  # #  ## ## #### #  # # .#   #. # ## ## # ##.## .  # # # #. # # ## # # # ## # .# #.     . # . # # ##  . .  .#     .        . .  .  .    .#
# ###.#.# ## # ## #.#.# # # #. # #. # # # #=# .   # # # #  # # # ## ## # # #  #.## # #.  # ## ## # # #.   #. #    ## ## #. #.#   .  # #### ## # #######.##.#####.##.#### #
# ..# #.#  # #.   ..    # # #.#  # # .  .    # # #  #.#  #.#.  ..     .   .. #  #.   # # # .  .     .# ## #.#  #.#    # #.#...#.#.#.# # . .#   .    .  .          #    .##
#.# # # #.# ##.#.###### # # # #.##.### ##.### ## ## # # ## . # # # #.#### ##  # # ##    .# ###.### #  . . .  # #.# ##...# ## ##.#.# # # ### # ###### ### #### # # # ### ##
#.#.# # # #.    ..       .. . #  . ..  ... . .  .   . # #  # # # # . .       ## ## # # ##   ...# # # #.#.## #    .# #.#..   ..       .          . .      . . . .   . .=  #
# .    .#.# # #.##.## #.#.# # #.#.### ##.# #.# #.#.#### ## ##..#. .#.# # # # . ..      =.#.#####.# #.# #  #  # # #.     ##.## ## # ## ## ## ## ##.# #### # # # #.###### ##
#.## ## # #      #    . #   #  # ...   # .# # #   .     .   .# ## # ##.## ## # ## #### ### #       #.# # #. #  # #.# ##   # #.#  #   # #..   # #.#     .# # # ##.   .  . #
## # # ## #####=## ## ### ### #. ## # #. #  #  # ## # # ##.##         ..   . . .   .        # # ## # # # ##.#.## ## #.# ###.##.### ### #.# ## ## # #### #      .#.# #.#.##
#  . ...                 . .  .# ## #  #  # # # . #  #.# #=# #.# ##########.### # # ### ## # # #.# #.#.   .    .  ...         .            ..     ...  .. # # #.##.#  ## #
####.#### ### ## ###.######## #  .  . ## ##.# ## #..#  .  .  .      .     # # # # #.#   . .        #.. # ### #### ###########.######.###.##### ##.# # # # # ##     .#  ..#
#       #      .  .#.#   . .  .# # ##. .. .. . #. #  .# # ## # # ##.# # #.#   #.      #.##.#.##.## . #  . .     . ..        .  .     .       # #  # #.#   # . #.# #   ## #
##########################################################################################################################################################################
