#####################################################################################################################
#  #.# #  .# ## # # ## #.....  .. ..             .        . . . ....      .. .. .    . .   . ..  ..   ..  ..  . .   #
##.  .   #.. .  .. ..   .## # ## # ## ## ## #.# ## ##.# ## # # # # ## #.#.#.# # #.#.# # # ##.#.# ## ## # ## #.#.##.##
## #.# #   #.##.#.#.## #   .  . ..  .   .## # #.##.## #.##   . ...      .. ....    . .  .  .  .    .     .   . . .  #
# .     .#.#.##.# # ## #.# ##.## #.## ## . ....   .. . .. .# # #.#.## #.# ## ##.# #.#.# #.# ## # ##.##.# ## # ## # ##
## # #.#   ...    .  .   .     .   ..    ##.# # # #.# #.##         ..  . .   =.       ..  ...          ..    ..  .. #
# .#.#.# #.# #.## #.## # #.## ##.# ## ##.   #  .    . .  ..# # # #.## # #.# # # #.# # #.#.# ## # ## ##.## # # ##.# ##
##       ..    .  ...   .. .  ..   ...  .## . # #.#.#.# ## # # # # ## .. .. ..    ...   ....        . ... . # ## #.##
## # # # # # # #.## ## # # ##.## # ##.## # ## # # # # #.##   ... . ...# # # #.#.# # # # # # ## #.## ## ## #  ..   . #
#.. ..  =  .    .. ..    . . . .    ........    .  .     ..# # # # ##.# # # #.# #.#.#.#.#.#.## #.. . ..#..  # ##.#.##
## # # #.#.# # # ## ## # # ## ## #.##.## #.## #.# #.#.# ##.. .... .. .    . ....     . . .       ## ##  # # #.## #. #
#   . ... .. ...     ....    ....# ## ##.#.## #           .# #.# # ##.# # ##.## #.#.# # # #.##.#  ...  #    .      ##
## # # #.# #.# #.##.## ## ## #.#  .. .        . # #.# #.## # #.#.#.## # #.##.## #.#.## ## .   .# ## ## .# # # ##.#.##
#      . .   =.         . .      # ##.## ##.# #      ....      . .      ..  .. .. .  . .. # ## ..     .## .  ... # ##
##.# # #.# #.#.#.##.##.##.# # ## # ## ## ##.# #.# # # # ##.# # # #.##.# #.##.## # # ## ## .  . #.## ## .  # # ##..  #
# . .... . ... .... ...   . .. .    ...      . ....=. ....     .  .  . . .## #   .#  .    #.##   #...  ## # # ##.#.##
## # # # # #.# #.## ## ##.#.## # #.##.##.##.#.# # ## ##.## #.# #.# ##.#.#..   # #   ## ##.# ## # . #.#       ...    #
##.#    .    .  ...  . .   . . # # ## ## ## #.# #.## ## ##.# # #.#.## # ..## # . .#.. . .       .#  .  ## #.#.##.# ##
## # # # # #.# # ##.## ## #.# #  ...    .  ..    ...   =  .   . .. ..  .#.##.## #.#.## ## # ## # # # # ##.#.#.##.. ##
# ..  .  ... . .    . .. .. ....##.##.##.##.# # # ## ## ## #.#.#.# ##.# ..... .        .....   .    .   =   .    #.##
#.# # ##.## ##.## #.##.## #.# #.    . . . .   #.# ## ## ## #.#.#.# ##.# # ## ## # #.## ## #.## # #.#.# ## # # ## #.##
# # ...  ..   .    .  . ...     ## ##.##.##.#.. ..  ... .. .         ..      .  .   .. ...   ..   ..  .=     ...    #
#...#.#.# # ## ## # ## ## # # # ##.##     .. .# # ## ## ## # # ## #.# # ## ## # # #.##.## # ## # # # #.## #.#.## # ##
# # .     ..  . .   .  .    ..   #=   ## ## # . .  .. ..  .   ..  . ... ##  .. .  .. ..   .       .. ..... ..  ..# ##
# # # # # #.## # ## ##.##.# #.##. .##         #.# ## ## ## # # ## # #.#. . #.## #.# ## ## ## # # ##.## ## # #.##  . #
#.  . . . .  .. . . ..      . ...#    ## #.##       .  .  = . .  . .  ..##.# ##.# #.## ##..    # ##.## ##.#.#.## #.##
#.# #.#.#.# ##.# ## ##.## # ## #.# ##.## # ##.#.# ## ## ## #.# ##.#.# #  .  .  ..  . ..  .##.#    .  . .    . .  .. #
# . . .  ..    .     .  .  .  .   . ...   . ..#    . . .    .   .=..    ##.#.##.# ##.#.##.## #.# #.# # ## # #.##.#.##
# # # #.# #.##.# ## ##.##.# ##.#.# ##.## #.## . ## #.## ##.#.# ## # #.# .    . .    . ..    .. ..         .  ....  .#
#  ..    .  .  .. ... .. .  ..             . .#.   # . ... # #    ..    ## # ##.#.#.# ##.## ##.# # # # ## # ## # #.##
# #.# # #=#.## #.## ## ##.#.#.# ## ## ## # #.#  ##  .##.# #o. .##.#.#.#. . # ## # #.# ##.##.#   . ..     . . . ..   #
# .. ..     .  .... ##.##.# # # ## ## ...# # ##.## #.  .  .# # ..     ..##         .  .    . # # #.#.#.## # # ## # ##
# #.# # # #.## #.## .    . ..    .  . ##  .   . . ...## #.##.#.## #.# # .  # ## # #.#.##.# #....  .      .# #.## # ##
#.# # .     .. ..  .## ##.# #.# ## ##  . # # ### #.#        .   . . . # ## # ## #.# #.## # # # #.##.#.# #..   .    .#
#     #.#.# ## #.## .# ## #.# # ##.## ## # #.##...  .## ## #.#.#.## #   ..  . .    .   .  .. . .   . .#.# # # ##.# ##
# # #.#  . .   . ## # . ...    . .   ....     ..##.# ## #.  . .. .  #.#.## # ## #.# # ## #.# # # ##.#   .... .. =   #
# #.# # #.#.## #  .  # ## #.#.# ##.## ## #.# ##.....   ..#.# #.#.## # # ## # ## . .    .  .   . .  .. # #.#.# ## # ##
#.  ..  . . .    #.#. ... ... .  . . . #.#   ##.##.#.#.# .  . ..    ....    ... #.# #.## # #.# # ## #   .       ..  #
# # #.# # #.## # #.# # ## #.#.#.## ## #    #  .      . ..# # # #.## # # ##.#.## . .  . .   ... . ## # # # # # ## # ##
#   ..     . ..     .   .  ..          #.# #.## ## # # #.#.# #.= ## # # ##.#.##.# #.#.##.#.# # #  ...  ..      . ...#
## ##.##.## ## #.# # #.## #.# #.## ##.#... . ..    .  . . .  . #.    .    .  ... ... .  .     . .##.## ## #.#.# ## ##
#.     .      .# # #.# ## # #.#.##.## ##.# ##.# ## # #.#.#.# #.#.#.##.# ## # ## #.#.# ##.# #.# #  .   ..= .   .. .. #
##.# # # ##.##     .   ...  ..   .   .. .. ##.#. . ...      ....   ##.# ## # ## # #.#.## # # #.#.## ## ## # # ## #.##
#. # #. ....  .# # # # ## #.# #.##.## ##.#  .   ## # ## #.## #.# # .  . .  .  .=..       ....  ..  .  .        ...  #
##..   # ## ## # #  ..     .         ..... ## # . ....  # ##.#.# #.##.#.##.## # # ## #.#.#.# # #.## ## ##.# # ##.# ##
#  # #...  .      .# #.## # #.# #.#.# ## # ## #.## # ##.. .   .. .  # ....  ..  . ##.# # #   ...    .   .   .. . ...#
##. . # # #.## # #.  .  ..     . .   .  .  .. ..   .   .#.## # # # #  # ## ## #.#.        .#.#.# ## ##.## # # ## # ##
## #.##  ...## #.# # # ## # #.#.#.# #.##.# ##.##.# # ## # ##... ..  #.# ##.## # . ##.# # #     .     =...  . ....  ##
#   ... # #.. .    .. ....      .           ..   .  . ... .  #.#.#.#.   .       # ##.  #.# #.#.#.##.## ##.#.# ## # .#
## # ##.# # ##.# # #.# ##.# #.## ## #.##.#.## # ##.# ##.# #.#  .. .. # # # ## # . .. #.   . .   . . ..   . .#.##.#.##
# ..   ... .         .  .       ....  . .     ....    . . .. .#.## #.#.# # ## #.#.##.#.## ## # #.##.## ## #  . .    #
## # ## #.# ## #.#.# ##.#.# ##.#.##.#.# ## ##.#.## # ## #.# #    .  .    ......... .. . .  =.  .       .  . ## # #.##
#  # #. #.#.## #.#.# # #.## ##.# ## # #.##.## # ##.# ## # # #.# ##.# # #.# ## #.# ## # #.# #.# #.##.##.## #   .  .  #
##.   #....  .  .. .  ....... ... . .  .....=.      ..  .  .   .. .  .  ... ...   ..   .. ..  .  ...  . ..  #.## #.##
##.# ## #.# ##.# # #.# # #.# # ##.# # # ## ##.#.## #.## # ##.#.#.# #.#.# # ## ## #.# # # # #.# #.# #.# ## #.....  ..#
#   .   ..  . . ..   ..  #.#.# .  ... .      .  .    .    .    . .. .# #.# ## ## #.#.# #.# #.# # # #.##.# . # ##.# ##
##.#.##.# # ## # # # # # .. .. ## # #.#.## ## # ## # ## #.## #.# #.#.  . . . ..        . .   .  ..  .     #  . . .. #
#     .  .   .     #.# #.# #.# .  ..#.# ##.##   .  . .       . ..    # # # ## #.## # # # # # # #.#.#.## # #.# ## # ##
## #.## # #.##.# # . ... . .   ## #.   .  . . ## # #.##.#.## # #.#.#..    .##... .   #. .. .... . ..  .. . ..  .  . #
##.    .  ...  #.# #.# # # # # ## #.#.# ## ## ## #.# .    .   .    #.##.##  ..# ## #. .# #.# #.#.# # ## #.#.## # # ##
#..#.##.#.# ##    .    . ..       .    .     ...  .  ## #.##=# #.#      .  ##. . ..  # .. .  .  .     . .  =.   .  .#
## .       ..  # #.# #.# #.# #.## # # # ##.## ##.# # ..  ...   # # # ## ## ##.#.## # #.#.# # # #.# # ##.# # ## #.# ##
## # ## # #.## # .   .. ..  ..... ..           ..  ..## #.##.#   . .    .    . .. .   .   .  .... .  .. .   .. ..  .#
# .     #..  .   #.#.#.#.#.#.#.## #.#.# ## ##.## #.#.## # ## # # # # #.#.#.## # ## # #.#.# # # # # # ## #.# ##.# #.##
## #.##   # ## #.# #.      ..      ..=.  ..    ...   .  .. .. .       . .  ..    ..... ..     ... .    . ...  .. . .#
##.   ..#.  .. ..    ##.## # # ## # #.# ##.##.##.# #.##.# ## # #.#.#=#.# #.##.# ## #.# #.# ## ## #.#.## #.#.##.#.#.##
##.##.# #.# ## #.# # ##.    . ...   ..... .  .   .    #.# ## #.## ## # #        . .    ...       ..    ...  .. ..   #
#..  . . .    ...   ....##.# # ## # # #.##.## ## #.# #.    .  .. ..    . # ## # ##.#.#.# # ##.##.# # ##.# # ##.# # ##
## #.# #.## ##.#.# #.## ...   .   .. .   ..##.##.#.#.# ##.##.#.##.## #.#  .  .    .. .. .. .. .  .    . .    .     .#
# .  . .... .  . ..     ## # #.##.# # # ##   . .     .  ..## #.##.## ## ##.##.#.## # #.# #.##.##o# # ## #.# ## # #.##
#.## #.## # ## # # #.##.##.# # ##.# #.#.  .##.## ## ##.##  .  .   . .  .. ..  .   . ..   . .       . ... ... . ...  #
#.##.#    .  .. .        . .. ..    .   ##  .... .....   .## # ##.##.##.##.##=# ##.#.# # # ## ##o##.## ##.#.## # # ##
#     .## # ##.# # # ## ## # #.## #.##.#.# ## ## ## ## ## ## #  . ## ##.## ## #.## #.# #.# #. ##.## ## ##..  ... #. #
# ## # .. ..  .  .  .. . ..     .    . . .    .=   .      . . .##.  . ..  ... . ....        #.  . . ....  # ##.#.. ##
# ## # ## # ##.# # #.##.## # # ## #.# # ##.##.## ##.##.## ##.#.## ## ## ## ## #.## # # #.#.#. ## ##.## ##.# #.  .#  #
# .  ...     ... .  . .   . . ... .  ..... .. ... .. ... . . ..  . .     . ...              # ...     .   .. .## ..##
#.# ## ##.#.##.# #.# ## ## # # ##.#.#.##.# ##.## ## ## ## ##=# ## ## ## #.## ##.##.#.# # # #..## ##.## ## # # .  #..#
# . .       ...  # #.##. .=   .   .. ..       .  ..  .     .  .. . .    .   .. ..  ...   . ## ##..   . .# #  #.#.#.##
#.## #.## # ## # .  .. .##.# # ##.# ## #.##.#.## #.# # # # ## # # ## ##.# ## ## ##.#.# # #  .    ##.#.#... .# . ..  #
#. .     . .  .  # ## # .    . =.. .. .... .        .    . .     ...  .  ...       ..   .# ## ## ## #.# #.# ## # #.##
#.## #.## #.##.#.#.## # ## # #.##.# ## # ## #.## #.#.# # #.##.# # ## # ##.## # #.# # # #  .        .  . . .   .... .#
# .  .      ....  . .    .    .    . ...    ..  ....      ..  ..   # # ## ## # # #   ....#.## ##.#.##.#.# #.# ## # ##
#.## # ## ##.# #.# ## # ## # #.## # # # #.#.# ## # #.# # #.## # #.# . . .. ... . . # # # # ## ##.# ##.# #.# # ## # ##
#     .    .  .  ... ..   ...      .#.# # #.. . . .   .. . ##.# #.## #.##.## #.## ## # ...... . . .   .     . .     #
# ##.#.## ##.#.# # #.## ## #.# # ##.. ...   #.## #.# # # #..   .   .     ..  .  .  ... # #.##.##.# # ## # #.#.##.#.##
# ## # ## ## #.# #.# ##.#.## # # ## # #.## ## ## #.# # # # ## #.# ## # ##.## # ## ## # = .. .... # #.  .  #.#.## #  #
#    ..  . .. .  .   .. .. .   =..       . .      .   .  . .         . .. .. . ##.## #.#.# ## ##.  ..## #.  . . .  ##
#.## #.## ##.#.#.#.# ##.# # # # # # #.#.##.# ## ##.## ##.#.##.# # ## #.## ## #  .....  .     .   #.# .... #.# ## # ##
#.  .  ..  .   .   .  .  .  .. ...      .         . .....   .. ..= ..   . ## # ##.## #.# #.##.## .  .## # .  ...    #
#.## # ## ## #.#.# #.# #.#.## # # #.# # ##.# # # #.## ## # ## #.# ## # ## .          # #.#  ..## #.# ##. .#.# ## # ##
#   .   ... .    .... . .       .  . .   .  .       . . ... . # #.## #  ..##.#.## ##    . .##      #   =# # # ##.# .#
# ## # ## ## #.# # # # # #.## # #.# # # ## #.# # # ## ## # ##   . .    ## ##.# ##.## # # #   .##.# ..##. .    ... .##
#   . ..  ..  .    .     . .. ..  . ..   ..  .. . . .  . ..   #.#.##.#. .. ...  .     .   .##   .. #    # # #.##.# ##
# # # #.#.## # #.# # # # # # ## # # # # ## #.# # # ## #.## ##.   ....#.##.##.#.## ## # #.# ##.## #.  ##      ....   #
# ### #.#. . . ...  ...        .      #.## #.#.#.# ##.#.## ## # # ##   .. . .        . .. ...  ... # ## # #.# ## #.##
#  ...    ## # #.# # #.# #.#.## # # #     .    ....   . ..  .   ...  #.##.## # ## ##.#.#.#.##.##.#.. .   ... ..  . .#
# ## #.##.##.# # # # # # #.# ##.#.# #.#.##o# #.# #.##.#.##.## # #.# ##.##.## #.##.## #.# # ##.##.#.#.##.# # # ## # ##
#.## #.##  .  . .  ... ... . .   ...   ........... ##.#.   ..  .     .=.   .  ......    =. .      .    . ..... .  ..#
#      . .## #.#.# # # # #.## # ## ## # ## # #.# #    ..## ##=# #.##.# ##.##.# #.# # # # # ## ##.# #.## #.#.# ## # ##
#.## #.##.    .. ...   ..  .   .   .    .. ..  ..  ## #       #.#.##.# ## ## .. .  ..        .##.# # ##.#     . .#.##
# ##.#.##.##.#.# # # # # # ##.# ## ## #.## #.#.# #.## #.##.##. . ..      ... #.#.# # # # #.##   . ..  ....#.# ##    #
# .       ...   .  ...        ....  .           .....     ... # # ## # ## ## #.#.# #.# #.#.## ## # # ## # # #.## # ##
#.## #.## ## # # #.#.# # # ## # ## ## #.# ## ## ## ## #.## # ##.#.##.#.## #   ...      ... .. .     ..   .     ..   #
#..%      .    ..   .      ## # ## ##.#           ..    ......     .    ...#.# # # #.#.# ##.# ## ## #.# #.#.# ##.#.##
# ##.# #.# #.# # # ##.# ## .        .  .##.#.## ## ## # ## # ## # #.## ## # . .. .   # # ##.# ## ##.# # #.# # ##.# ##
#.## #.# # # #.#.#.##.#.## ## #.## ## # . .       .....      ## #.#.##.## ## #.# #.# ...  ... . ..  ... .. ..   .  .#
# .       .  ...      .  .   .# ## ##.# #.## ##.## ## #.## #   .    ...    # ..... . # ##.# # ## ## # # # #.# ##.# ##
# ## # ## ## # #.# ##.# ## ##  ..      ...           ..      ## # #.##.##.#. # # #.#    . ....   .  ..  ..       .  #
#  ...  .            ... . .#\# ## #.## #### #.# # ## # ##.#.## # # ## ##.## # .     # ## # # ## ## # # # #.## ## ###
#.#.##.### #.# # #.## #.#.#. . .. ..    ####. .        . .. . ..      ..   ..  # # #. ...  . .## ## #.# # #.## ## ###
# .    . # #.# # # ##.  . .# ##.## # ##  . ..#.# #.##.# # ##.##.##.#.#.##.##.# # #.# ## #.# #      . .  ..     ##  .#
#.# ##.#  . ...  . .  # # ##.## ##.#.##.# ##.  .  .. .     .  ....    ...  ....       .. . .  ##.##.# # #.# ##    ###
#   ...  # # #.#.#.##..      .  . . .. . .  .#.# # ## # # ##.##.##.# # # # #.## ## # ## #.# #.## ## #.#.# #.## ##.###
#.# ## #  .  .. .  . .#.# ##.##.##.#.##.# ## .      .    .   .. .  . .    ..      ...        ... ..     ..    . . ###
# #.##.#.# # # # #.## # # ## ## ## #.##.#.## #.#.# ## # # ##.## #.# ## # # # ## ## # #.## # # ## ## #.#.#.# ## ## ..#
# .. .     . .. ...   ..    .. ... #  .....  .     ..   .. .. .      .     ...     .   .   ..  ..       ..   . .  ###
#####################################################################################################################
