########################################################################################
#..  # # # .#.# ..  . # ## ##.## #  ..# #.#.#  # ..#....# #. #.#  .  .#.#. # ## #..#.#.#
## #.# # ##.. . ## ##.#   . .   ..### #.# #..#...#.####.#.## # ###### #. #  .... # #  .#
# ##.#  .  ####. ### # # ####.#### .#%#.# #.#  # .# ..#.# . . .  .  # #.# ###.####.# # #
#  ..#.# ## ..#.#. .. ..#  .    .  #...  .#.# #..# #.##. # # #.#### # ... . .      #..##
# ## #.# ### ##.#.#####. #.# #.##=# # ## #..## #  ..   .##  ##.  . #  #### ## #.###.#. #
# #.  # . #  #. #.# .   # #.##.#. # # #.# #.....# ###### .##...#.# .#.. .# # # ##.#.#.##
# .## #.# ##.##... ##.# #. .    #    . .    #####.   .   # ..##.# ###.# #   .. .  .  . #
#.## # .# .#  ###.##.#..#.# ##.#  ####.##.###.    ####### ##.#....   ..# ### # #.# ###.#
# #. ##.# #. #    . . #..## ##  # ...#.#  .  .# ##.    . ....# #.# ##.#   . #.# # #.. ##
# .#  # # .#.###### #### ..#...#.#.# #. #.###.# #. ## # ##.#.#.# # .#.#.#.# #.# .. .# .#
# ## ## # #....    #. #  ## ####.### ### ## ##.# ## # ## ###.#####.#. #.# # # # #### .##
# ...   # ## #######.#.#  ..  ....  .      .. ...  .##.... ..  #=.. # # # ##  #.# . # .#
#.#.# # .    .     ..#  ###=#### # ###.# ##.#.#.# #.. ######## #####. =## ...##.##.#  ##
## # # #.# # ## ##.#.# #    #...#.#.  # # ##.#.#.##.#.. ..  ...... ## #..# #.  #  ..# ##
##.  #.## # # # .# #.# # #.#  ##  #.# ....      . ...#############  #  .#.# ##  .## #. #
# ##..  #.# # # ##.#.#   # ##.  # # ##.# # #.#.## ##  ...  ...   # #..#.#.# # .### # .##
#.  # #  . .# # # .#.# # #....# # #.. . #  #. # .#.  #####.######. .# #.  . .#     .#.##
## ## .# #.# .#  ###.#.#.#.#.## # # #.## #.# #. #. ##       ..  .# # . # #=# #.#### #  #
## # ## #   # # #  ..#=.## . .  # # ## # #..# # ##.o#.##.# #.#.#.#  # # .#.# #.   #.# ##
# . ..   #.##.# # ##...##..## #.# #  ..# # ## .... #.# #.# #=# .#. ## # ##.## .###..  .#
# ### ##.# .  #.##. .##. # #.#.##..##.# .#.# .#.## # . ##.#.##.# # #. .#  # .# #  # # ##
#.#.#.#.# .####  #.##  # # #. . . #   ##.#..# #.# ##.##. ..   # . ..##. # # #. #.#.  #.#
# ..#    #.   . ##.# # # #  # ### .##  # # # ##     ... #.##.# .## #.#.## #.##..  # ## #
# ##..#.# ### ##.       .  ## . # #..#.#  .  ...#.#.# # ### # #..#.# #.   ...# ###.    #
##  # #.# #. # #.# #.#.###   ## #.#.#..  #### #.## #.# ..   # #### #..#.###### .  #.# ##
## #.. #  ##  ..#.# # ##.#.###.## #.##.#. = .#.   . . #.# #   .....# ##.   .  =### #.#.#
#.. # # #  .# #  .. ...   ..     .  .#  # ## # #######  .# # # ### #  . # ## #.  . . . #
##.## #.#.## ##.######################.#.#  .# .  .. .# #. ## #  ...###.#  . #.### #.#.#
##  .  . .    .. ..          ....   .. .  ##.#.########.##..# ## # #.. .#.###  #.## # .#
# ## ########.# #.# #.## ## # #.#.####### #..#.   .  ... # #...###..### ## . # .    .#.#
# .# #      .# #.## # #.#.# ## # #.. .=.   #.# #####.#.##   # #  .o# .   # ###.##.#.## #
# #   #.## #.#  ... # # ..  ..   #.######.# .#.#.  # ### # # . .##.# ##.#.  . . .# .# .#
#. #.#  # #. # # ## # . # ### ### ##  . # ##o#   ### .. .#=##.# .#..#..  ## ## #. # # ##
#.# # #.#.### ## #  # ####   .#.#    ## # .. #.###  .#####. . ##..##.####   # #.###.#..#
# ..     \  .  .. # #. .#. ####.##.#. .#.##### #. ##.#    .### #.# ..     # #   .. .# ##
##.## ####### #.###  ##. #.#  ....## ###  ...  ##.## #.#.#=#.#   #.#.# #.#  ### ####   #
##.  #  .. . . #  . # #.#.#. ### # . . .#.##.## # .=. ##  #. .## ## # # # #    #  ..# ##
#  # # ###### #  ## #..   .#.# . # ###### #..  ..# # #   # ## #. ... ... .  ##.# ##    #
##.##. #. ...#.## ## ####### #####....  . ##.####.##. ##.#. #  #.## ######## ## # #.####
#.# ##.# #####... . .#..   .  . . # # # #  #.     #  #.#.# ##.## #    .  .       ...   #
#.  . ## # . .#.## #.## #.##.# #.#. #..#.# # ##.## # . # ... .#  ##.## ####.# ## # #.# #
## ##  .. #.#.#  # #.  # # #..## ### .#  # ### #  . .##  ##.#  # .#  #    ## ##.# ##.# #
## # .### # ### # . # #  ..=.# . ...### ##    ..# # ## # #.#. # .## # .##... #..     . #
#. .#.#. #. . ..## #  #.## # ## #.## ..   ## ##.#    . #  . #  # #  ##.# .#.######.#####
## #  #.##.####  #  #.# #.# . #..# # ## # #.# #.# # ## # ### # # ### ## ##.# # .  ##  .#
##  # # . #  ...#.##..#.#  # #  #..# # .# #.#  .# # ##.#.# #.#.#....     .   .# #.#  #.#
# .##  ##.# ###.# # # # # #  .# .#..  # # #.###.# #.  #  ..  #.# #.######## # # #. # #.#
## #..# # .# .# . #...### .#.#..# .###### ..  #  ##.#.## # ## ##.# .   . .#. #.. #....##
#.# # #.#.#.#.#.##  #  .. #.  #  #.#..#...# ##  #..   .#.##.=.  ..######### #.# ##.### #
# . # . # # . #. .##..#.#  #.# ### .# # ##.## # # #.# #   . ## ##.# .   .   #  .#    #.#
#.#.# ### ## ##.##  #..# =#..#..   # .# .  . .#  #..# .#.## # #    ##.#.### # ## .##.# #
#.###     .    .# #...# ###.# .#### #.#.#.#.##. # ##. #  ...# ##.#  # .# =..#.#.## #.# #
#     # # # # ##..  #.# ..  .# #      #.#  ## #.# #####.#.# #...#.##.##.####  # .  .  .#
## ## ## # # #.###### ##### ##..###.#. .# # ..  # .# .  ## .#.## ...    . . # #######.##
## .#   ..   .     .. . . .... # .  # # ##.####.## # ### .#.# #  ## #### #.#  . =.  ## #
# .#.# #.# ##.## ##.### ##.# ##. #.#  #...  . # =# ###.# ## #  #  # .   # ###.# ## #   #
## ...# # . #. # #..# # #  # #### #  ## ## # ## ##  ..... . #.## ## ##### ###.  #.## ###
#..## #  # #  # .#.# .# #### .#   .# #. # # #. .#  ## #.#.#      #   .   . #  #.   .  .#
### ## .#  .#. #.#..# #..   #  # #.###.## #.# #. #.# # # ## ## ## # ## # #  #.. ##.#####
#     #  # #  #  # ##.# # #.# #. ##.     .    ###.##  ...   .## # ## #.# #.#..## ##. . #
#.##### #.#.## # .#. .. # #.#.##..#.#.### ### ...   #### ###. .. . .. #  #. #  #.  #.#.#
#  ...   .  . . .# .##.#  #.#   .#  ##   #  #.##.## #  # # # # # #.##  # ##.# # ## #.###
### ##.# # ##.# #.#.#.#.# # #.#.#### # #.##.. # #.#  # # #.# .# #.#.# #..  #.    .    .#
#   . # #.##.#.#..#     # # .#.#.#.    .   ## # # # # .#.#.# #. . . . #.##..# ##.##.##.#
# #.## .     .. # .## ### .#.# #   ###.## # #.# #.#.## ###.#. #.##.# # # # ## #.## #. ##
# #..  ## # #.#.  #.# # ..# # .# # # . #  . #.#.  . .   .. # #.#..##   . ..    .  . .# #
##.# ##..# #o#. ##  # # ##...#.## ..### # ## .# #### # #.##  #.  #.  ## ##.## #.####   #
##.#.#.# .   .# . #.## .. ##   . # # .  ..# # # #  #. # #.##.# ##  #..# #.#.#.# # .#.###
#  #.    ## # # ### ..# ##. .# # .. #.# #. .#.# ..#. #. .... # # # ##.###.. # ##  #= . #
## ###.#. # # #     # #   ## ## #### # ## # #   #..##  ## ##.# . . .      #.#   # #.##.#
#. . #.### ##..## ##.# ## # .....     . .#### # ### ### # .# ##### # # ## ##. ## .#  . #
## ### ...   ##.#.#  .  # ## ### # # #.# .#  .# . ..  . .# #. . . # #.#.#   #. .#. ## ##
#     ##### # . .  #.##.# .# #  .## #. # # .##  ########.###.## # .  .  #.##  ## .# #.##
## ##. .. .#. # #.## #. #.# . ## .  .#.#.## # #.  ..   #.    # #  #=####  . # .##...# .#
## .# ## #. # #.#   # #. ##.#. ### # # #  #.# #.###.## # ## #  #.#    . #.### #.#.# # ##
# .# ..#  # # ## ##.# #.#...##  ..# .#.# ## #.# #..#. # #  #.# # .###.## .. ..# #. #  .#
#.# ####.#  #   . #  .  # ## ##.#  #.#.#.  .# #. #  #..  # .. .. #..# .#.###### #.#.#.##
##..     . #  # #.#.## #.   . .#.##.#..#### # # # .#  ###  ## ## .# #.#....  ..  . .  .#
## #.##.## ##..#..#.#   #.## #.....  # . .#.#.  .# ## # ### ##.# ## # # ## # ## # ### ##
#.  ## # # . # .# #  # ##.  #..#.## # ## ## #.# #   . ...  ..  .##. ##.   # #.#.#    # #
##.#.  .   ##. #. #.#.   # #.#  ##.## .. ...#.#.# #.# ## ## # # . # .## ###   # #.##.. #
#..#.# ###   #..##   # #.#.# ..#      ##.##.# ## # # ##.## ## # ###.# #     #.#.#   #.##
## # # # #.### #.##.#  # #.###.# ## # # #.#      = # ...#..   .....  .  # ## # . ##.# ##
##  #.#..#..      #  ##. ##..    =# #.  .. # ## ##  .##..## # # ## # ## #.. ..# #### ..#
# #    #  #### # ## #. # . ### ##.# # ### ##...# # # #. #...# # # ## # #. ##### .##.# ##
#   ##   #   .  #  . #. .#.  ..#     .#  .. #.#.   # #.#  #  #  #. .    ##..  ..#      #
########################################################################################
