##################
## ## .=# # #    #
#  . =#  . =.# ###
## ## # ## ##.   #
#    #  #  #  # ##
##=#  # ## ##    #
#.o#.#      #.# ##
# #    # #.#  #  #
# % ## .  o # # ##
# # #. # #.## #  #
#   .# # .  . # ##
## #.   .#.# #.  #
#    ######\### ##
##.# #   #.. #  ##
#   .  # o # o#  #
# ## ##. # ## # ##
#....  # #       #
##################
