#################################################################################
#..=    .#.. .# #.##.#  # # ## # .# ##.#.# # #.#... # # ..#.#. # . #..#....#.   #
# # ##.#  ###  ..   ..#.#...  . #.# .. .. .  ..# ####.###.# ##. ## ##.####.#### #
###.#.#. ##.#.###### ##.# #.###.#..#########.###... . . ..  .#.# ... .      .. .#
#.     # #.  ... ...#.  # # # # #.#  .=. ..  #...##.#.#.## #.# #####.## ##.# #.##
########.####.######.## #.#...# # .##.##.### .#.#  # .#  #.# # ... # # # .# # # #
#  ... ... . . ...... . # ##.#. # ###...# .# #...#.##.#.#. #.# #.##..#= # #. .  #
##.#.#.##.#.#.## ##.#.#.#.  # #.#..#..##  # ..# #   #..#.#.# # ### #...##.# #####
#.  #.##.#.##.#.#.## #...## # .# .#.# # # ##.# #.# # .#... # #  .  # #...... .  #
## #. . .  .. .. ...  #.#..  #.##  .#. .#..# #  .#. #. ## ## #.##.#..# ## ##.# ##
#.. #.## # # #### ####. .# #= . #.### #.#.#  #.###.##.#..#  #  #.#=# #.#.## #..##
## # #. .##.# .. .#  .# ## #.#.#..#...#.#. #  .o . ....#.#.###   .. .#.#... .#. #
# .# ###. .. ###### ##  #..#.#..#..### ##.#.# # ## ##.#..#  # ## ### # ####.##.##
## # ..# ####.... .. .#.##.## ###.#..... .#.  ## ##.# .#..# .....# #.#  ..  #.# #
##.#.##. .. # #### ## # .... . ... ######.###  .. ..# #  # #####.# #.#.# # # .. #
#.o# #.# #### #   # # .#.# #.## #.#   ........# # #.#. #  . .....# # # ## # #.#.#
##.# # #... . # #.# #.#.#.# .#  #.##.# # ##.# #.##.## ############ #.#.....  .#.#
#..#.#..## #.#. #.# #.#.#  # ###.  #.## .#.# .##.#.. ..#.. . .  . .#.#.#### ## .#
##.#o# #..#.#.#.#  .#   ..#. . .#.#... #  ..# .. # ## # .# # #### #. #.#.  ##.###
## #.#.#.##.#.## ## ######.#.##.#. # ## .##.# ## #.#   #.##.#...#. #.#.## #. ...#
# #. ... . .#... .... .... # .#.#.#.##.## ##.## #.#=#.# . . # # #.# .# ..  # #.##
# # # #.#.#.# ####### # ##.###.#. . .... .....   .....## ##.#.###. # ####### ## #
#..##. ##.# # #. . . ..#.# . .. # ##.# ###.###.#.### #.#.#..#  ..#.#   .   .... #
#.# . #.. #.# # #.##.##  # ### #  # # #  #.# .# ##..#..#..#.# ## #.#.## ## #### #
#..## ####..#  #.##.## # #.#.# .# .... # # #.#  #. #.#.  #  #  #.# # # .#.#. .#.#
# #.#..   #.# #.....  ..  .  # # .###.#  #.# ##  #.# ..# ## # ##.### .# #. # ##.#
#.#...#.# #.# ### ### ## ## ##. # #  #.# #..    ##.###.## ##.# ...  .#..#.##.#..#
#.#.## # ##  .  .#. ..#.## #...#..## #.... ### #=  .   .  . .#.# ## # # .   ..# #
#.#  # #.# #.#.# .# #.......### #  ..#.# #.#.##.##.######## #...##.##.# # ### # #
#.#.#  ... ..#.#.#.# ###.### .... ## ##.#.... .  .. ..  ...# #.#    =...# # #.###
# ##.### ###.##. # ..   #..# ## #=# #   .#.###.#.##.# # ##.# .. ## ######.  #.. #
#.   =.# # ....# # # ##..#.# .## . ..#.#.# #.##.## #=#.#.## ##.# .#.. ... ## ####
#.####. #.######  #.#...#  .#...#.# #. #.#.... .. .......   ...# # ######..# #. #
#.#. .#.   ..  . #...##..#.#.#.# .##.#. #.#####.##### # ##.## #. ..  . ...#.  #.#
#.#.# #.## #.##.# # #  .#  . .#.# .. ..##.... #.#  . ##.#.#..# ####.##.## .## #.#
# #  ##.#.#.#.#.#.#.###.# ### #  .###.# ..####  .#.#.#..#.##.#.# . #.#.#. # ..#.#
#  # #. #  .. #.#. .... #.#.. .## #.###.#.#  .# #..# .#. ... # .## ..#  #..##.#.#
##.#.## #.# ##. . ## ## #..##.#.. # .. .#. # #.#.### #####.#..#. #.#.#.#..# #.#.#
# .#..# . .# .#.# #.# # #.# #  ##. #.## #.# .... . .  # .# #.#  #. #.# .#.  =.# #
## #.# .#.##.# .# # #.#.# #.# #   #.# #.#. ###.##.##.## #.## .#..#.# # #  ###.. #
#..#  # # #.  # #.# ..# #.#   .## # #.  #.#. #.# ##. #... . .#  #  #.#.##.#. .###
##.#.##.#.## #.# # ## .##=#.# #.#.#.### #.# #.## # #.######## #.##.## # #  #.##.#
## #.#...#.. . .. . . #. .##..#.. #.. # #..   .  . ..  ..   .... #.  .. . ## # .#
#. #..#.#  ### ### ##  ## ..# # ## .#.# ###.# #### #### #.#.# ## .# ##.## # .##.#
##.#.#.# # # .#   # . # #####.# ..#.# #.  ###.. .#.#....##.#..#..# #.## #  #....#
#... ....#. #.###.### #.   .= # #.#  ##.##.. =# #  #.#.#... # ## ...  . #.# .####
#.######.## # ..#.. # #.# #### .#.# #    .#.#  #.#.#### ## # #.#.######.#  #....#
##...  #  #.# ## .#.#.# .#... #..#   ## # # # #  #.. #.  . . ..#.#   .#.#.# #####
#  # ##..#..#...#.# #.#=#..### .#.# # # #  #   #.#=# #.# ###.## .#### #.# .. ...#
##.#.  #.##.# ##..##..# .# ...#..  .  .#### #.#. ..# #.#.#  .#.# .  #.. # ## ####
#. #####   .#.# # .  ## ##.###.### # #. #   .. #.## .#..# ##.. # ### .#.# # .#. #
##.  . .#### .# # ## . .  ...  .. #.# .#..### #.#. #.# #... .#.# #.## #.###.##.##
#.#.# #.#.. # # #...## ### ## #.###.##  ### # #.## #.#.######.##.# ...#. ..#..  #
#.#.# #.#.### # ####.###.#  #..#.. .   #....#.#..#.# #.. ..  .  .####.#####  #.##
# #. #.  .  ... . . . ..   ## # .#.#.# #.#.#  #.# .# .####.## #.# . #  .   #.#.##
#.# ##.####.# ##.# ### # #.#   ##.##.#.# ## #.#.##.###...#.# # # ##..#.### # #. #
# # #. # . .#.#.##.#..#.#.# # #   #. # # . .  # .   ...##.## #.#.. =#.# .  #.# ##
# # ##.# ## #.# .  ##..... .#..## ####  # ###.## ### #. .....    ## #. ###.#.#..#
#.#..# .# ## #.###. #.#######.#.#..    # ##.#  .#. ..#.##.# # ## . #% # ...#.#.##
# # #..#....   .  .#......  ...   ## ##..   . #  ###.#.### .#.#.### #.###### #.##
# # ##..# ### # ##..## ##.###.#### .##.####### .#   .#. # # #.#.. . ...  .  . # #
#. #...#.## ## #.#.#. . #.# . #  ##.  .   .. .# .# ## .#. ..#.#.###.###.## ##.# #
#.# .#  .     ..  #.#### # ## .#  #.##.# ###### #.## # ####.#.# #..# .#.# .#.#..#
#  # ### ##### ##.#. ...... ..##.#  #.# # ... ......   .. # #.#. #..#.# .#  ..# #
# #.   # .....# #..###.###.## # . #.... \ ## ###.#.##.### #.#.# #. #. #.#. #### #
#.#### # ## #.# #.#..#.# ..# .##.# ######.. #...#....#. # #..#.. # ##.##.#....  #
#   ...#.#.## #.# .# .. ##  # .  .   ..  .# # ##.#####.#..#.# # #     .. #.### ##
#.# ## #.# # .#.. ####.#.#.#..# #.###.#### ##.##. .... .# # #.#. #.#.## # .  #. #
# ###  #.#..# .# #.#.#.# ...# .#.##..# . . .. ...##.#.##  #...#.# ##..##.# ##.###
# .  # # #.# .# # . .# ##### .#   ..##.# ## ######.# # ##.#.##.  . ..# . .... ..#
###### #.#. #.. #.####.  ...# #.### #  .#.  # ...  .  . #.# ..# ##.##. # #.#### #
#.  ...#.#.# # #.  . . ##.##.  ## #  # #.#### ###########.# #.#.#.## ## #..# .#.#
### ##.# .. ..##.####.# .##.# #. .  #o.#   . .. . . . ... # .#  .. . . ..# .# #.#
#.# # .###.##.#.. ..# .#..  #..####..# # # #.####.### ###.# #..##.#.##### .# .#.#
# ## # . .# #..#.####.##.### .#  .. #  # .# #    #. .##.#.#..#.#..#..   .#.## ###
# .. ..## #.# #..#.... .   .#.# #.# ##.#.#  . ### ##    # #.##.## ## # #.#.   ..#
## #.#..#.# #. # # ## ###.#.#.# #.#. #.# #.##.. .  ..#.#..#.#  .#. #.#.#  #.#.#.#
#. ### #..#...# # ##=##.## ## ## ## ##.##.#.######## ## ##.#.#### # # ##.#..# ###
# #... .# ####    ... .. .. . . . ....   ....    . .  . .  .  .. .#.  ....# #. .#
#.#.##.#......#.#.## ## #.## # ## # ##.##.#.##.# #.# ##.# ##.##.#. # #.#.#  # # #
#################################################################################
