########################
#. .o.    ## ## # #.# ##
# ###### #          .. #
##     # # # # ## # #o##
## ### # ## #\# # ## # #
#  . #.#  ....         #
## ## ## ## # # # ###%##
#   .    # # #. #.#.# ##
# ## # #.#    #.#.# #  #
### ## #.# ###.## # #.##
#   # # .#  . ..  # # ##
# #    # ##.#.# # # #  #
### ####  #. ##.# # # ##
#  . =   #  #  . .# # ##
# # # ##  # #.#o#  =   #
##=#.#.#.#  # # # ### ##
#    .    ## ##.# #.#. #
# ## # # #  .   # # # ##
# # # ## ## # #  .# #  #
#  .    . =#. # #.# ####
######### #.# #o# . .  #
#   .  .  #   # # ## # #
## # ## #   # #.# #. # #
########################
