##########################################################
# .... . #.# ## ..#..  # #.#  .. # ## #......#...# .# #..#
##.#.# ## . .. .#.#.###......## #.  ...##.# # #.##.#..  ##
# . #. #. # #.#.## .  # #.##..#=..## # .#.# # ...o.# ## .#
##.#.####..# .#..# #.# .##.##. ## # #.# .#    ####..#..# #
#  .. .# .# #### #.#  #..# .#.# . #  .  #.### .  #.###. .#
##.##.## #....#.#. .##.# #.#  #.##  ## ##. .##.# #  # .# #
# ..# # ...## #.## #o...#...#.#. # # .  . # . #. ###.##. #
## #. #.# ##.#.. .   #.#. ## ##.## # ####  ## ##..  . . ##
## # #.  # ..#.#.## ##..#.       .##.#. ##  #  ..#.# ## .#
#. o#..#.#.## ..#.#.#..# .# ##.###.  .o# ##.# ##. # . .# #
#.# .#.##.   .# ..#..#.## # # # .# ####...  .# # ####.# ##
#..#. . . #.##  # .# # .. #  .. #  # .  ### #.. .##  ##. #
#.### ## ##..#.##.#.#. #.#.#.#.#..#..#.#  .#..#.#  # # #.#
# .#  ##...#.#. .## # ##.#..# # .# .#..###  ##. .#..  .. #
# # # ..# #. ### .. #. .###.#. .# .#..# .# #..#.# # ## ###
#.  # #..###   # ## # ##.#..#.#.#.#.#. # ..#.#=....##. #.#
##.#.# #.###.# ## #.# .  #.##..# #..#.# # # ..##.#..  #  #
# #..#  ..#   #. .##.### . . #. .  # .#..   # #..##.#.. ##
# ##.#.#.# #### ## #...#.# # ##.#.#.#.# #### .###  .# #. #
#.  ....#  . .. .# # #.#. # ...# .#=#...# .. # ..#.##. #.#
###.## # ##.#####..# #  .#..###  ##..# #.###..#.#.##..####
# #...#. .    ... ###.# #.#.#. #..  ## #..  .#  ....#. #.#
#..#.#  ##.### #.#.##.# # .. .#  # # ..# #.## ### #..#  .#
#.#.# ## #.#  ## #. ..##.##### #  #..## .##   #=#### . # #
#.# . .. #.##...#.#.#..# . ..... #.#.#.#  . ##.   #..#.# #
#.  ##.#... #.#.. #.###..## #.## ...#. #.##. # ##..##. #.#
#.#.#.##.###   ##.   ..#..#  #.##.#.#.#.##..#.. .# .###. #
##  # # .  .#.# ##.# #   ## #  .#.## .  ..#  # #.# #. .###
#.##..  ## #..#..  .#. #.# .# #.#.  ###.#...##.## . #.#  #
# ##.##..#. #..### # ##.. ##. #  # #..##.# #  #. .#   #.##
#   ##..##.### #. . ...### ## # # .. #.. .#.# ..##.##  .##
#.# . ##.. ### .# ## #.. #..#.#..###..###  ..### .....# .#
# ##.# #.#..#. #. #.# ### .# .# #... ## # #.#..#.#### # ##
##...   # .#.#.#.#  . ..# # .#...#.### .  .# # # # ..#   #
#  #.#.# #.#.# .#..##.# #  .#.#.#..#.  ## #.   .### ##.###
##.#.## ...#.## .# . #.##.##..#.  ## ##. #. #.##.#  ...  #
##.# ...##.   # ##.###.. #.  #. #..   . #. # #  .# ## ####
#  .###.#  ##.  . .# ..# .# #. #. ###.### ## #.#.# ##.#..#
####. .#  #. .### # #.#.##.  #. ##...#..  ... # .#. .# .##
#   ##.# ###.# . ##.# # ..#.# .# # #  # ###.##.#..# ###  #
#.#..#.#. #. .#.#.  \. ## # ##.#.....##. .# #..#.##. #  ##
# ##. .  # .##..# ##.#..  #.  ..##.# # .##...# . #  #.#..#
#.. # ### # . .# ...#..# #.## #. .# .. #  ####.#.  #..  ##
# ####. ..# ##  .# #  ###. .#.# #...# #.# .. ..# ##.##.#.#
# . #.## # # #.#. # #  #..## #.#.# ##.#..#.#.#. #  ... . #
##.##....# ..  #.# ..##.#. ... .  #.. ..##.#..#.# ## ##.##
##  .## #  ##.##.#.#..#  ## ##.## #.## # .#..#### #.## #.#
# # #.#.#.#..#. .#..#...#...#..#... # # #.# ###   ... .#.#
#. ##....# # # #..##.#.### #.# #.# #. ... #.## .#.# # # .#
# # .# #..... ##.# ..#.##.. ..# ###.####.# ....##.# .## ##
# # # ..##.#.#. .. # #..  ##.#.  #.....# # #.# . ## ##.  #
#.#.##.#.#.#.##.#.### .####. ### #.#.#.#..## # ## .  ..###
# .. ..#  .#...  # ### #...# ... ##.# .. # .# #.#.####.. #
#.#.##.# #. ##.##. .##..#.##.###. #.# ## .#.. .....  #.#.#
## ## ## ##..# #.# #. .##. . .. ###.. .#.# ### # #.#.#  ##
#. .. ..=.#.# .. #   # . # ##.# .. .#.#. .  . . #  #. #% #
##########################################################
