#####################################################################################################################
#.#.#.#..#...... ..#. . #.#.#..#........#....###.#. ... ... ......##.# ## .#.##.#.#.# .....#.#..#=#.##..#.......#.  #
#. ...#.#.# ##.####..##.#.#..#.###.#.##.#.##..#...#.#.# ###.##.##. ..#.. #......#.#..# ####...#.# .....#. #.##.#..###
#.#.#...#.#.#..... ##.....#.#.... #.# # #.#.=#.#.#...#.#..#.#.#..#.# ##.#..##.#.#. #.#....#.#.#.#.## #.##. #.# .#.#.#
#..####.#.# ######....##.#..##.##...  ..#..#.#....# #. .#.#.#.# #.#.#.  ####.##.#.##.####.#.###.###..##...#....## ..#
#.# #.# #.#.......#.#.#...#..# .#.#.# ## .#. ##.##. #.#.#.#.... . . .##............  .... ..... .  # .#.##..# ##..#.#
#.#. .#.....#.###.##.#.#.##.# .#..#.#.#.#.###.#.# #.# ### # ####.#.#.#.#.###.##.#.########.####.#.##.##.# ##.#..#.#.#
#.#.##.#.##.#..  #. .# ..#...#.### .#.#.# ... ... #.......#.#...# #.#..##.. # .#.#.....  .#....#..#..#. .....#.#..###
#.#.....#...# ## #.#.#.##.#.#.....#.#... ## ##.##..#.## #..#..#.#.#..#..#.#..#.... ##.####.#.#.##.##..#.##### .##...#
#.#.#####.#..###.#.#.#....#..#.##.#..####.## #.# .#.#..## #.#..##.#.##.#.##.##.#.##.#.#....#.#.. ....#..... .#..#.#.#
#.#.......#.#.#.#.##.#=#.#..#.. # #.#........#..##.. #... ... # ...............#..#.#.#.##.#..#######.#.#.## #.##.#.#
# .##.###.#...  .....## #.# .#.#.#.#.####.####.###.#...##.####.###########.###..###.#.# #.. .#.  .. ..#..# .# .#.#..#
#.##.##.#.#.####.#.#.... ...#... ............ . # .###..#.. ...............#.. # .. #.#..#.#.#.#.#####..#..#.#.. .#.#
##......#..#  ..#.#.#####.#.##.#.#.#####.## #.#..##....## ##### ##.##.####.#.#..#.#.#.#.#..# #.#.#. ..#..#.#.#.#.##.#
#..#### ###.#.#.#.. ... # #..#..##.# ....#.#.#..#.. ##.#..#... ..#. #....# #.# #.##.##.#.##..# #.###.#..##.#.#.#.#. #
#.#.. .. ... .#..# #.##.#.#.##.#.. ##.##.#....#.#.##.. .##  # #.#..# .##..#.#. #.#. .. ....#.#.#......#.#..#.#.##.#.#
#.# #.##.#.#.#..##.##.##.#..#..#.##.##..#..#### #.#.#.#. .#.#.#..#..#.#.#.. .#.#.#.###.#.#.#.#.#.#.#.##..#.#.# ... .#
#.#..#...##...# ......... #.##.#.#.....#.#.. .. .##.#.#.#.#.#.# #..#. #.#.###..#.. #.#.#.#.#.#.#.##....#...# #.## ###
#. ## ##...#.#.###.# #.# #...#.#.#.##.#..#.#.##.#.....#..#..# # .#.###..#....#.#.#.#.. # #.#.# .#.#####..#.#.# #..#.#
# #......#.#.#......#.#.#.#.#..#.#.#.#.#.##.# #..####.###.##.#.##......#.#.##..#.# #.#.#.###.# ##... ..#.#.#.#..# ..#
# .#.####.##  #.#.#...#.#.#..#.#.# # #  .. . .# #  ..#.........#.#######..####.#.#.#.##..  ..# #..##.#.#.#.#.#.##.#.#
#.###.  ... .# #. .#.#... .#.# ##..#..## ####.#..##.#..#.#####.#.........#.##..#.#.#...#.#####.##.#.#.##.# #.#.#.#.##
# .# #######.#..#.#.#..###.#...  #.#.#  .....##.#.#..#.#.#......###.### #....#...#.###.#........ . . ....#.#.#.... .#
#.#.... . .# #.##. . #....#.##.###.#.##.# ##.#..#...#..#.#.#.#.#....#...##.#.#.##... .#.##.##.#.#.####.##.#....## ###
#.## #.#.#.#.....#.#.#### #.##.#. .#.. .#.#..##.#.##.#..# # ##..###.####.#.#..#.#.##.##.#.#. #.#.#...#.#..#.##. #...#
#...# .#..##.#### #.#..........#.# .#.#.#..#..#.. #..# #%.. ...#..........#..## #. #.#.....# ....#.#.# #.#.#.# #. # #
#.#.##.# #. ......... #.# ##.#.###.# #.#.###.# .##.#.#.#.##.#.##.##.#.#.#.## #  #.#..#.##.#. # #.#.#.#.#.#.#....#.#.#
## ..#.#.#.##.#.## ###...# .#. .  .... .... . #.#....#.# #.#.##..#..# .#. .#.##.# .# #..#..##.#..##..#......##.#..#.#
#.#.##.#.#..#.#..#.#..#.##.#..##### #### #.##.# #.#.#..#. .....#.###.## #.#.......##..##  #.#.##. .# #.#.###....#.#.#
#.#.#..#...#..#.#...#.#.....#.#...#.....#.##. #.#.#..#.# # # #.#.... ...#.#.##.##.#.#...# .... #.###.#.#.#..##.#..###
#.#.### ### ##...#.##..#.##.# # ##.##.# ....#.### ###.##..# .#..###.##.# .###.#.### #.## .###.#..#....#...#..# .#. .#
#............ #.#..#. #....##.#..#...#..####. .......... #.##.###.## ## #.......... . #.#.#.## #.#.##..#.#. #..#..#.#
#.#.#.## #####..##.##.##.##.....####..#.#..#.# # ##.#.##.#... ...... ..  .#.#.###.#.###.# .......#.#. #.##.#.##. #..#
##.#.#.###....#..#.....#..#.####.#.#.##.#.##..#..# #.#.#..#.# ###.####.##..#.##..#.# ... ##.####....#.# ...#.. ##.#.#
#.  .. ...# #..#.#.##.#.###.#. ....... .#.#..### #.#.#.#.#.#..#.#.....# #.# ...#.#..#.#.###.#..# #.#. # ## # #. ....#
###.#.#.#..#.#.##. #..#.....# ###.#.#.# #.##. ##.#.# ..#.#..#.# ..###.#.#.###.##.#.###. .#...#..# .##..#...#.# ###.##
#..#.##.#.#......#..#..#.#.#..# #. #..#....#.#...#.#.#.#.#.#...####.###.# . ........# #.#.##.#.#.#..#.#..#.#.#.. .#.#
##. .. .#.#.####.#.#.#.#.#.####.#.#.##.##.#...###..#..##...##.# ........#.#.## #.#.# ...... #. #.#.##.####...# ##. .#
#.#####.#.#.. .#.#....#.#  .....#.#......#.#.#...#.. # ..##.#..######## #..# ## ##.#.##.# # .#.#...#.......##.# #.###
#.#...# #.#=#.#.. #.#.#.#.#.#.#.# #####.##.#.###.#.#..##....# #... .....#.#..   ..#...#..#.#.#.###. #.###.#..... ...#
#.#.#.#.#..#.#.#.## #.#..#.##.#.#..... ....#. . ...### #.###..#.##### ##..##.##### ###.##....... ..##.#.## ##.##.#.##
#.###.##. #. .... ..#.#.#.....#.#.####.#.##.#.#.###.. ... ..# #.#.. .#..# ...... ........###.##.##.#..... ..#.#.#..##
#........# ##.##### #.#.#.#.# #.# #.....#.....#... #.####.#.# #.#.###..#..##.###.##.#.##.#.#.#.#.#.#.###.####.# ###.#
###.#.##.. .#. ...#.#.#.##.#.#.##  ######.#.#.#.##.#.#...#.##.#.# ...#.#.# .#....#.#.# # #..## #.#.#.# #......... ..#
#.# #.#..# #..####. #.#........ ..#. ....#. #..#### .###.#... #..###.#.##.#...##...#.#.#.#.#.....#.#....## ####.#.###
#.# .#.#.#..#. ...#.# #.##.#######..##.##.#.#.#.##.##......## # #....# . . #####.#.#.#.#.. #.#.##..#.####.#....##.#.#
#. .#... ###.#####.##. #.##...... #. #.#....#.#.....#.# ###...#.####.#.#.#. . #..###.# .#.#.##.#.#.###.... #.##.. #.#
##.#.#.#........... . #...# ####.#..#..#.##.# #.#####..#..#.###......#.#.#.###.#.....#.##.#. . .......###.##...##.#.#
# ##.##.####.#.#.#.##.#.#..##.  . #..#..#   #.........# .#......#.####.#.#..... ##.### #.. #.#.###### #...#..#.. .#.#
#....... .  #.# #..#. .#..#  #.##.###..#.###.######### #.#.####..#  ...#.#.#.#.###.o...##.#.#.##... #.###. #.###### #
# ###.#.###.#.#..#..#.#.# #.## .#.. .#...  . .. .. . ..#.#.#..#.# .#.## #..#.#..#.#.##..#..... .###.#. . .# ........#
# #.##.##.#.# #.## #......#... #..#.#..#.##.#.##.###.# #.## # # .#.#.##.##.#.#.#. ...### .##.##.......#.##.#.########
##.. .......#.#.# ..#.##.#..# #.#.#..#.##.###...#...#..# . ...# ##.#. ...#.#.#.##.# #...#..#..# # ## #..#..#. ..... #
#.## ######.#.#.##.#..#.#.###.#.#.# #........#.#..##..##.#####.##..# ##.#..#.#...#..#.#.#.#..#.#.#..# #..#.##.# #####
#.........#.#.#... .# ..........#.#..#.#.# ##.#.#.#.# .. #.......#..#.#.##.# #.##.#.#..#..## # #..#.#.#.##. .#..#...#
##.########.#..#.##..#.##.##.# #. #.# .#. #. ..... . .##.#.#####...#. #. #..#..#..# #.#.#. .#....#..#.# #..#..#.###.#
##.#.. ... .#.#.# ### ## #..##..# #.##.#.# .###.###.#.#...# .....#..#...#.#.###.#...# #..## #.##..#.#.#..#.##.#... .#
#.##.#.##.#.#...   ...#..##....## # ..#.#.# #.#.# ..#..#.#..#.#.#.##.## #..#.... ####.##.# #.#.#.#.... .##...#..# ###
# . .#.# # .#.#######.##...#.#.#..#.##.... #..#.#.#.#.# ..# #..#...#..#.#.#..# #.#................#.#.# #..##.#..#..#
#.#.#... .#.##.... ......####.#.###....#.#.  #...#.##..# #..#.#..#.#.#..# .#..##..##############.##.#.#..# ... .# #.#
####.#.##.#...######.### #.#........##..#.##..###....###.##.#.#.# ##..#.# # .#. .#.. ... . .... ....#. #.#.##.#.#...#
#.# .#.#..#.#.# ... # .#.#.. #.#.##.#..#..# .# ...##......#.#.#.#....#.##.##.#####.##.#.##.####.#.# #.#...#.# #..## #
#  #..# ##.##.#.#.# ##.#..##.##.#.#. #. #. #..#.# #.#####.#.###.####... ...........#.#.#..##...#.#.. #..###.##..#.. #
#.#.#.........##.##......#..... ...##. ##.#.##.## ... ..#.#..........#.#.#.#########.#..#...# ## ##.#.### ....#..##.#
#. .#.##.#.#.# . ...#.##.###.#####...#. ... ......####### #.#####.##.#.##.##.. ........#..# ......#.#...  # #.#.#.#.#
#.# #...##.#.##.#.# #.#.#....#.. ..#..# ##.##.# ##. .......#....#..#.#.......##.##.####.# #.#.###.#.#.#.#..#.##.#...#
#.# #.#...#.....#..## #.#.##..# ## .##.##.#.#.# #.##.####.#. ##.#.#..#.## ####.##.......#.#.#.#.#.#.##.#..#.. ..#.#.#
#. ## ####.#####.###.##.##.#.#.# ###.. ......#..#.. .#..#..#.##.#..#.#.#..#.. ...#.#.##.#.#.# #. .# ....# .#.##.#.# #
#.#..... . .......... . .... .......##.#.#.#..#.# ##..#.#.#...\#.##..#.##.# ##.#.#.## ##. #.#..#.#.#.#.# .##. #.# ###
#..##.#.# ####.####.##.###.#.#.##.# .#.##  # #.#.#..##..#.#.## ....##...#.#.#.#..#......#.## ##.#...#.#.#.#..#... ..#
#.#..#.#.#  . .#...#..##.##.#.#. #..#....#.#.#....#.#.#.#.##.#.#####.#.##.#.#.###..##### .  .....##.#.#....# ##.##.##
# #.#..# .####.# #.#.#. ........#  #.# #.#.#. #.#.#.#... ......#.....# #.#.......#...... ###.### .#.#.#.#.#...#.#  ##
# #.## ##.#..#.###.#.## ##.#.##..#.#..#.# .#.#.#..#. ##.#.#####..###.#....#.##.#..#.## ## .### #.#..#  ##.#####..#..#
#.... ....#.#......#..#.#.#.#.#.#..##.# ## # #..#.# #.#.#.#... #.# #.#.##.#.## #.#..##.# #...o ..## #.#... .....#..##
#.#.#.###.#..#.#.##..#. ......#. #.. .#....#.#.##...#.##.##.##.#.#...#...##.. #.#..#.....#.######... .###.##.### # .#
#..# #. #.#.##..# .#..#.####.#..##.##..#.##... ..##.#........# #..##..##.#..#.#..#.# #.#.# ... .#.#.##.....# ..  #.##
#.#....#.. .#. #..# .##.# . #.#...#.#.#.#.##.###..#.# #.###.#..# #...#..#.#.#.#.#..#.#..#.#.#.##..##.####.#.####.#..#
#. #.#.#######..#.##.#..#.# ....##..#.. .....#...# .## .#.#..#.# #.## #.. . #.#.## .#.###.##.#.#.#.#.  .#. ... #.####
#.#.##......#..# .....#.#.#.#.##..#..### ##.#.##..#..##...#.#..#..#  .#.##.#.##..#.#......... .....#.##.#######.....#
#.....##.###.#.###### ### ##.#.#.##.#...#.# #.#..##.#.. ##...#.# ##.#.#.#.#..#..#..#.#.#.#.#.#.#.##.#...... ...#.#.##
###.#..=........ .. ... .......... ..##.# #.#..#.#. ###   #.##.#.. ..#..#  #.##..#.#.# .##.#.#.#..#..##.## ###.#. #.#
#...###.###.## #.###.##########.##.#..... #.#.##.##....##.#.# .#.####.#.#.#...#.#...##.#...#.#.# #..#. . .##.#.#.#..#
###...# #..#... #..#.#.. .. ..#.. # ######.##.#... .#.#..#...#..........# .#.#...#.#....##..# ##..#.#.##.#...# # o#.#
#...### .#.#.###.#.# ########.####.........  .##.#.#.# # ## #.#.##.##.##..# ..#.##.#.#.###.#.. ..##.##.#.#.# #.#.#. #
###.# . #...#....#.# .  .. ......# #.# #######.#.#....  ..#....#..#.#.#.#.##.##.#. # # .#. #.#### .......#.#.#.##.# #
#...#.#..#.#..#.#...##.##.#.#.##.# ##.#.........#..##.#.##..### #.#.. #....... .#.#.#.####.#.. .#.##.#.##.#..# .. #.#
##.# ##.## ##.##.#.#.#.#.#.# # #...... .##.##.#..#...#.#..# ....#.#.# ###### ###.. ..  .#...# #.# #.#..# .##.#.## # #
#.##.#......# .... ..#....... ..#.#.## #..#...#.##.##  .# ..#.#.#.#.#..... . ...#.######.###.##.#.# .#.##..#...####.#
# #..#.#.##. #####.#..##########.#..#...# #.#..#...# # #.##.##.##.#..#.##.##.#### #..  .... ......#.#.. #.#.## .#...#
#.##.## #...#  ....#.#... ... ....#..#.# .#####.##.....#  ........###.#.##.#.# ....####.##.####.# #..#.#..#....#.##.#
# . . ....#.####.#.#..#.#.##.## ##.###..# ..#.. #..#.# #.#.##.##.#...... ... ##.# # .....#.#..###.#.# ..#..#.#.# ...#
#.#.#.##.#... ..##.#.#. #.#.#..#..... .##.### ##.#.#..#...# #.#...##.###.# #..# #  #.##.#..#.#....#. #.#..#.##. ###.#
#..#..#.#.#.##.#...#..# .#....# .#.#.#........##.#.###.#.#..  .#.##.#...#.#. ##.#.# ..#..# #.##.#.#.#..##..... #... #
#.#.#.. ..#..#.### .##..#.#.# ##.# ##..# #.###.... ..  #..######.#. #.##  .#.#.##.####..#..#..#.#.. #.#.##.####.#.#.#
#.#.##.####.#......#..#...#..#..#. ..##.#.##..## #.#.#####......  #.# #.#.#.##. ......#. #.#.#.#..##..#..#.# ...## .#
#.# . #... ..#.# ##..##.#..# #.#.#.#.#. .. ..## ## # ..#...###.###  ..........#.##.## .##.##... #.#.#.#.# #.# # ..# #
# #.##..### #.#.#.#.#....##..#. .# .#.## #.#.# .. .##.#..###.# # #.#####.#.#.#.# ##.#.#... .#.#.#.#...#......#..###.#
#.#...#.# #........ #.#.#..#.#.#...##...##o#.# #.#...#.# #...#.#.#... ..#.## #. ..... .#.####.##..###.#.##.# .#... .#
###.###...#.#.#.#.##.##.##.#.# ###.# ##.#..# #..#..#.#...#.#.##....####.#.  ..#####.#.#. .. ....#...#.###.##.#..#####
#.......##.#.# ##.# .#. ......#... ...#.####.###.##.# ##.##....###. ...###.#.#. ...##.####### ###.# #.... ...##.# ..#
#.#.#.#........#...#..#.###.#.######.## ..... ....   ...... ###...#.##. ##.#.#.###.................#.###.##.#...#.#.#
##.#.#.#.## ###.# #. #.#. ..#. ......#.##.##.#.###.#.#.##.##. .##.##.#.#.. #.#.#..##.#.##.#######.#.....# ..###.# # #
#.......#..# ...#.##.#.##.#.#.####.#.#.#.##.##...#.## ##...#.#.......#.### #...#.#..#.#.#.......#. ##.#..##.......#.#
##.#.##..#.#.##.#....#. .###..#. .#.#..#.#.. .##.#...  .#.#.. ### #.#....#..##.#..#.#.....#####.#.#..##.###.#.####.##
#..#..#.##.# .#.#.##.#.##.#.##.##.....# .##.##.#.###.#.##.###.#.## #.# ##.###..#.#..#####.#...# #..#.#...#.##.#..#.##
##.#.##.. .. #####..##.#.... .....####.#... ...#... #.# ......... . .........#.#..#........#.##.#.##..#.#.....# #...#
#..#...#####.##.#.#. ....######.#........#.#.#.#.#.#.. #.#.######.## #.## #.#. ##.#.###.#.#.....#....# ..#.##.#.##.##
## #.### .. ........#.###. ....#####.###.##.# ##.###.##.#.##... .#..#.##.##..#....### ###.#.#.#..###..#.###. .#..#.##
#.#.....#.##.#######..#.#.#####.# .#.#...... . ..............###..#.... ....### ##. .. .. # #.#.#..#.#...#..#. .## .#
#..#.###...#.#......#. ...........#...## ##.#.##.## ##.##.##.#.#.#..#####.##.#.#.#.## ###.#.#.# #.##..# #.#.#.#.#. ##
# # . ..#.#...#.#.### #########.##..###.## #.#.##..##. #.#...# #.#.# ....#... .. . #.#. #..#..#.#.#.##  #.#.#.#.##.##
#..#.##.#.##.#.##.#...#........ . ##. .... ... . .#..#.#.###.#.#.#.#.###..##.##### #..#.# #.##.##.#.#.#.#.#.#.#....=#
#.#..#.#....#... .# #. #.# ####.#..# #######.#.###..#..# ..#...#.###.#...#..#....#.#.## #.... . ..#...  #.#.# #.###.#
#..#. ..# #. ####.#.# #..#....#.#.#..... .  # .#..#..#..##.##.#.......##..#.# #.# .#....### ##.##. #.##.#...#.#.#...#
# #.# ##..#.#.  ....#.##.#.##.#.#..#.#.#.##.###.#.#.## #.......#.#.# #...##.###.##..#.#... .#...# #.#.#.####.#.#.##.#
#...... #.#..#.##.#..#. .#...#..#.#.. # . #............# ##.#.#..#.# .##....  .. #.#...#.#.###.#..... ...... . ...#.#
#####################################################################################################################
