########################
#   # .....  #.=  # #=.#
### . ##.#.#.##.#.#. # #
# #.### # # .  . #.#  .#
#  .#.    .#.##.#  o.# #
#.# # ######\# ..#.#  ##
###. . .  . #  ## ## #.#
# .=#.# # #  # . ..= ..#
##%#o# # #.## .# ## #.##
# .   . oo  .#.### #.# #
#.#.# #.# ## # ..  . ..#
########################
