##################################
#.# #.   .# o.  ..# # #   # # #..#
# # # ##.#  # # # . #. # #.  ..#.#
#.# #...#.#   ##.##.#.## ## #### #
# ..#.# . # #..   ..=  .  .     =#
# # # . # #. ###.## ##### # #.# ##
### #.### # #..#.#  #   .# #.# # #
#   # #...#. #.# .#.##.### o.. ..#
### #.###.#.#  # #.  #.#...###.# #
#.....  .\. ## #  # #  .##   # # #
##.# # # ##   .#.#. .#.# # ### #=#
# ##o## # # ### #.# # .  %    .. #
#..   .    .     .  .# #.# # #.###
##.###.## ## # ##.# ## ### ##=## #
# .# # #  #  #o. ##  .   .   ... #
##.. #. #..# # #.   #.# ## #=# # #
##################################
