#################################################################################################################
#  # ##.#.## #.## # # ## ##.# #   #  # .     ## # # ##=# # # #.#      .    .. #   #    # # # ##  ## # ##.## .#  #
# #  .    .       .    .    # # ### #..# ###     . .       # # .############# ### #.##  .      #   .  .. . # # ##
#  ##.# # #.# ## #.# # ##.#.#        # ### # ## # #### ### #   #            . .   .    # #.#### .# ##.# ##.# #  #
# #.# ## ## ## ## # ## # ##.#.##### #      #. #.# #  .#  # . #  ##### ################ ### .  .#. #.# ## #.# # ##
#   ..    =   .    ... .       .  =  # ## #  #  ### ###.## # # #     . .    .      .     ..# # # #..       # #  #
###### ## # ########## ## # # ## ####  #=#.#  #.           #.# # ## ###################### # #.#  # ##.# # # # ##
#                . . . #  # # .# #. ## # # # #  ####.######  # # #. ... .           . =      #   # ..# #.#.# #.##
### # ### ## ####### #  # # # ## # # # # # #. #            #.# #.######### ########## # ## # # #  ### # ## #.#  #
#. # #  # #     .     .##.# #    #.# # # # # #. ## ### ##.#      .                  . #. # # # # #         # #.##
# #  # ## # #.#.## # # #. # #.## # # #.#.# # # # # #  .#. .# ########## ######## ### #  # .# # #. ## # ### # .. #
# ##.#.#  ## #.## # #. # #    #  # # # # # # # # # # #  ## #               = . .      # ## # # #.#  # #. # # ## #
# .  #  #  ..      . #    #.#  # # #     # # #   # # # # # # # ### ############ ##### ## # ## ## # ## ## ### # ##
# ###  #  # #.## ## #..# #  #.#= # ###.### #.# # # # #        ## #            # #        ...                .   #
#  . # ## # # #   ##.#.#  #.# .# #  .#.#     # #   # #.#.### # . # ####.#### # .#.# # # # # # ####### ### # # # #
#.####  #.#.#  # # . # #.## # #.   # #  ## #.# #.# #   #   # ###        #   . # # #.#  # # ## #.      # ## # # ##
# .    #.   # #  # #   #.  .   # #   # # ##  # # # # #.# ##.   # # # ##.#### # .# # #.#       # # ###   . . ..  #
###### ### # # #   ## # ########.# ### ..  # .## # #     # # ##  #.   #  .   .# # # # ## ## # #.#   # #### # ## #
# .       .    . #    .  . .     .     # ## .#   #   #.# #   ..# ## ##.###### # # ##.  # # #  # # #   #.. # ## ##
##.# # #.## ## #. ####### # ###### # #..# ## # # #### ## # # ##.     .        # ..  # #     # # # # #  # # .  . #
#.# ##    #.#.#  #       #        .# # #                # # . ## # ####### #.# .##### .# # ##  ##.#.  ## ##.### #
#  .  #### =#  #  #### # ## ### ## #.#  .#.## # #=## ##    # # . # #      # # # #     #  ###. #   # #..    ..   #
# # ##    # # #  #   # # .# # ###  # # # ## ## #.## # #=# #.  ## # # #### #      # ## ##    # #.# # # #### #### #
#.# ## ###  #. #.### # #.#     . # # # # . ..  .  .     #  #.#   #.# #  # # #.#.# # #..  ### .##    # #  . #   ##
# ..      # # #   .#  #   # ######.#.# ## ### ## # #.## # #  # # ##.## ## ### #       ## #  #.  # # # ### # ##. #
# #.# ## #  # .#.#  #  # ##  ..   .. #  # #..#  #  # #  # ##..  .               ### # #   # # ##  # #   ..    #.#
# ## ## # #.# #  ####.## # ########### # #.# ## ### # #=## # ##.### # # #####.# #.### .# #    # #.# # ##.### #  #
#      .    #  #   .                  .         .   .        .#   #   # #     # ..  . #   # #.# #o#    # #  #.# #
##=### ## ##  ## ### # # # # ## ### ## # #### ################ ###.# ## ###### # #### .# #.   # # ###.# . # # # #
# ##.###.## # # .# # # # .# #    . # .#            .    ..  .      .             .    #  .# # # #   #  # #   .# #
#   ..      . ## # ###.# ##.# ## ### #  #### ### ## ####.## # # ## ## #.#### ## ### #  # # .# # ##### ## #.## # #
##.# ## ## ##  #  . .  .    .         # #   #     # #   # .# # #  # ##.##  .  # # #.# ##. # #.#   .   #   . # # #
# # # ### #   ##.# #### ### # # ## ##   ..# .# # #  # ### #     # #.      ## #         .###.## ####### ## ##..# #
# .       .## #. # #   #  # # ## # #  # # #.# #   # # #    #.#### ####### # # ### # # ##         . .   .    #.# #
## ##.## #  .. # # # # # #  #    #  #.# # #. ..# ##.# . # ## .          . .     .   # #  ### ##.# ##.## # ##    #
# #.#.# ##.##### # # ### ## # ## # #  #     #.#  # .# ### #..### # ## # # #.# # ##.##  # #. # .##  #.# # # # # ##
# .     .  #     # #    . #.# # .#  #.# # # # ## .#        # # # #   #     # #.## ##. #  ##  #    # .#.# # # #. #
## # ## ##  # ## # .# #.# # #. # # # .  # # ##.# #  # ###### # # # #   ## #  #      # ## .# ## ##.#### # # # # ##
# ## #.# # # #.#.. #   ## #.# ## #  # #.# #    #  # #   .    #.#.# . #     # # ## # #    ## #  #           # #  #
#    #  .#    =#.####.#   # #    # # .#.# # ###  #  ## ###.# # ## # ## ##### # ## ##  ## #  ##  # # ## ###.#.# ##
#### #.### ####  #.#.# ## ### ##.#  # # .##.# ## ## .      #       .          .   . #.#..## .  #   # # # . # # ##
#    # #   #. .# #       ..    . # # .# #   #  #  #.## #### ##.## ## # # # # ###### #  #  # ##  # #  . ###.  #. #
###### ### ## # # ## ########### ## # #  ## # #  #  #  #. .   #   #. # # #  #   ..# # #  #   # #  .###  .  # # ##
#.   ...                 .    ...       # # # ## .# ###.## ##.####.## #. # ## # #  .#. #.## #  .# # .  # # #.   #
# ### ##.# # #.# # # ## ##.# # ## # # # #.#    # #               .  .  #=# #  # # # #.#  .# .# #.  # #  # ## #.##
#    #.#  # # # # # #.### # # # ## # ## # #.## ##.##################### ## ## # ## #.  # #  #  ## # # .#  .  # ##
# ####. #                               #.#.. #    .... .    .        .         .. .# #   #.##    # ## ### # #  #
# #  . #.## # ##### ## # ##.# # ## ####.  . ##  ## ## ## #.### # # # ############ ## . # #   . ## #   .  . # # ##
## ### #  #  #.    # # ### #  # # #  .  ###   #  .  # #  #      #.#.#..      ... #  # ## ## #### # #.# ##### ## #
#      .# # #. ### # #.  .  # #.   # ## . # # # ###.  .#  #######.# ## #.## ##.# # #  .           ...     . .  .#
#### # ## #  #.    # # ##### # ##.## # .### # # #=## ##  #            # ## # ### #  # ## ## # # ###.# # # ### # #
#. ..# #  #.#  # ### # # .  . . . #. .# #    #      . .#  ## ####.# #.           #.#   ##   # # # .# #  # #..# ##
###### ## ## #       #.  ####.###  # #  # # # # # ### #  ##  #    #  # ####.#### # ## #   ## # # #   .#.#.  # ..#
#         .    ####.## #        # ##  # # #     # # ## #.  # # ## # #  . .#.#    #     ##. ...   . ## # # # ## ##
# # #.######## #       # #.## ##     # .#.# # #.#.#  . # # # # # .#= #=## #  # #  ### # ########## #  # #       #
# ## #.      # ##### #  # # #.# #.## ## ### # # ### ### #.# # # # # # # ## ## ## ##  .#    .  .   .# ## # ### # #
##   # ##.## #       #.#.    ..  .                .     .       .       . .         # ########## #  ..    #   # #
# ## # # # ### ####### ### ### ######## #### ###### ## #### ##########.# ## ### # #             #.####### # # #.#
#     .    .  .         .   ..  . . . . #  # #    .#  #.   #    .  . # # #.#   # #  #.# # # ## #.     . # # # # #
# # ## # ########## ### # # ###.# ## ### #.  ##.##.## # # ## ## #####  # # # #.  # ## ## # # ## # ###### #.# # ##
#.  # ##.#  . . .  #  # # . .  # #  #.   #.#  ## #             .     # # #.### #         ...           .        #
# #     .  #### ## # #  # ### #   # # ####.#.#     ## ###### #.#####   # #     # #.##.## ### ## # # # ##.### ####
#  ####### # =.  .  . # # # #  #.#  . .      # # # #. # ..  #      #.# ## #### ##=##  ## # ### ## ## #  .# # #. #
#.#     .#. ### ## # #  # .   # .# #.# # # #  # #  .# # ### .# # # ..#  .  .=      .#     .          # # # ##  ##
#  # #.#.# #    #  #  # # # # .#. # # # ## # ## ##.## # #. .# # ## # #.## ##.### # # =# #.# #.# # ##. # # .  #. #
# ## # #.# #.##  # # #  # .# ### #    .   .#          #.# #.        .# # ### #  # # #  # ## ## # #.#.#  # ##  .##
# # .#  ##  # # ## # ## . #  .    ##### ## ##########   # # # #######  # ##= # ## # # # .            # ## # ##  #
# ## #.#   #   .#  # .  # ### ##.#.          ..   .   ## ## # #    . #..   #.#      # ## # ##.# #### #.     .. ##
#  # #.  #  ###. # #.## #    # # # ## # ## ## ## # ##.#     # .## ## # #### #.##### #. # # # # #    .#.## ####  #
## # ##### ## #### # # # ##### # ## ##.##.#.##.## #.# ##### ### # # ##      .   .  .# #  # #   # ### .      .  ##
#                                                     . .     . .      # ###.## ####   ##.# ## ### # # # # ###..#
# ### ## ## ## ##### #####.## ## ## # # # #.#####=## ##.# ## ######### ###.## .#    # #  . .         # #.### # ##
### # # # # # ## ..  #   .#  . # # # # #.## #    #   # .# #  .    .  #       # # ##   # # # ## ## ##.# #  .     #
#   #.# # # # #  #.#  ###.## # # #          # # #  ## # #  #=#.# ##.#  ##.# #  # #  #  # # #  #  # # # ####### ##
### # #     #  # #.# #   .   ..# # ########   # ##.   # # #. # # #.# # # #   # #.## # #  # # #  ## #       .    #
# # #. # ## # ##.# #  #### # # #          # # #  # ###. ##.## # ## #.# #.#####.#  ...  # # # .# # .# ## ## ######
#   # # ## ## #  # # #     # # # # ##.# #.# # # #     #              ..#      .###### #  # #.## ## #  #..# # . .#
### # # ..  .. # # # #.# #.# #  # ## # # # # ## ##.# #..## # ## # # ##   #####   \ .#.## # # #   # #.#  #  # ####
#.# #  ###### # ## # # ## ## # #    .      .        # #  #..#    # # # #       # # #  .  # #  # #  #.##  #.#    #
#     #    . .     .       . #  ## ### # # ## #### #. # ## ## ## # #.# ####### ## # # #### # ## ## #  # #  # # ##
#####.  #### ## # ##.## #### #.# =.#  #  #   ##  #. #.# #    .   # #.#     ..       # #        .     #   # #=# .#
#    .# .  # # # # # .# #    # # #  #  #.# #   # # #     # ## # #    .### # # #### #.. # # ######### ## # ##.####
## ##  #### ## # # # ## #### # # # ## ##.# ###.#.#  # # # # ## # # # #..  .# #.   #.#.# .#    .    #  o    .    #
##  . #        # #o# #    .# # # # #. #  #   #   # ## #      .     .#.# #### ## ### #. # # # # ## #  # ### #### #
# ## # ####### # #.## ##### ## # #  # # ## # #.###.# #  # # # ### ##.  ..         .   #    #.# # # # #   .#   #.#
#  ..  .=  .    .    .         # # ## #    ##    ..  =# #.# . #   ##.##### # # #.# ##  # # # # #   # # ## # ##  #
######.## ### # # ############   # #   #.#  #.# # # #.#.# # #  ##..  #   . #  # # . # # .# # # ### # .  .   . #.#
#     # # #     #. ..    ..  #.### ##.#.# ## .# #  ## # # ###.#   ## # # #.# ## ###    # # # # . ..# # # # ## #.#
# ### # ## ####..# ## # # # #  #      .  .  # ## .#  .# #     ###.# .#     # #     .# #   . # ###### ## # # ## ##
# . ..  = .     # # .# #.# # # #=# ######### .  #  ## # # # ##  #  # .# # # # # ### # # ##.# .       .    .     #
### ## # # #### # # #  .         #     .  = # ## # ## #.# #  #.# .##.#          #.# # .# # # ####################
# #   # # # . # #.#.########## #.# # # # #.#      ..  # # #.#   #    .## ###### # ### #  . # ..             .  .#
# # ### # # ### # #          # ## #.# # # # # # # # ### #.   # #  ## #.     %   #. .   # # # ######.## #.# ## ###
# # #  .#.#  .  # # ## #### #    =          =      .    # # #.  # #  ## ##### # # # # # #  # #   .# ## # # #    #
#.# #.# #.# # # # # # #   .   # ## ## ## ### ## # ## ## # #  # #  ## .# #  . # .# # #   .# # # ##      # #  # # #
# # . # # # # # # # # # ## # # # # # .# # .# . #    # # # # ## ### # # . # # ## # # # # #.  .  .  # ####   # .# #
#   # #.# # # #   #.#. ...         ###  ## ###.## # # # #     . .. #  # ### . # # # # #  # # # #.## #    #  # # #
#.#   # #.# #   # # ##############.  =#         # #   # ####### ###  #.# ## ###.# # # ###= # #.#.#  # ##.# #  #.#
#.# #.# # ## ## #         .   .    # ## ######## # ## #  . .. #.#  # #        . #=# #    #.#. # # #.#    #  # # #
# #.##  #     #  ## #.## #.## # ##.#       . .   .   .# # ### #.##.#. ##### ### ##  # #### #.#      # ## # #.  .#
# #   # # ##### #   #.# # # ## # # # ##.## ##.## ## # # #   #.#   .# #  .     #   # # #.   #  ####### # ##  # ###
# # ### #..     .####  ...       # #. # # ### #. #  # # # # #.#.# #  #.#.# ###. #.  # .# # # #  .  .   .. .## # #
# # #  . ## ### #     ########### .# #.   ##   #  # #   #.###  #.# # #.# #    #.. # #.# #  # ..# #### #### #  # #
# # .## #.#.#   #####.           # # .# #   # #  # .# # #     #   .  ### ###### ## #    .# #.#  #     # .#.## # #
# # # #.  # # # .   . ## ## ## #   ### ## ### ### ###.#  ##.#.# ## #     .          #.### # . # ### ## # #  # # #
# #.#.# # #.# #.# ##### # ### ## #.     . ..  . .     #.#  .# #  # # #####.## ## ## #..    # #             #    #
#.# # # # #  ## .        ..    . #.######.############    ### # # .#.#     # # .# # # #### #  # ## ### ###  # ###
# # # # # # #.  #.#####.# ## ###  .  .   .  . .   .   # #     # ##.# # # # #  # # # # .  .   # # #   ..   .#  # #
# # #   .   ### #     # ## #.   .# ## ## # ### # #####  #.#####. # # # #.# # #  # #.# ### # # . o .### ###.##   #
#   #.# # #     #.### #   .. # # # # ##.## #          #  .  .  ##  # #  .#.#  # # # # # ## # ##### #         .# #
###  # # # ## # # #   #.####   # #.#       ##### ####.# ######  .# #  ## # # ## #.# #. ..  .       . # # # ## #.#
#   # .        .# # #.# .  # # # #= ## # #     # #    #.#  .. .## .# #. .# #. . .   # # # #.# ##.# #     #    # #
#################################################################################################################
