##############################################
# ## ##.#.#   #     # .#  .#. .  # . # #.# #.#
#      ..   # # ## #..#. # # ## #  # # # . # #
## # ## # #   .    .#. # #..#.#  # #.# ### # #
# ## # # ## # # ##.## #    #.  .#  #.  .   # #
# .  #   #           .## # # ##  #   #.## ## #
# ## # # =#.### # ###  . #      #. # #  . .  #
# .  # # #  #.      # # #  ## #  # #. .# # #.#
#### #    #   ####### #  #  #.  ## ### ## # ##
#.     # #  #     .   # #  # ##      ...     #
# ## #.#. # ## ###### #. # #  # ### ### # ##.#
## #.# # #   .     .  # #..# #    . # # # # ##
#         #.#.# # #.# #\ # # ## ###  .. ..   #
##.# # # ##.  # #   #.##      #.#. # ### # ###
# # # #     # ..# #     .# # # .# #  #   #   #
#     .#.## ## ##.### ####  . # #o## ### #.#.#
# # ## # #  .         #.   ##  .   #   .    .#
# # # #  .# ## ## ### # ##   .#.#### # # # ###
# #... #.#   # #.   # # # .##        # #.# #.#
# ### ## ## #   # #      #  #.# ####  .  #   #
# .    .   .## # ## # ##.# #. #.     # # . # #
# # #.## ##     o     ##    # # # ## # # #   #
#    # #  # ##.## #.#    # #.    # # #  ## #.#
# #.#.   # . # # ## # # #. ## # #  # # # . # #
#.= # ## .# ##    =  ..  #    # ## # # #=# # #
#### #.# ## # # ##### ## # ## #    #.# # #.#.#
# o  ..     #         .   .#    ## # # # # # #
# # #.#.###   ## # ## #.##  # # #    # # # # #
#   # #   . # ##.#=# # # # ## #.  ## #.# # # #
# # . #.# #  . . ..    ..    .# # #. # . # . #
# # # # # #.## ## #.# #### ## . #  #=# # # # #
# #.# # #.#     # #  .       =#  .#. # # # #.#
## # # #.## # ## # ### ### ####.#.## ## ## # #
# .   .  .          %        . .  . ... .    #
## # ###### #### # ## # # ##### # # # ## # # #
# #       #     #  #  .     .     .    ..# #.#
#  ## ##.#. ##.## # #.### ### ## ## # ## #   #
# # # #   #. # #   .      #       # #  # # #.#
#      # # .#.  # ##.# ##  # #### # # #      #
#.##.# # ## ## #.## #.#.# #   .  .  #  # # # #
# #  .   =           .    # # # # #   #  #   #
#  # ####=# #############  .## ##.###  #   # #
# #     .   # ..  .   .. .# .      ...#  #   #
# # # ### ### ## ##### ## # # # # # #  #.# # #
#        .o   .      ...  # # . #.  # #  #  .#
##############################################
