##########################
# ..# # # #\#.  .# # #.# #
### #. .# #.#.##%# # # # #
#...  # # #.#.  .# #.# # #
#=# #   #.. ####.#..=#=#.#
# ..o.# .## .    ###.#.#.#
# #.#.. # . #o## . .o   .#
###.# #.# # # . .#.# #.# #
# .  . .   . #.#. =# ## ##
#.######### #... #.#  . .#
#....o.  .#  .#.##  # ## #
# ## # #.#  #..  ..# ..  #
##########################
