################################################
##.  .# ##.#    .# #.# # #.  .  ..  . # ..     #
# .# #  . .# # #. .. .. . .# ## # ## ## ## #.# #
## #.##.#### ### ###### # ## ## ##.#.#..# #.## #
#.. .    ..  . . .   .   . .   .    ..# .   .  #
#### # ##.#.# # # ##.#.##.# ### ## # #. ##=###.#
#  #.# # ## #.#.# #.# # ## ##.##.###.##.#      #
##.# .....o  . ...  ........   .    . # ##.# # #
##.#.###.##.## ##.#.#.# ###.#.#.#.#.#.# .# # #.#
#..  #  .# .  #.. #.## .. . # .#.# . #. #. # #.#
# ## . #  # # #.# # ...#.# #  #.  .#. #  # # #.#
# .# #.#.#. #.# #.#.## # ###.# # # # # .#  ### #
# #. # .  #.#. .. # . . =.   ... .  . #.## ... #
# .#.# ## #.#.#.#.# ##### #####.## ##.   # ## ##
#.#. #.#. ..# # #.# .   #.....  ..#=# # #    ..#
#..# #.## # #  . .  ### #.# ### #.  .  .##.## ##
#.# ..     .#.# # #.  .  . . .    #.#.#..#  . .#
## #.## # # # ## # ### # #.####.# ## ## #..## ##
#.      .. .. . .... . ..  .... ..   . ..#..#  #
# ## ## ## ##.#.###.##.## ##.## #.#.### # .## ##
# . .#. .  #    #  #  #.  ...#. #. #     # #.  #
## ### ### ..## .#.# # .#.##.  ##.#  ## # ..#.##
#. #   .   #... ## #o # #  #.#     # #..##.#   #
##.. # # #...##   .#.##.  # . .# ### .#     # ##
#. ##.##.#.# # .##.#.  .#. #.#  ... .#  ## #  .#
##.# .   . # ## ##.# ##.  #. ##.#.## .#.. .##.##
#..## #.##.# .#  .   ...#. # .#..... # .##  #. #
##   ##.## #.#  #.##.#.#. ## #.# ###.## # .#. ##
#..#       #  #  #.# # ## # .#.    .    .# .#..#
##.# ## ## # # .#... #  #. # #.######.# # .#  ##
#. # .# ##   ##. # # #.## #.  .# . . ## .#  #.##
##.#%# .  .#  # #  . # #  ### #.# ## #  # .#  o#
#  # ## ##.# ## ##.#.   # ...    . .  #.## ###.#
##=#  . .# #.#  .. # ## #.###.##.## #.   . ..  #
## # ##.## #. # #.#. .# #.#..# . #..#.#.#.######
# . .   ...# # .#.## #= #.## .##..# ..#.#  .  .#
#.# # ## #.#..#.#. #.##   .#.# # #..###.##### ##
# #.#.#..# ..#   .#. .  #.#..  #  # #  .  . .. #
#.#  ..#.# #. #.# .#.## .. # #   # ..# #.#.# #.#
### # # .# # # ##.# ## ## ## ##.# # #..#.### = #
#      #.. #.    . .. .  .   .  . ...#. .... # #
# #=#.#  # #.######## ##### ## ####.#  #.# #  .#
#.# #..#.#... ..   ..    ..  .       #.o# ##.# #
# ### #  # ### ###.#### ## ## ## ##\##.#   ..#.#
#    . # # ..    #      ...    .. .. . ..### =.#
# # #.# .# ###.# #.####.# # #.## # ### # #.#.###
#...   #.#.#   #.  .      # ...# # .  .  ..  ..#
################################################
