###############
#...## ## #   #
#%#  = .  ### #
# # ## ##. \. #
#  #.  ## #####
# #.# # o     #
#.#  # ## ## ##
#   #  .   #. #
###.# #=##o# ##
# ##o ###  # =#
#  ## . .# # ##
##  # ## #.## #
## # ## ## = o#
#          # ##
###############
