##############################################
#.............. ......   #. .#.#.  .#... #...#
# ## ##.#.## ##.##.#.#.#.. # . . ##..#.#...# #
#............ ....... .  # #.#.#....## ..#.#.#
#.# ###.#.##.#.## #.##.#.....#...##....#.#...#
# #.#.#.##.    .#.#.#..# #.#.. # ...## # # #.#
#..... .. .#.##   ...#.... #.#.##.#. ...... .#
#.##.## ##.#.##.#.#.## #.#... ..... ##.#.# # #
# ... .......... ....  ... #.#.##.#... #.#.# #
## # ##.#.## # # ## ## #.# ....#....##.......#
#.. .#.# #.#.# ...==. ...#.#.#..#.#....#.##.##
##.#.\. ...... ## #.#.# #  ....#. .# #...... #
#.  .##.## #.#. ..# .. .##.#.# ..#... .#.#.#.#
##.#.# . .. #..## . # #..... . #...#.#.... ..#
#...  #.#.#...#.#.#.. .# ##.#.# ##.... #.#.#.#
##.#.## #.#.#.......#.#........ ...#.#=. .=..#
#. ... . ... .#.#.#.#.#.#.#.###.##.##.#.##.#.#
##.#.#.#.#.##.# #.. ..  ..  ...... ..... ....#
##.... ..#..#.....#.#.#.# #.## #.#.#.# #.# # #
# .#.###...#..#.#.......#....... ....... ....#
## . ... #..#.... #.#.#..#.#.##.##.#.# ###.#.#
# .#.#.#.##...#.#... .#.#... # #.#..... .....#
##.... .....#... .#.#. .##.#..... .#.#.#.#.#.#
##.#.#.# ##...#.#.#. .#. . .#.#.## ...... .=.#
#........ ..#.. ..###.. #.#.... . .#.## ##.#.#
## ##.## ## #.#.#.....#.#..#.#.#.#...# #  .. #
#......  .... . #.##.##..#.##.##.#.#.....##.##
## ###.#.##.#.#... ... .#. ........ #.## .#.##
#.. .#.... ..#.##.#.#.#.#.#.#.###.#.... #....#
## #..=#.#.#. .... .......... . . #.#.#.#.#.##
#..#.#.#. . #.#.# ## ##.##.##.#.#.#.#.... .  #
## #.....# #........ ...# .#..# ....#.##.#.#.#
#..#o#.##.#.#.##.#.#.##..#..#...#.#.  ....  .#
## ....  . ...... ......##.#.# #. #.# ##.#.# #
#  #.##.# # ## # #.#.# ##.......#...  .   o..#
# ##.## #   .#.#.# # #.#..# #.#.. ##.## #.##.#
#.... ...# #.... .......#. ..o..#....#.  . ..#
##.#.##.##.##.#.# #.##.##.#.#.#..#.#..#.#.## #
##.#..# ..  . .......... . .=.# #.## ##...#..#
#.. #.o.#.###.#.##.##.# ##.#.#..........#  #.#
##.#=.##  . ........... .  ## #.#.# #.#..#. .#
##.##....#.#.##.###.### ##.%... .. .... ##.#.#
#.. #.##... ....#=. .......##.# # # #.#.... .#
## ##....# # ## #.# ##.#.# ##.#.#. ...#.##.#.#
#.. . ## ..... .. ..  .... .......# #....... #
##############################################
