#################################################################################################################
#  .. .. #.. # #.#.#.# #.#.#.# #. ##.  #.# #.# # #.#..  ..#.. ... .    .. # #.  #.#.# # ...## # #.....# ...#.# .#
# ######.###.#  . ..... . ...#.# # . ## .#.#.  ..#. #.#.##..# ## ####.#.#.# ###.# # #.#.##..  #  ####  #.###.# ##
### . .# ..#.# ##.#.#.#.# ##.#.#  ##.# # # # ## #..# .#. .#.#.# .#..#.# # # . #.#=#.#. # # #### # ..  #... .. . #
#.  ###. ## .#  #..# # # ###.#.# #.  # # #.#.# #.#.## ####   #.# # #..#.# #.# #.#.# # #... .. . .##.#..## ##.#.##
###. ..# # #.# #. # .# # ##.. .#.#.#.# . # .... .. . .. . # #..  #.### #.#. #.#   # # #########.#. .# #. .#=.#. #
#.# ####.# # # ##..#.. ....#.# # # #  ## .##.#.### ## #=# #..###. .   .. .# #.# ##..# .... ...#. ##.#  ###.###.##
# .. .. .....# =# ##.# ####.  ##.###.# #.##.# ## #.#.#.# ##.## ############.# # # #.#.## ## #.# #   #.#. .. . . #
##.#.#.# ###.#.#  #..# #   # # .....  .   . ..... . ...  .   . .  .......  .# # # . #.#.#.## ##.#####  #.###.#.##
# # ##.#.# #.#..#. #.# #.#.#.# #####.##.#########.# # ## # # #.#.## # #.###.###.###.# #.. .    .. . . # # .#.# .#
#.# #  # #.# # #. #. #.###.# #.#...#.#.#   .   .#..#.#. ..# #.#.#.# ##... #..   .  .# .# ######## ###.#.#.#..# ##
#.#  #. ##.# # ## ##.#... .#.#. #.#..# . ###.#.##.#  #.#.#..#.. ..  . #.## .### # # # # .#  ...  #  #.#....# #. #
#o# # .# ..# #  # .# # #.## .# ## ###.##.# ##.##.# #.## #.# ##########   ## #.#.#.# #.##.# ##.#.#..# . ##.# .#.##
# #. #. ## # # #  ## ## # ##.#   ........   ..... .. .. . . .. ..  ...# #   # ..# #.#  # # # #..##..#.# # ####. #
# # # ## #.#.#..#....  . . # # ## ##.#.# # ##.## #.##.##.##.##.# #.# #..# # # # .# ##.#  #.# ### # ## #.. .....##
# .  . ....#. ## ###########.###.#.##.#.# ## # ## ## ##.#.### # #.#.# ## ##.#.#.#  ....# #.   .. .  .. # ##.##..#
# ## ##.##.# #     .... . .. . ... . . ...  . .. .    . . . . . ....  . .....# # #### #..# # # ######.#.##.#.#.##
## ### #.#.#..#.###.####.#.#.##### # #.#.## # ##.## #.#.## ## ###.#.#.###.# #....   ...#  #.##.  .. #. .. ..  ..#
#... ....  #.#  #.# #...#.#.#. . # # ##.# .# #  # ##.#.#.##  #.  #.# #. #.# ###### ## #. #.... ###.#. ##.## ## ##
#######.##.#. #.# #  # #... .## ## #.. .# # ..#. ....  . ..# #.# #.# ##.# # ....  #.# .# # ### #.#..#.#.##.#.## #
#..   ...#.#.#  #   #. #### #.#.#.#.####. ##.##.###########..#.#.# . ...  #.#.# ##..#.#. # # #.#.#.## #..... .  #
##########.#.##  ##  # .... . .  .. .. .# ...  . . .   ....#.###.#########...# ##.#.#  # #.#.#.# #.# ..#.#.#.##.#
# .  ..  . .  # #.#.#. # ## ### ####.## # #####.#.# #.#####......   . .. .#.# ... ..# #  # #.#.# #.## #.#  # #..#
####.# # #.#.#..#.#..#.# #..#.  #   # # # #.. #  ##.#.#.  .#.### ####.#.### .######.#.## # #.# #.#. #.#..# # ####
# .##.# # #. ##.#.#.#..#..# #.# .##.#.# # #.###.#. .#..##.# .#.. #. .#.#.  .#.  ..  #  #.#.# # # #.## #.#. #.. .#
##. .   ...#. #.# # ##. ##.#.## #.#.# # # #.. .. #### #.#. # .## ###.#.####  #.##.#.#.#..# # # #.# #..# #### #.##
#..# ###.# # # .#.#..# # .. . ..  . #.# #..#### # .. .#.#.# .# ...  .. . .# # #...#.#..# # # #.#.# ##.#   .  .# #
## #.#  #.##. #...# #. #.###.##.## #..# #.#  .# # #.#.#.. .# # #.###.##.##. #.### # # #. #.#.#.# # .#.##.#.#.## #
# .#.#.## #..# ###.# #.###.### ## # #.###.### ## #.#.#.## ## ## ## ### ##.# # ... #.#  # # #   #.#.# . #.# # . .#
## #.#.# ..#.    .. ........ .. ......    .. .. .        ..   ... ..... ..#.####### #.#.# # ####.##.#.# #.##.####
# .#.#. #.#..###############.###.#####.## #### #.# # ##.# #.##.## # # #.##   .     .. ... .. ......  ... ... ...#
## #.#.#.  #. .  ... . . ..#.# ##.  ..#.# #.  #  # .#.#. #.##.#.#. # # #. # #.# #.# ## ###### ### #.#########.# #
#..# # .# #. ##.# ## ##.###. #  ..#.##..#..##..#.#.##.#.#..#. #.#.#. . #.#...#.#.#.#.# # .  .## #.# # . . .. .# #
## #.#.## ##.#.#.## # .## .#.#### ### # #.# #.## #.#..#..#. # #  .## ##. .#.##.#.#.#.# .#.##  . #.#  ########.#.#
##.#.# . ..#.#.#   ..#.#..#...  ..     .#.# #.#..#..#.#.#  #. .##. . . #.# .#..#.# #.#.#.#.#.#.#  #.# . . ..#.#.#
# .#  ###.# .#.#.#.###..#..# ##### ## ##..#.# ##.# # ..# # ##.#.#.##.## .##. # ..#  .#. .. # #. # #.#.######  #.#
## # # .#. #.# # # #  .## #  .  ..#. #..#  .#. # #.##.#.... ..  .  # # #. #.##.### ## ######.###.## #. . .  # #.#
#..#..# # #  # #..#.##.#. .# ## #.#.# .#  #.#.##.#..#..##.####### # ...# ##.#...    . ..... . .  . .#.## ## # #.#
##.# ##.# .# # # #.... .# #. #.#.## ## ##. ## #  #.##.#  .#.. . ...##### #...########.# # ##.# ##.#.# # #.##.# ##
#=.# #... #  #.#.# ### #...#    ....   .# #.. .# # # .### # ##.##.#  ..   #.#. . ... . # #.# ##. # .   .........#
##.## ###.##.# # ###.# ##.##.####.## ### .# #.##.#.##=..#.#.# ##   #####.#  #.#.##.## #..#.#   # .# ##### #.#.###
#   . ....   #.  . .  .. .. .# .# #..# .# # # #. #  #.## .#...  #.# . .  .#. # #.#..# .# #.#.### ##.#   .# # .#.#
############ ################# #.# ###.#.#.## ###.###.#.## ##### #.##### ##.#..# ..#  ##.# #.#  .   .##.## ## # #
#   .  .  .  .... . . . .. . . ......       .  . . ...  .. .      ..   ..  ..# #### #.# .  # ######.# . ...   # #
## # ### ###############.##### ## ## #.#.#.## ## ##.######.#######.# #=#### # ...   .. #.##.  . . #.# ## ## #.#.#
# #.#...#. . . .. ......#.. .# #.#.#..#.# # # .# #.#. .. #.#..  ..#.###...#. ########### #.# #### # .##.# # # # #
# # #.##. ## ###.#### ##..### .# # #.#  # #.# #.   # ## # ..# ####...## ### #.... .  ..  ... # . .# #...  . #.#.#
#..   ..#. #.# # #...#.##.   #.#.# #  # # = # ##.#.#.# # # #. .  .# # . ....# ## ## # ##.#.#..###.#. ######## #.#
###.#.###.#..# #.###.# .  ## # #.# #.##.#.## # ##.#..#..  ..# # # #. #.## #.#.#  #.#.##.#.# .#.  .# # ...   .  .#
# # # #  ..#.#.#   #  ### # #.##.# #......... .....#. #### ##.##.#. #=# .# .##.#.# #. ... .#..# #.#.#.# ##.## # #
#.# ##.## # ##.#####.## # #... ..#.#.#.# #.####### # #. . .# .. ..# #. #..#  . # #.# ## # # .#.#.#..#.# #.# #.###
#.# . ..#.# .....  . .....###### #.# ## # # .. =..##  # ##.## #.# # #.##.#. ###.##.#.#.#.# # . .  #.# #  ...# . #
#.# # #.# .#######.# ####.... .# # #. ..#..#.##.#.#. #.#.#  #.# # #..  ...#.#.. . . .... . ..#### #.#.# ## ## ###
#.#. #.##.# ... .  #.#  # #####. #.#.##.# #.# ### .# ... # ##.#.# # # #.###..##### ## ##.#.# # %#.# #.#.#.## .# #
#.# #. . ..######## # # #..   .#.# #..# #.#. .  ..## ##### #. #.#.#.## .#...#  .... ##.##.## #.#..#.# #  . .#.#.#
#.# .#### #.   .. ... .  .##.##..#.#.#..#.#.###.#.#. #  .. .#.# .## . #.# #..## ##.#..... .. # ## # .#.###### # #
# #.# . #. #######.# #.##.# #. #.# #..###.###.###.##.#######. #.#. o## #.#..#..###..#.##.#.#.#  . # #..  .  ..#.#
#.#..#.#..#..   . .# .#.#.#.#.## # # #. ..... .  . . ...... # # ###  .  ..#  #.##.## ## #.# #.#####.# #.##### # #
#.#.#   #.#.###### # #..#.#.... .#.#.#.# # ##.## ### ## #.##. #.  #.##.# #. #.   ... .  .. .....  ..# #... .#.#.#
#...##.# .#.  ...#.##.# #.###### # #. #.# ##.#.# #.. # # # .#.#.#.#.#.#.#.#..#.#.# ## ## ######## #.# #.####  # #
# #. . .#.# ##.##. ...  #. .   #.# # # .  .. ....#.#.# #  # #.# # #  . .  #.#.#.# ##. # .# ..... ## # #.=.. #.#.#
### #####..## ##.########.##.#.# # #..########### ## #.# ##.#.##.#. ###### .#...  . # .#.#.# ###.# .# # ##.#. # #
#=...   ..#.  . ..... .. .# # #  # # #   .   .....   #.#... # ..  # #... .#..####.###.#. # #   #.## # # #.# #.# #
# # ###.#.# ## ## #.##.##.# # ##.#.#..##.# #.##.####.# #.##.# ##### .####.# #   .  .   # .# ####  # #.#.#.# #.#.#
##.#.. ## #.#.#. # # ###..# #..#.#.#.#..#.#.#.# #..# #.# #.##.# ..  #. . .  .#.#.# ##.#..# .... .#..#.#.# # #.# #
##.## #...#.#.  ## # ...# #.#.#. #.# # #    . #.#.# .#. ..  . #.#.#.# #.### #.#. #  #..#..#.####. # # #.#.# # #.#
#  ... ## #.# #.  .#.#.#. # # ##.#.#.#.##.#####.#.##.# ###### ##.## ##.## #.# ### ##.## .#..   # #..# #.# #.# #.#
#####.## .#.###.#### ##.#.# #..#.#.#....#.#.....#..#.# #....# ...... . ...#  ......    #  # #.##. # #.#.# # # #.#
# ..#. .# #..  ..  . ...#.#.#.# .# #.#.# ..#.## #.#.. ##.#### #.#.##.##.# #.# # #.#### # #.# ##..# .# #.#.#.# # #
# ##..##. # # ##.#######  # # .#.#.#.##.#.#.##..#..#.#   ... .## ##.#.##.# .# .##.# .#.#..   . #. # #=#.# # # # #
#.# # ### # #. .#    . .# #.# #..#.# .  # ..  #.# #..##.#.# #.....   ..#..# #.#. . #.#.# ######  #  #.#.# # #.#.#
#.# # .##. #.####=####### # # ## #.#.#### ##### ...#.. #.# #..#.#.#.# # .# .#.# # #..# # ....  # .# #.#.#.#.#.# #
# # . #. .# ....    .     . . .# # # #  . #     #.#..##.....#.##.# #.# # ## ## #.#.#.##.########.#.# # ##.# ###.#
#. ##. ## # #.#.#.##.#.##.## ## .# #  ### ######.# #   #.###  .. ...... ... .   . . .  .  .. . .    .   .  . .. #
# #.# #.#.##.#.# #.##.#.# #.# ##.#.# #  #.... . ...#.# # # .#.#.# ##.## #.#.#.# ## ## # # ## ##.############.## #
#    .  . . . .. .  .   .  ..... .. .# #..######.## .### ##.##.#.#.##.##.#.#.# ## ##.#.# #  #.# #.  . ..   .# # #
##.#.## ## #.#.################ #.##.# .# #... ..# #.... .  . . ..    ....  . ... .  . .  # # # #.### ## ##.#.#.#
# # # .#.#.# #   . . ...   .  #.##.# #.## .#.###.#...##################.##########.#####.#..# #.#.# # #..#  # # #
#...#.#  #.# #.#.####.# ######.. #.# #. ..# # .  ###.#.. . . . ..  . . .#.... ..  .#..  # # # # # # .. #. # # ###
# #.#. #.#.# # ##. . # #  .. .# #. # .#.#.#..#.# . #..################## ##########.### #.#.# ..#.###.# .#.. ...#
###.# # .# # #  # ####  # #.##..## # #..#.#.# #..# # #  ...   .    . ..  . ..   ..=. .. ..  .## # . # .# .#.### #
#  .. .# # # # # .  . .#..##.##..# # .#.#. . ..#. ##..# #.## #######.#.# ###### # # #.#.### #.# # # #.# ###.#..##
#.# #.# .##.#. # #.###  #...  # # .#.# .#.##.## .#...#.#.#.# ..... #.# # #.  . # #.# #.#  #.#.# # #.# #  ...##.##
##.##..#.....#  # ##.# ## #.#.# .#.#..#.#   #  #..## #.#.#=. # ## ##.## # # # ##.#.#.#.# #..# # # # #  # ##. # .#
#..  .## ####..# ..  =.. . #.##.#..#.#.##.### # ## # ..# #.#..#.# #   .   #.###....# #.# .#.# ..##.#.## # #.## ##
## ##.. .  ..#.######## # #... . # #..  .... .   . # ##..# # # .#..# #### #....#.#.#.#.#.# ..##...  .....   ... #
# #.#.#####.# ..  .   #.#  # ## # .# ### ####.#.###...## ##. ##.#.##... # # #.## .##.# #..# #.#.##.#### ######.##
#.#.# .  .# .#.#.##.##. # # # # .#.# # .#.. .#.#.  #.#.. ..#....#.#  # ## # ###..#  .#...# o#.#..#.#  ..  .  # ##
#.# #.##.# .# .#. # # #.#.. #.# # .#  #.####.# # ##.. ## ### ###.# #..##.##. . # #.#  ##. # # #.#.#.#########.#.#
#.. #..#  #..# .### #.#.#.##  #.##.#.# . . ....# #.#.#..  .  # . ... #..  ..###..# # #.#.#..# #     ....  . ..  #
# ##..#. ## #..# ..  .# # # # #..# # .#.#.# ##.# . #. ##.# # # ###.#..#####.#.## #.#.# #  # #.#.#################
#.# #..#.#..##..#.#.#.# #.. . # ##.# #.# # #.  #.##  # # # # ###.## .#..... ... .# # # # #. # #. . ...  ..  . ..#
#.#.#.#.#.##.# #..# #.#.#.####  #. #.....# .##. ...# # . #.# .   ..# .########## ###.#.#..# ..# ## #.##.# # ##.##
#...  .. .   ...#.#.# #.#.....# .#.#.### #.# ..## #..#### #. ##.####.#  . .  .. .....#. .#..### #.#.# ##.# #.# ##
##.##.# #.####.#. # #=# #.####..#..# #  ##. ## #.# #  ..   # #..#..  .#.#.## # #.#.#  ##.## # ..#. .... ..  ... #
# #.## #.#. ... #.#.# # #.#...#.## # # # . #...# # #.# ### # ##.##.# #.#.# ## #.# #  #.# .# .## .## ######.### ##
#o   .. .# ### #.#.#.##.#.##.#. .# # #.###  ##.# ..#.# #.# #. #  ###.  .  ... =....#.#   ## #.#.#. #..    #  #..#
# # #.##.#.  #.#........#   . #.#..# #.....# #..##.#.#.# #.# ##.#... ##.#### #.##.#. #.#.#  #.  .# # ##.##  #..##
##.#.#.#.# ##. .# #.# #.#.##.# .##.# #.#.#.#   # # # #.# ##..# ..###.#.#  ..#.#. #.#.# #  #= ## # .# # #. # ##..#
#  ....# #  .#.# #.#.#..# # #.#. #.#..#.## ###.# #.# # .   #. #.#  ..#.# ####.#.##.# #.#.#..# .  # #.#.##.# .#.##
## #####.#####  ..    #.# #.# #.# .#.# ...   # #.# # #.#.#.#.#..## # # .. .. .. .  . # #. #.#.#.#...      #.#  =#
#... .... .   .# #.## # # #.#.#.## #..## # ## .  ..# .#.#.# # ##.##.# ##############.### ##.# # .# # #.#.#. .#.##
###### #######.##.# #.# #.#.#.#  # # # ### # #.##### #. .. .. ..  ........  ...... . ...  . # # ##.##.#.#\#.# .##
#. .   ......#. #.# # #.#.# # #.##.# #  ... .. .... . #.#.## #.#.##.##.#.#.####### ##.#.#.#.# # #    ..... .##  #
## ###.####### ##.#.##.## #.# # # .#  ##############.#.# ##.#..##.##.##.#. #. .. .#.##.#. #.# #.#### ##.# #  # ##
# . .#.#.  . . #....     ....  . #.#.#. . ... .......# .    .# .   .... .#.#.##.# # . ..# # # #.  .#.  #.#  #. ##
##### #.######..# ## #.#.##.###.## #.############### ###### #.###########.# ##.## #### # ## ## ####.####.##.### #
#..  .. ..  . .#.##.# # # # . # . .#.   .  ... .   ..... ....    ....    ..= . ..  .... ..  . ....... ...     . #
##.#.#.# #.#.#.# #  ..  . ..##. #.#  #.###.#################### ##.#.#.# ## ##.## #.# ##.# # # ## # #.### #.## ##
#.#.##.#.# # # #.##########.. # ## # #.#.#. . .. ..   .. .   .#  #  # #.## #.### #.# ##.# # #.#.##.#.##.### # ..#
#... . ##  #.#.# . ...   .. ###  ..# #.  # ##.##.###### ### ##  #..#. .  .  .  .. . ....... . ..       .  . .#.##
##.#.#   # #.#..#.##.#.##.# #.  ## #.#.# #.#. #  #.  .    #.  #. #.# #.#.##.# # ## # #.#.#.#.#.#.#.#.#.##.# #   #
#################################################################################################################
