######################################
#.##.#.#.#.#..##.#.#.... ..#.# #..#.##
#....#......# .......#.#.#.#.#.# #.. #
# ##.#.#.# #  ###### . #...#.... .#.##
#  #..#.##.##. .. ...#...#.#.###.#.  #
# # .#......#.##.#####.###.###.#.##.##
#  #...#.# #  .... .. ... . ......  .#
# #. ##.## ##.###.## # #######.#####.#
#..#...... ...... ....  ..=....  o.. #
#.##.#.# #.#.#.#.###.## ###.#.#### #.#
#......## #...#o# ..##  ..#.#... ....#
#.##.#. =...#. .. #.  #.#.#  #.###.#%#
#... .#.#.###.##.# .##..#..o#.. ....\#
#.##.#....#.....#.#.#.#..##..#.###.###
# .....##.#.#=#.......# # #.##.# #...#
#.#.#.#.#.###.#.#.#=# ..#...#.o... ###
# ###.. #....... ## # #..##..#.# #...#
# ....#.. ##.#.#. ....#.#...#......#.#
######################################
