#######################################
#...... ............#.#.#.#.##.#...#..#
##.##.#.#####.##.##.......... ...#.#.##
##.##.#.#...........#.###.#.#.##......#
#.....#.#.#.##.##.#.#....#.......###.##
##.##.#.#.#.....#.#.#.##.#.#.#.#.#.# ##
##..#.#.....##.#..#.#.##.#.#...#......#
#.#.#...#.#.....#.#......#...#.#.#.#.##
#.....#.#.###.#.#.#.#.#.#..#.#.#.#.#.##
##.##.#..................#.#.....# #..#
#..#....##%##.#.#.#.#.##....##.#...#.##
##..#.#.##.#.##.##.#.....#.#.#...#.#..#
#..##........o......#.#.#..#...#.#.#.##
##.#..##.#.###.#.#.#..#.##.#.#.. .....#
#...#..#o..#.##.#..##.#....#.#.#.####.#
##.#..#..#.... .##.....###.....#......#
#...#\.#.#.####..#.##.#....#.#.#=###.##
##.##.#.........#...#.#.##...#.#.#.##.#
#..#....####.##.##.#...#.#.#...#.#....#
##..#.#..... .......#.#......#.....#.##
#..#..##.####.#.##=##.#.##.#...#.#.#..#
##.##.......#.#.#..#.....#...#.#.#.#.##
#...#.#.#.#.###.##..#.##.#.#...#.#.#..#
### #............#.#=.#.##.#.#.#.#.##.#
#.....#.#.##.#.#=.=.#.................#
#.#.#.#.##.#.#...#.#..#.##.### ###.##.#
#.#.#......#.#.#....#.#..#.#.......#.##
#.#.#.##.##.#.#.#.###...##...#.###....#
#................ ....#.#..#.......#.##
#.##.#.#.##.# #.#.#.#.#..#..###.##.#..#
#.#.#.#.#.##.#.#.#.##.#.#.#.#.##.....##
#=...............................#.#..#
#.###.###.#####.#.#####.########.#.#.##
#.#.###.#.......#.....................#
#.........#.###o#.#.#.#.##.####.#.#####
#.###.#.#.#.....#.#.#.##.#o..... .....#
#.#...##..##.##...#........#.##.#.#.###
#..=#...#.......#...#.##.#...#....#...#
#######################################
