#####################################
#   ..       .#    .   .# #.# # # # #
#.#.## # # #.# ## # # # # ..  . .  %#
# .  #  # . #   .. ..  ## #.## # ####
# ##.## # #   # ### # #   #    # .. #
#       #   #  ## # #   #=# ### ### #
# ### #.  ##  #   . . # #    .=  ...#
#   . # #   #. .# # # #.#.# ### # #.#
# # #   # ##. # ### #.###.  # # ##..#
# # ### #.. #  ..    .    # #  .   ##
#  .  .. .### ##### ## ##    # #.#.##
# # ## # #...       .#. . #.#.   #..#
#  ## # # # # ##.### # # ##.###.## ##
# #  .  # #.#  . .     ..\      .   #
# # ###.#   . # # # #### ### ## #.###
# #.# # ..# #. # .      .# # ..   # #
# #.#.# #.    # .## # ##.  # ## # # #
#    .    #.#  #.#.  #=#.# #    # # #
# # #####.#   #  ## #     .# ##    .#
#.#    ...# #  #  . ##.# # . .# # # #
#   #####.#.# #. ###.### # ##  .### #
# #  . .  # #  #   .   .    . #..  .#
#.# #####..  .#. # # # ### ## #.## ##
#.# .     ### ## # ##   .# #.## # # #
#.  ## ## ...  # .   # # #      o   #
# #..  .. #.#.#..#.#  .#  # #.# ## ##
# #### ##.# #..# ###.### # ## # #.# #
# .    .# #.#.#        .  . .      .#
# #####.    # . # ####.# #### # # # #
# #. .  # ### #.#      #.   ..#  ## #
#   #.# #.   . .# #### #.#.# ## #  .#
# # ### ##.##.##  # ..   # .   .### #
# .  .   #  #. .# #.##.#o# # ##   . #
#o### ##.## # ##.#.#.# # ## # # ###.#
#  .  .        . . .= . .   ..   .o #
# # #.# # #.#.# # ## # # #.#.# # ## #
#####################################
