################################
# =  .    .....  .. #.    ...  #
# ## #.##.#.#.## ##.  # ########
# # ## #.  o   # .  #.  . .    #
#    ..  # ## #..##.# #.## ## ##
#.## # # .  .  #      ##.#  #. #
##.## ##.## #.##.#### =.= .# .##
#..   .  ..   ...     ##.#.##.##
# # # #### # ## #.# #  . . ... #
#      =  .#     ## # ## ### # #
# # # # ##.# # #.       .  .. .#
#..   .. # # # #.## ## ## ## #.#
#.# ## # #  ... .. .. # #   #  #
# # # # ## ## ## #.# ##   #  #.#
#    . .  .##.#.# ##... ### #. #
## # ## ##   . =.. . ##....  # #
# #.#.## #####.# # # ## #.# ##.#
#.   . ..  .    .   o .  ## . .#
# #.## # # #.### ### ## #.  ## #
#.## # # # ###  .# #.##   #=.#.#
#      ..  .  .#   .. . # # #  #
#.#.#### # # # # ##.# # #. . #.#
#.   .. .. #.   ...   #.. #.# .#
##.#\###.#.### ###o# ##.#. . # #
#o... .  ... . . .      #.# #..#
#.# # ## #.# ##.##.##.#.% #. # #
#. .#.   #.# .##.   . # # #.#  #
# #.# ##..   #.  #.##.#      #.#
##.# ## #.### ##.# #.##.# # ##.#
#  .. . ... .... . . .        .#
##.## # ##.## ## # #.#.# ## ## #
################################
