################################################
#=# # ## # # # # ## # #.## ## #  # .  # # #   ##
#  ..     .    .. .   =.       #  # # # #= ##  #
## ## ## ## ## # ########## # #. #  # # # #.  ##
#  # ## # # # # .#       . #####. ### #.# # #  #
##    ..  # #  #  #.## ### ## #. #      .  ## ##
#  # # ###  # #. # .#   . ..   #. # ## ## #    #
## #  # . #.#  # #### # ## ## ## # # # #  # # ##
#. # ## ##  # #         .  # #  .#   # ## # # ##
##.#    = # # .# # #.## ## # .## #.#.## # ##  .#
#.#.####### # #  # ## # #  # #   #      .   # ##
#   .   .   .  #.#..#  # #.# ### ######## ##  ##
# ### ##.#.## #  # ## # .. #  . \          ##  #
# #.## #..# #  # # #  # ## ##############o#.  ##
#      # #  . ## # ##.# .#        .    .#  ##  #
# ## ## .## #.#  # =# # # .# # ## # #.##  # ..##
## ###.## ### ## # ## #. # .##.# # # o# # # # ##
#    . o   .     # #. ###  #   #.# .#.# # # #. #
#.# ## # ##### # # ##..  #  ####.# ##   # # # ##
###.# .#      #  #  # ###. #          ### #.#o##
#    #   ##.# .# # #  # .#   ######## #  .# # .#
# # ## #.#  # #  #  # # #  #. .    ..  ## # # ##
## ## # # ###.## # ## #  #  # ### # # #   ### ##
#         .      # #= # #  # ##.## # #.##   . =#
########### ## # # ## # ##.#              # #.##
#      .    # #  # .#.#    #.###.# #### # #.   #
# ####### # #  # # #  # ## #   # # #    #   # ##
#      ..#. # ## # ## #= # # ##  #  ### # # #  #
### # ##  # #.#. #  #  ### # # #.# #    # # #.##
# ## #.# #  #  #.# #  #   .#   # # # ##.# ### ##
#      #  # # #  #  # # ##  #### # #  # #      #
## # # # ##  . # # ## #  # #   . # # ## # ### ##
# .# # # #. # #% #    # #  ###### ##.# #  # .# #
##.#.# #  # ## #  ###.##.#    .     . . # # #  #
# ## # # ##    # #       . ## #### ####.#    # #
#  ..#.# #  ## # .# ######.#  #   #   # # # #  #
##.# # #. #  # #.# #     # ##.# #  # # .#=#. # #
# # ## # ## #. # # # #.# #  #  ## ## #### #.#. #
#      .     #.#.#    # # .#  #  .      . #  # #
#.## # #### #  # ### #  .#. # # ## ## # #.# ## #
## #.## ..#  # #  .#  # #..#   # ## # #.#.#    #
# =   # ##. # #  ##. #   #  # #..     # # # ## #
# ## #  #=#    # # #.##.## # # # ##### ## #=# ##
# # # # # #.##.#    .        .    .        . ..#
#           #  # # ## # # ## ## ## ## # # #.## #
## ## #####  # # ### # # ## # #  ### # #.# #.# #
#   #  .  # #  #    .    . .  # #  .  .    ..  #
################################################
