##########################################################################################################################################
#...................#.#.#.#...#.#..#.#.#.#.#.##.#.#..#..#.#.....#..#.#.#.#.#..#.#.#.#.#.##.#....#.#..#.#....#.#..#.....#.#.#.#.#.......#.#
#.###.###.###.#.#.#........#.#..##.#...............#.#.##.#####.#.#..#.#.#.##.#............#.###..##...#.##.#.#.#..#####.#.#.#.#####.##..#
#...#....#...#.#.#..##.###.#..#..#.#.#.#.#.#.#.####..#..........#.##..........#.##.#.##.###.....#..#.###.#.#.....#.....................#.#
#.#.#.##.#=##.....#..#...#.#.#..#..#..#.#...#.#....#.#.##.######...#.##.#####.#..#....#.#..#.###..#.........#.#.##.###.#.##.##.#.#.##.#..#
##.#.##.##.#.#.####.#.###.##.##.##.#.#...#.##.#.###.............#.#..#........#.#.#.###.#.##....#..#.####.#...#.#....#.#.#.##.#.#.#.#..#.#
#..................................#..#.#..#..#....#.##.#.#.####..##.#########..#............##.#.#.....#...#.#..#.#.#.#.#............#..#
#.#.##############################.#.##..#..#...##.#.#.#.##.#...#.............#.##.###.##.##..#.#..#.###.####.#.##.#.#.#.#.##.###.###..#.#
##.#...............................#.#..#..#..##.#.#.#.#....###.#.##.##.######=..#.#...#..#..#..#.#..#........#.....##.#.#.###...#..#.#..#
#..#.##.#.##.#.##.##.#.##.#.#.#.##.#..#.##..#.#....#.#.####.....#.#....#......#.#....#..#..#..#.#.##..#.#.#.#..#.#.#...#..#.##.###.#.#.#.#
##.#.#.#.#.#.#.##.#.#.#.#.#..#.#.#.#.#.....##.#####..#......#.##...#.#.#.###.#...#.#.####.#..#..#..#.#.#.#.##.#.##..##.#.#...............#
##.#.#.#...#.#....#.#.#.#.#.##.#.#.#..#.##.........#..#.#.#.#...#.#..#.#...#.##.#..#.......#..#.#.#................#...#..#.#.##.##.#.##.#
#...##.###.##.#####.#.#.#.#.#....#.#.#.#.###########.#.#.#=#.####.###.##.##.#.#.###.###.####.#.##.################.#####.#.#.#.##.##.#.#.#
##.#..................#.#.#..#.##........................................................................................................#
#..#.#.######.##.####.#.#.####.#.#.######.#.#.#.#.#.##.#.##.#.#.#.#.####.#.##.##.######.##.#.#.###.##.##.###.####.#.##.#.#####.###.##.##.#
##.#.#......#.#.....#.#.#........#......#.#.#.#.##.#..#.##.#.#.#.#.#....#.#.....#......#..#.#.#....#.#.#...#.#...#.#...#.#.....#.#....#..#
#..#.#.#.##.#..######.#...###.#.#..#.##.#.##..#....#.#...............##.#..##.##..##.#.#.#..#..#.#.#.#...###.#.###.####.#.######.#####.###
##.#.#.#..#...#........##.....#..#.#.#..#...#..#####.###############.#.##.#.#...#..##.##..#.#.##.#.#.###.#...#...........................#
#...#.#.##.#.#.######.#.######.###.#..#.#.##..#...............................##..#......#....#..#.#...#..####.###########.###.##.#####.##
##.#...............................#.#..#.#.#.###.#.#####.#.##.#.#.###.####.#.#.#.#.#.##.##.#.###.#..##..#.....#...........#.#.#.#.......#
#...####.##.##.##o#.#.##.#.##.##.#.#..#.#.#.#...#.#......#.#..#...#..#....#.#.#...#.#..#..#.#......#...#..##.#..##########.#...#..#.###.##
##.#...#.#..#.#.##.#.#.#..#.#.#.#..#.##.#.#.#.##.#.######..##..#.##.#.###.##...##.#.#.#..#..#.##.#.#.##..#..#..#............##.#.#.##.##.#
##.##.##..#.#.#....#.#.#.#..#....#.#.#..#.#.#............#..#.##............#.#.#.##.#.#.####.#.#.##...#..#..#..##.##.#.##.#.#.#.........#
#...#.#..#..#..#.#.#.#.#..#.#.#.#..#..#.#.#.#.########.###.#..#..#.##.#####.#.#......................#.#.##.#..#.#..#..#.#.#...#.###.#.###
##.#...#.##.#.#.##.#.#.#.##.#.##.#..##.##...#.#........#....#..#.#.#.#.....#..######################.###.#...#.#.#.#..#.....##.#.#.#.#.#.#
##..#.#...#.#......#.#.#....#....#.#......##...##.#.##.#.#.#..#..#.#.#.###..#.............................#.#..#.##.##.#####.#.#.#..##.#.#
#..#...#.#..#.##.#.#.#.#.#.#..##.#..#####.#.#.#.##.#.##.##..#..#.###.###.#.#..#.##.#.#.#.#.#.##.#.##.#.#.#...#...............#.#.#.#...#.#
##..#.##..#.#.#..#.#.#.#.##.#.#.#..#......#.#.#............#..#.............#.#.#..##.#.#.#..#..##.#.#.#..#.#..#####.#.#####.#.#.#.###.#.#
#..#..#..##.#.#.#.#..#.#....#....#..##.##.#.#...##########.##.##.#.##.#.##.#..#..#..#.#....#..#....#.#.#.#...#......#.#....#.#.#.#.....#.#
##..#..#.#..#......#...#.##.#.#.#..#.#..#.#.#.#...................#..#.#.##.#.###.###.###.#.##.####.#.#.#.#.##.######.##.##.#.##.#.#####.#
#..#..#...#.#.#####..#.#.#.#..#..#.#.#.#..#...#.###.#.#.##.#.###.##.#.......#............................................................#
##..#.##.##.#......#...#....#.#.#..#.##.#.#.#.##...#.#.#.###.#.#.#...#.####.#.#.####.#.##.#.#.#######.#.#.#######.#.##.##.#.###.##.##.##.#
#..#.....#..#.#.#.#.##.#.#.#..#..#.#....#.#.#..#.#.#.#.......#...##.#..#..##..#.#...#.#....#.#.......#.#.#.......#.#..#..#.##.#.#.#..#.#.#
##..####..#.#.##.##.##.##.#.#.#.##.#.#.#...##.#..##..#######.#.#..#.##.##...#.#.#.#.#..##.#..###.###.#.#..#.######.#.#..#.......#.#.#..#.#
##.#.....#..#.................#....#..#.#.#....#...#.........#.#.#...#..#.#.#.#.#.#.#.###.##...#.#.##..#.#.........#..#..#.#.##.#.#.##\#.#
#...#.##..#..#.##.#.#.#.#.#.#.#.##.#.#......#.#..#.#.##.##.#.##...#.##.##.##..#.#.#.#..#.#.#.#.#.....#.#..###.##.#.#.#..#.#.#.#.#.#..#.#.#
##.#.#.#.#..#.#.##.#.#.#.#.#.#.#.#.#.####.#.#.##.##....#.#.#...#.#..........#.#.#...#.#......#...#.##..#.#.....#.#....#.#.......#.#.##.#.#
##.....#.##......................#.#........#..#...#.##..#.#.#.#..#.#########.#.#.#.#..#####.#.#.#.#.#.#..###.#..#.##.#..##.#.#.#.#....#.#
#..##.#...#.#.#.#.##.#############..#########.#..#.#.#.#.#.#.#.#.#..#.........#.#.#.#.#......##..#.#.#.#.#.....#.#.#..#.#...#...#.#.##.#.#
##.#.#.#.#...#.#.#.#.#.............#...........#.#.#...#.#.#.#.#..#..####.###.#.#.###.######...#.#.#.#.#..###.#..#..#.#..###.##.#.#.#.#..#
#..#......#.#..#.#.#..##.#.#.##.##.####.#.###.#...##.###.#.#.#.#.#..#....#..#.#.#..........#.##..#.#.#.#.#.....#.#.#..#.#.......#.#....#.#
##.#######.#.#.#.#.####.#.#.##.#.#.....#.#..#..#.#...#...#.#.#.#..#..#.#..#.#.#.#.#########....#.#.#.#.#..#.#.##.#..#.#..#.#.##...#.##.#.#
#..................................##.#...#.#.#..#.#.###.##..##..##.#..#.#..#.#............#.##..#.#.#.#.#.##.#..#.#.##.#.#.##.####.#.#..#
######.#.#.##.#.#.#.#.##.#.#.##.##....##.#..#..#.##........#...#.#...#.#..#.#.#.##.#.##.#.#..#.#..#..#.#.#.#...#.#.....................#.#
#.....#.#.#..#.#.#.#.#..#.#.#.#..#.##..#..#.#.#....#.#.#.#.#.###..#.#..#.#..#..#.##.##.#.#.#.#.#.#.#.#.#.#.####.##.###########.###.#.##..#
#####.#.#.#.#......#.#.#..#.#.#.#...#.#..#..#..#.#.#..#.#..#.#...##.#.##.##.#.#....................................#...........#..#....#.#
#o..#.#...#..#.#####.#.##.#.#.#..#.##..#..#.#.#...##.#...#.#.#.#............#..####.###.##.##.##.#.#.####.#.#.##.#.#.#.##.##.#..#.##.##..#
###.#.#.#.#.##... ........#.#.#.##.#..#..#..#..#.#....#.#..#.#.#.######.####..#.....#.#.#.#.#.#..#..#...#.#.##.##...#.#.##.###.##..#...#.#
#...#.#.#.#.#..##.#.#.##.#..#.#.#..##..#.##.#.##.#.#.#..##.#..##.#......#...#.######..#.....#.#.#..#..##..#......#.#........=.....#..#.#.#
#.#.#.#.#.#..#.#..#.##.##.#.#.#.##..#.##..#.#.#...##..#...##.#...#.##.#.#.##........#.#.###.#.#..#..#...#...## #.#..#############.###.##.#
###.#.#.#.#.#...#.#.......#...#..#.#..#..##.#..#.#...#..#.....##..#.#.#.#.#.#.#######.#.#.#.#.#.#..#..###.##.##.#..#.....................#
#.....#.#.#.##.#.#.########.##.##..##..#....#.#..#.#..#..###.#...#....#.#.....#.......#...#.#....#..#.#..........#..#.#.##.#####.#.#.###.#
#####............................#..#.#..##.#..#.###.##.##.#.#.#..####.#.####.#######.#.###.######.#....#.########.#.#.##..#......#.#..#.#
#.....########.########.#.#.#.##.#.#...#.#..#.#..............#.#.#....................#.............#.##..#........#.....#.#.#.#.##.#.#..#
#.###.#.......#........#.#.#.#.#.#.##.#...#.#..#############.#.#.#.##########.######.#..##.##.#.##.#....#.###.####.#.#.#.#.#.#.#.#..#..#.#
#.#.#..#####.##.########.#.#.#.###..#..#.#..#.#..............##..#..........#......#..#.#.#..#...#..#.#.#...#.#..#.#.##.#.#.#.#.#.#.#.#..#
#.#.#.#............................#..#...#....#.###.##.#.##...#.#.#.#.###.#..######.##....#..#.#..##.#.#.#.#.#.##.#...................#.#
#.#.#..##.###########.##.##.#.#.##..#..#.##.#.#.#..##.#.#.#..##..#.#.#......#.#......#..####.#...#.#..##..#.#.#.#..#.#########.##.#####..#
#.#...#.............#..##.#..#.#.#.#..#..#.##....#..#.#.#..#.#.#.##.#.######...##.##..#.#.....#.#...#...#.#.#.#..#.#.#.........###.....#.#
#.#.#.#.#.#.##.##.#.#.#...#.#.......#.##......####.##.#.#.#....#............#.#.##.###.#.###.#.#.####.##.#.#.##.##.#.##########.##.#####.#
#...#..##..#.##.##.#.#.##.#.######.#.....####.........#.#.##.##..###.###.#.##.#..........................................................#
#.#.#.#...#...............#......#..##.#.#....#.#.#.#.#.#......#.#..#..#.#.#..##.##.########.#.#.###.##.####.#.###.#.############.######.#
#.#.#..##..######.#.#.###.#.##.##..#..#..#.##..#.#.#.#.#.#######..#.#.#..#..#..#.#.#.......#.#.#....#......#.#.#..#.#...........#.#......#
#.#.#.#.#.#........#.##.#.#.#.#.##..#..#.#.#..#..................#..#.###.##..#..#..#.##.##...#.#####.######.#..#.#..#.#########..######.#
#.##..#...#.#.#.#.#.......#.#......##.##.#.##.##################..#.#.......#..#.#.##.#....#.#................###.#.##.#........#......#.#
#...#..##.##.#.#.#.######.#..#####..........#..................#.##.#.######..#..#.#.#.#.#.#..#.##.#.##.##.#.#.........#.#.#.#.#..#.#.#..#
#.##..#.#.................#.#....#.###.##.##..#.##.#.##.##.##.#.............#.##.#........#.##.##.#.#.##.##.#.########.##.#.##.###.#.#.###
#.#.#.#.#.##########.#.##.#..#.#.#....#..#..#.###.#.#.##.###.#.#.#.#########...#...#.#.#.#..........................=....................#
#.....#.#.#...=......##.#.#.#.##.#.###.#.#.#......o............#.#..........#.#=.#..#.##.######.#.###.##.##.#.##.##.#.#.##.#.#.####.####.#
#####.#.#.#.#.###.##..#.#.#.#....#..........#.#######.###.###.#..#.#.##.####...#.#.#..........#.#.#..##.#..#.#.##.#..#...##.#.#....#....##
#.....#....#.##.###.###.###..#.#.#.#.######.#.......#...#.#.#..#.#..#.#.#...#.#..#.###.#.#####..#.#.#....#.#.#......#..#......#.##..#.#.##
#.#.#...#.#.................#..#.#.#.#....#.#.#.#.#.#.#.......##.#.#..#.#.#.#.##.#...#.#.#....#.#.#.#.#.#.....##.##..#.######.##.#.##.#..#
##.##.##.#.######.########.#.###.#.##.#.##.#.#.#.#.#.#.########.#.#.#.##.##.##.###.##.##.###.#.#.##.###.####.#.##.#.#..............#..#.##
#...................................................................................................................#.#.#.#.#.##.#..#....#
#######################.###.##.##.#.#######.#.###.#.##.#.###.#.####.##.##.#.#.##.#.#.###.#.##.#.###########.##.####..#.#.#.#.#..#..#..#.##
#.....................#.#.#.#.#..#.#........#.#...#.#..#.#.#.#....#.#.#.#.##..#.#.#.#...#.#...#.#...........#..#....#.........#..#.##.##.#
##.##.#.##.#.##.##.#.#..#.#.#.#.#...#.##.##.#.#.#.#..#.#.#...#.#.#..#.......#.#.#.....##...##.#.#.#.##.#.##..#..#.#.########.#..#........#
#.##.#.#.##.##.#.#.##.###.###.#.##.#.#.###.#.#.#.#.##.#.#.###.#.#.##.#######.##.#####.#.#.#.##.#.#.##.#.#.###.##.##...........#..#.####.##
#...................................................................................................................###.##.#.#..# .#.....#
#.##.##.##.#.#.#.#.###########.#.#.#.#.#####.#.##.#.###########.#.#.##.######.##.###.###.##.#.#.##.#.#.#.#.##.##.##.#.###.#.#.#.##.#.#####
##.###.#.#..#..#.#.#.........#..##.#..#.....#.#..#.#...........#..#.#.#.......#..#.###.##.##.#.##.#.#.#.#.#.###.#.#......................#
#.........#..#.#.#.#.#.#.#.#.#.#...#.#..#.##..#.#...#.#.####.#..#.#.#..#.#.##.##.#................................#.#.#.##.#####.#.#.#.###
#.#.#.##.#..#..#.##.#.#.#.#..#..##.##.#.##..#.#.##.#.#.#...#.#.#..#.#.#.#.#.#..#.#.#.##.###.#.###.##.########.#.#.#.#.#...#....#.##.#.#..#
#..#.#.#..#.##.#...........#.#.#.#....#..#.#..#..#.#.....###.#.##.#.#.........#..#.#....#.##.##.#..#.#.......#.#.##...#.###.###.......#.##
#.#..#.#.#...#.#.#.#.##.#.#..#.#...#.#..##.##.#.#..#.###.#...#..#....#.#.####.##.#.#.##.........#.#...#.###.#.......#.#.#......#.###.##..#
#.##.#.#.##.#..#..##.#.#.#.#.#.#.#.#..#..........#.#.#...#.#.#.##.#.#..#....#..#.#..#.##########.#.###.##.#..##.#.#..#.#.##.####.#...#..##
#......#.....###.#...#.......#.#.#.#.#..##.##.#.#...#.##.#...#.#.#...#.#.####.#..#.#........................#...#.#.#............#.#.##.##
########.##.#....#.#..##.#.#.#.##.#.#.#..#.#...#.#.#.....#.#.#....#.#..#.#.....#.#..#####.############.##.#..####=#.#######.##.#...#.....#
#............###.#.#.#..#..#.#........#.#...####.#.#.#.#.#.#.#.#.#...#.#..#.#.#..#.#.................#.#..#.#.....#.........#.#..##.#.#.##
##.##.##.##.#....#.#.##..#.#.#.#.##.##...#.#.....#.#..##.###.#..#.#.##.#.#..#..#.#.###.##############.#.###.######..######.##.##.#......##
#..#.#....#.#.##..#.#.#.#.##.#.#..#.#.#.#...#.##.#.#.#.......#.#.=..#.#.#.##.###..................................#............#..##.##..#
##.#..##.#....#..#...........#..##.##.#..#.#..#..#.#.#.#####.#.##.#.#............###.##.#.####.####.#.#.#####.##.#..##.#.#.#.##..#..#.#.##
#..#.#...##.##.#..#.####.#.#.#.#......#.#.#.##.#.#.#.#.#.....#..###..##.#.##.#.#.#..#..#.#.....#...#.#.##...#..#..#..##.#.#.##.#..#.#...##
##.#..##.......#.#.#....#.#..#.##.###.#..........#.#.#.#.###.#.#....##.#.#.##.##..#.#.#...#.##.#.#.#.#....#.#.##.#..#.......#..#.#..###..#
##.#.#.#.##.####.#...##.#..#.#..#.#.#.#.##.#.##.#..#.#.#.#.#.#..###.#............#....##.#.#.#.#.##...###..##.#.#.#..######.##.#.##...#.##
#..#...#..#.#.....##.##.#.#..#.#..#...#.#.#.##.#.#.#.#.#.#.#.#.#..#.#.##.###.#.#.####..............#.#....#.......#.#.............#.#.#.##
##.#.##..#...###.#.........#.#.###.##.#..........#.#.#.#...#.#.#.#..#.#.#...#.#.....#.#.#.#.##.##.#..#.##.#.#.##.#...##.#.#.#.##.##.#.#..#
##.#...#.##.#.....#.###.#.#..#........#.#.##.#.#.#.#.#.#.#.#.#....#.#.#..#.#...#.####.##.#.##.##.#.#.#..#.##..#..##.#.#.##.#.#.#.#...##.##
#..#.###..#.####.#.##.###.##.##########.##.###.##..#.#.#.#.#.#.#.#...##.##..#.#..#...................#.##...#.##..#...#... ....#.##.#...##
##.#.#...#.....#.................................#.#.#.#...#.#.#..#.#......##.##..#.#.####.#.#.##.##.#....##...#.#..###.######.#..#.###..#
##.#..##..######.########.##.#.#.##.###.#########..#.#.#.#...#.#.##.#.####.#...#.#.#..#..#.#.###.#.#.#.##.###.#...#.#...#......#.#....#.##
#..#.#...#................#.#..#.#.#...#.........#.#.#.#..##.#.#.#..#....#..#.#..#..#.#.#..#.......#.#..#..##..#.##.#.##.######.#.#.###.##
##.#.#.#..######.########.#.###.##.##.##.#########.##.#.##.#.#.#..#.#.####.##..#.#.##.#.##.#.####.##...#..#...#..#.......................#
#..#..##.#.....#.............................................#.#.#..#.#....#..#..#....#..#.#.#.......#..#.#.#..#.##.#####.######.###.#.###
##.#.#...##.##.#.##.###.##.##.#.##.#.#.#.#.##.##.#.##.#.##.##..#..#.#..#.#.##..#..#####.#.#.#.####.#.####.###.#...#.....#.#.....#..#.#.#.#
#..#.###..#..#.#.#.#..#.#.#.##.#.##.#.#.#.##.##.#.#.##.#.##.##.#.#..#.#..#..#.#..#.............................#.#..###.#..####.#.#..#...#
##.#...#.##.#.##.#.#.#..#....................................#.#..#..#.###.##..#..###########################.##..#...#.#.#........#.#.###
#..#.#.#.#.......#.#..#.#.#.#.###.#.#.##.##.#######.##.##.##.#.#.#..#.........#..#............................#..#..##.##.#.###.###.#....#
##.#.#.#.#.#.#.#.#.#.#..#..#.##..#.#...#...#......#...#.#.#.#..#.##..########.##.#.##.#.##.##.##.##.#.###.#.#..#..#.#......#..#......#.###
#.##.###.##.#.##.#.#.##.#.#....#....#.#..#...#.##.#.##..#....#.#..#.#.............#.##.##.#.##.#.#.#.#..#.#.#.#..##.#####.#..#..#.#.#..#.#
#................#......#..#.###.####.##.###.##.##....#.#.##.#.#.#..#.###.#.##.#.#.................#.#.#.##.#.####......#..#..#.#..#.#...#
#.#.#.#.#.##.#.#.##.#.#.#.#............#..........#.#.#.#.#..#.#..#.#.#.#.#..#.#..##.##.#.##.#.#.#.#.#......#.....#.#.#.#.#..#..#.#..#.#.#
##.#.#.#.#.##.#.#.##.#.##.#.###########.##########.#.##.##.###.#.#.#.##.###.#.#.###.#.#.##.##.#.#.##.#######.######.#.#.#..#.##.##.#.#.#.#
#...................................................................................................................#.#.#.#..........#.#.#
#.###.##.#.###.#.##.#.#.##########.#.##.###.#.#.#.#################################################.##.##.##.#.##.#.#.#.#.##.##.##.##..#.#
#.#.#.#..##.....#.##.#.#..........#.#.##..#.#.#.#.................................................#.#...#..#.###.#..#.#.#..##.#.#.#.##.#.#
#.#.#.##..#.##.#.........#.###.#.#..#....#..#.#.#.##.####.##.########################.#.#.###.#.##...#.#..#.......#.#.#.#.#............#.#
#.#.#..#.#...#...#.#.###.#...#.#..#.#.##.##.##..#...#....#..#.........................#..##.###.#.#.##..#..#.###.#..#.#.#.#.###.##.###.###
#.#.#.##.##.##.##.#.#..#.#.##..#.#..#..#..#...#.#.#.####.##.##.#.#.#.##.#.###.#.#.#.#.#.#.......#...#.##.##.##.##.#.#.#.#.#.#.###....#...#
#.#.#.#.....#..#.....#.#.#.#.#.#..#.#.#..#..##..#.........#..##.#.#.##.#.##.##.#.#.#.##..#.##.#.#.#.................#.#.#.#......#.##..###
#.#.#..#.##.##.#.#####.#.###.##.###.#..#..#...#.#.#########.#...........................##.#.##.#.#.##.###.#.##.###.#.#.#.#.#.##.#.#.#...#
#.#.#.#...#..#.#....................#.#..#..#.#.#.#.........#.###.#.###################.#.......#.#.#..#..#.#.#.#.#.#.#.#.#.#..#.#.#.#.#.#
#.#.#..####.#..#.##.#.#.####.#.####..#.#.##.#.#.#..########..#..#.#............. .....# ##.####.#.#..#..#.#...#.#.#.#.#.#.#.##.#.#...#.#.#
#.#.#.#......#..##.#.#...=.#.#.#..#.#.......#...#.#.........#..##.#.#.#.##.##=##.##.##........#.#.#.##.##.#.#.#.#.#.#.#.#.#..#.##..#.#...#
#.#.#..####.#..#...#..#.###..#.#.#...#.#.##.#.#.#..########.##.#.#.#.#.#.##.###.#.###.#.######..#.#.#..#..#.#.#.#.#.#.#.#.#.#....#.#.#.#.#
#.#.#.#......#.#.#.#.#.....#..##.##.#...#.#.#.#.#.#...........................................#.#.#..#.##.###.#.#.#.#.#.#.##.#.##.#.#.#.##
#.#.#..#.##.#..###.#.##.#.#..#.......#.##.#.#.#.#..#.##.#.###.#.##.#.###.#.##.##.#.#.##.####.#..#...#.........#.#.#.#.#.#................#
#.#.#.#...#..#........#.#..#.#.##.#.#.....#.#...#.#.##.#.##.###.#..#.#.##..#..#.#.##%#.....#..#...#..#.#.##.#.#.#.#.#.#.#.#.#.############
###.##.##.#.#.#########.###.#.##.##.######.#.##.#.#..............#.#.#...#..#.#.......#.#.#..#..##..#..#.#.#.#..#.#.#.#.#.#..............#
#...............................................#.#.##.#.##.###.#..#.#.#.#.##..##.##.#..#..#.##.#.#.##........#.#.#.#.#.#.#.############.#
##.#.##.##.#####.##################.##.##.###.#.#.##.##.#.###.#..#.#.#.#.#.#..#.##.#..#.###.#.#.#....#.#.#####..#.#.#.#.#.#..............#
#.....#..#.#.....#.................#..#.......#.#.............#.##.#.#.###..#......#.#........#..##.#..#.#....#...#.#.#.#.#.##########.###
##.#.##.##..####.#################.##.####.###..#.##.#####.####.#..#.#.....#..#####.#.#.#.####..#...##.#.#.###..##..#.#.#.#.#..........#.#
#..#.#..#..#...#..............................#.#.#....=.#.#....###..#.#.#..#.#.........#.....#..##..#.#.#....#...#.#.#.#.#.#.#.#.##.#.#.#
##.#.o#.##.#.#.#.#.#.#.#.####.##.#.#.#.##.#.##..#.##.###.#.#.##....#.##.#..#....#.###.#.#.####..#...#..#.#.###.###..#.#.#.#.#.#.#.#..#.#.#
##.#.#...#.###.#..#.#.##.#.....##.#.#.#.##.##.#.#..#.#...#.##.#.##.#.....#..#.##.##.##..#.....#.###..#.#..........#.#.#.#.#.#.#.#..#.#.#.#
#..#..#.#......#.#.......#.##.#.................#.#..#.#.#....#.#..#.#.##..#..........#.#.#.#.#...#.#..#.##.#.#.#.#.#.#.#.#.#.#.#.#..#...#
##########################################################################################################################################
