####################################################################################################
#.# #.. ..# # #..#. .   ... . . .. .. .     .  ..#.. # #  .  ...   # #.#   =# ##  ...  ...#   .....#
# . ..#.# .. . #.# #.# ## ##### ### ## #.# # # # ### # # ##.########.   # #.    ##.# #.## #.#### #.#
### #  .  #.# #. ..#  .# .... ..# . # ## .# #.## . ...   .... .. ....## #  # ## .## ##  #...  ...#.#
#. ...# # . ...#.#.  #.#.#.#.# # ##... . #.. .. .#.### ## #.##.#.### #..# #..# .#..... #. # # #.#. #
#.#.#. .#.### ## # # ....... ..... .##.# .#.# # # ..  ..... .#.#...#..#  . #. #.#.##.#  .# # .. ##.#
#.#.## # ..    .   # ##.## ## # # #.#. #.# .### ..##.#.### ###. .# ..##.# #  ## # ##.#.# # ##.#  ..#
#..  . .##### ###### # .# #.## #.#..# #. ## ....# .. # ..  .. .## ## . .#  #.# ...     #  . . . # ##
# # ###.# . .. .     .# . .. .. . # #..# .. ### #.## # # #.#.#.#...# #.## ##.##.##.##### #### # # ##
##    . ..##.# ### # #.## ###.### #.#.#..##.# ..#. # # .  . .  .##.#.... . ...... . .....       .. #
## ###.## # .. .   ..# ...# .#. .. .   #.  .  #.. # ## ### ## ## #.#.#####.### #.######## #.## ### #
#.....#.# # ## #.###  ###..# ##.#.### ##.## #  .#..    . ...... .  . .. .#....#....   . ... . .# ###
# ### # ##.# #.#.#.#.#   .##   .#.... .   #...# . #.#=##.#.### # ###.# ## # #.###.### ##.# ###.    #
#.  .     . .... ..  #.## ...## #.# #### #  #.# #.#  .    . . ..     . . ..... ...  ..  .#.# #.# # #
#.# #.##.##.###.#.##.#.##.##.# . ..  . #..# #.#....# # #.#.##.##.#.# # # # #.# #.####.#.## #...#  ##
# .. ..#.#  # #. #. .#... # #. ##.# # ## #. #.#.# #.  ...#.## # .# ..## # #.# # . . . #.#  #.#  # .#
#.#.#.#..#.##..#.. #.# ##..  #   #.#     ## #.#. # ## #=## .. .# ..#.... ... . #.#### #..#.#.. # .##
#.#.## #  ....## #.#      ###. # # ..# #.   #.  # ..    ...# #.. # ..# ######.#. #.  .#.# . .# ## ##
#......#.#.## #... . ##.#.# ##.#  .#.#.#### #.# ##.#.#.####.##.##### .   .... .#..# # . ##.#.# .#  #
### # #.. # #.#.### # # #.   # .##..... .   #.#...  # .    .   ..#...# ##\# ## # # .# #. #.# #.## ##
#   # .#.# .   . . ... .#.# #  # ..# # ## ### #.##.#o.## # # # # . #..  ...... ..##.#.## #. ...  ..#
# # ..##.#.## # ## # ####.. .#...#... . ...   # ##.##  # ..### # ### # ####.## # . .#   ...##.#.## #
#.# #.#. #.#..# #..  .. ..#.## #.# # #.##.### ..  ... #..#  ... ..   . ...  . . .#.## #### ... .# ##
# ... .#.## #.#  #.# # ##..... #.#.##  # .# ..## # ##.#### ## ###.## #.###.# # # #.  .#.. .####... #
#.#.##.#   ..#..#..# #   # #.# # . ..# . # ## .#.# .#   .=  # .. . #. #..... # # # ##.#.##.. ..# # #
#.. .  ..#.#. ## ## #.###.#.## #.# ###.#  ... #. . ## ##.# #..#### .# # ##.#  .##.#.#.## ## ##.# ###
### ####. .  #  . ..... .... ..  ... ..# # # # #.#.#.  ..#.# #  . .#. # .. ..# . .. ....  .      ..#
#. .#. #.###.#.##.### #.# # #.#.#.# ###..##.. .  #..# ### . .#.# #  #. #.# #...##### ## # ##.# #.###
#.# #.#. ... # .#... .  #.#  .#.#.# #.##. #.## # # #..# ##.# . ..  #  #.   #.#.# ..#.##.##.# ##  # #
### #.##.# #.#.#  ## ## #  .#..  .# #..  #  # #. #. #. .. . .#.# #.## #.## # # #.#   . .  .#. .#  .#
#.  .....# # #  #.#  . .. #. ##.### .# # .#.#. #.# ##.##.#.#  .. ..   ...  #  ..  .#.## #.#..#.  ###
#.#.# ##...  ..## #.### #.. #  ..  .#. ..##.# #  # # .#..#  #.## #.#### ##.#.# #.###.#. .# #.###. .#
##.#.## #.# ##.#  #.#.#.# #..# # #.# .# ## ##.##.##.##.## ## #.##.#. .   .. .  .....  # #   .  #.###
# .    ...  ....#.#...#  .#.# ...#.. #  ...   ....  .  .... ...   .# ## ## #.# # # # # . # # # #   #
##.# ##.###.## #...#### # #..#.#. # ## ###.# ## #### #.# #.# ###.#.# #.## ## #.#.# # .#.#     .#.#.#
#..# #.  . ..  ## #  ...# # # .#.#  .  #.#  # # #. .. ....##. . ##... .  .  .#.###.#### ####.# #.# #
#.#.. .## ## #.o#...# #.#.#..#.#.. # # # ##.#.# ###.###.#.  .##... ########.##  .......  ... #.#...#
# .# # .#..# . #..##.##.#.#.##.  # #  .  . ...... . ....  ## .# ##. .   .. ....#.# #.### # #.# ..# #
# # .#.#. # .#..#.# ....#.#. ..#.#.. #.###### ### #.#.#.#   .#.. .####.###.### ##.#.#..# #.  # #   #
#.## # .#..#.  #. .####..##.##.  #.#  .. .  . . ..# .## # ## ## # .. ..  ..  #....    ## #.# # # #.#
#.  .#.##.#. #.##.#....# #..# ####...#.# #.######.#.#. .#...  . .#.# # ## # ## ##.#=#.#. .  .  #. .#
# ## .     # # .#.#.## #. # . .. . # # # #... .. .   .#.#.##.## #.##.# #.# #   ...# .  #.###.# #.# #
###.##.## #    #. #. ... # #.# ### ###.#. #.#.# # # #.  #  # .........   ....#.####.#.##    .. #.#.#
#..  .. #  # #..#  # # #.#  ..#.. . ..  ##.#.# #.#.#.## . ## ##.#.# # # ## #  . .  .#  .#.#.##   . #
#.##.##   # .# # .#.. ...# #.#..###.## #.     . . ... .##   .##.##..#.# #. # #.##.###.##.# #.# #.###
#    ...#  #.# # # ## ##..... # #.  #....#.###.## #.## . .##     .# # .  # #... .. .     . . # # # #
#.##.##.. #....# # . .. .# ##.# .##. #.#.#   .. #  ....###.#.######.####.#.### #.##.## #.## #  # . #
#.. #.. # ##.# # # # # #.## #.# #.# # .#  #.## #..#.## ... .. ...   . ... . .  .  . ....  .#.# #.#.#
# # .# #.  #.#.#.#   ##.  ..... . ...#.#.##.## ## . # .### ###.####.## # # # # ##.##.# #.#   ..#   #
#. #....#.# .  # #.#. .#.##.# #.# #.# ...#  ..  . #. ## .#.# ..#  .##.##  # # #.# #.#  # #.# #.# #.#
# ##.#.# .#.##  .# #.#.#.##   # . # .#.# ..##.# # # #.  ## . #%#.#..  . #.. .. . . . # #o.# ##   # #
#...  . #..#.#.#   .  ...   # # #.#.#  ..##. # ## #.#.# #. # #.#.# ##.###.#.# #.# ### .# #  . .#.. #
# ## #.##.#..# #.## ##.##.# #.# ##. ##.#.. .#..   #...#  # #.# #.# #   . ...  . # .  #. #.#####.# ##
# #. . #..## # #. #. ...#.  #.#   # .# #.###.####.#.#   #.   ..#.#.  #.## #.#.#. .## . #.... ...   #
#. # #. # .. ..# #. ####. # # #.# . # .#.. ...... #. ##  #.#.#.# ..##.#.... ...#.#...#.# ##.####.# #
#.# #.##  ## # # ##. ...# # # #.# #..#.##.#.#.### . # #.##..   # #. . # #.#.#.# .##.#...... #.   .##
#...   .# . .  #..#.## #..#.#.#.  #.##  .... ## #.#.#.. #..###...#####.#.#.##.###.# ## ##.#..#.##  #
# ###.## ## ####.###.  . #  . # # . #..#.# #  ... #.###  # .  .# . .=    .  . ... .  . #..#.##..#.##
# . ..   .   ..  .#..#.#...## # .##.##...#..# #.#   . . #.## #. .#.# ## #.#.#.### ##.#. #... . ## ##
##.# # #.# #.####. # ##.#.##.##.# ... .###.#.##.# #.# ### ..##.## #.#.###.  #.    .#.# #..#.##.#. .#
## #.# #.#.... .. # . .. ........ # ## .. . . ..     ...  #   . . . ... ..#.#.##.# #.#  # #.##.##.##
#   .#   = # # ## ##.## ####.###### .  #.# #.# ##.##.#.#.#.## ###.#### ##.#..#.  .. .. #     .. #. #
#.## # # # #.#.#.  .... # . .#..... ## #.#.## #  ##.#...#  # # .... ...   #.#. #.#.#.#. #.### #.#.##
#.. .#...#.#..#.# #.#.# ..## #.##.#. . #.#.. . # #..  #  #  ..#.### ##.##.#  # # #.    #. .  . .  .#
# ##.# ## #.# ..     ##.#.   . .. ..##.  . # #... #.#.  #. ##. ##.. # #.# . #. # #.# #. #.## # #.# #
## . .   ..  .#.## #.#  #.## ## ###.. .#### #  ##.# # #..#..# #. .#....  .#  # #.##.# .#    .#... .#
# .#######.##.#.#.##  #... #.##.# # ###.   . #.#..# #.#.## ##.### # #####.. # . .   .# # #.## ## ###
##.#. ....#.#.  . . .#..##. . . .  . .#.#.##    .##.##.. ..   . .. ..  .  #..##### ##.. #.. .... . #
#  #.# # #....#.####.##.## ##### ##.#.... #  # #.. .  # ###.#.#.####.####.. #  .  .  # #  # ########
##.#.####.# #.  ..  . .    ..= ...  # #.# .#.#.# ##.#.# #... ...  ..  . .## #.####.###.## .  .. .  #
##.....#.   .# #####.### # ###### # #.#.##.#.# #.   ....#.##.## #.##.## #.         .   .. #.# #### #
#  # #.#.# ##.## .  .#.##.#. .. . #..  .  . .. #.##.### #.  ...# # ## #.###.## # #.# ### ##.## .. .#
##.#.#...#   ..  #.## ...  # # ##.#.#.# #.##.#....# # #. .##.#    ....    . .  # ...  . . ....##.# #
#. #.# #.# ##.### # # ###.##.##.# #. .#   ..  #.#. . .. # #...#.## #.# #.##.##...# ####.##.#.#     #
##.. #.#...... ..  ... .  .  .    ..### ##.#.# #  #.# #  ...##.#.# #.# ##.#.# ##. .#....#. . # # # #
# .# # #.########.## ###.####.## ##......# #.# ##.# #.#.#.#  .. .  ....  .  # . .#. #.#  #.#.. #.# #
## #  .#.# . ...     . .      ..  ..##.#.#.# # . .. .. . .# ## ## #.#.## #.#..##.#.## # # #..#.   .#
# .# ###.. #.## ##.### #.#.## #.# #.#. .  ...## ###.# # #.#.#  . ...     # .# ....    ..   #  #.## #
##. .  ..#.#. #..# #.##.#.#.. ##.#.  # #.#.#    ..  #   #.#..#.####.#.# ##.## ## # ### ##### #.#.#.#
#  # ### # # ## # .#.. .. ..# .  ##.# #.#.## ##.### ## ## #.## #   . .   ..# ...   #. .........    #
##... .# ....# . #..##.# ##=# ##. #... . ... . .. . o     #... # # ##.## # ## #.##.. ### #.###.### #
## # ##  #.#. #.#  # #.#. # #.# .#.# #.#.## ##.## ## ## #  # #.#. #..# . .   .#  # #. .  #.# #.. # #
#..# #.#.#. .#  .# # #.#.# .   #..   #.# ##..#.#   # #.#. # ##.#.###.# # #.## #.##  .#.# . ....# # #
## #.   . ## .# #..#.....##.# ##.#.##.##   .# . #.#  .  #.# .. #.##..#.#.# #..# . .#...#.# # # .. .#
#..## ## #.#.#  .#.#.###.. .    .  ..    # #.#.#. ## ##.# .#.# #.. #.#.# # ##.#.## #.# #   # #.### #
## .#   . . ..# #   ## ##.#.####.#.## # #  .. .##...  . ..#. ... #.# #.# #. ... . ..   # # .. ...  #
#..# #.#.### # #.## . .  ..  . . #.  ...# ## #..# ## ## #. .##.#...#   # #.# ### #.####.#.#.# ####.#
##........ . . . .  ##.## #.##.#  ### #...  . .# .. = #  .#   ...#.###.# #.. ...# . ..  .   #..   ##
#..######.# # #####.# # .##.##.# ##.# # # # # #.#.#.# ###.  ##.#.    ..  # #.##. #.## ####.# .# # .#
## ..  .. .. ..  .     #. .. ..#  ... ..#.#.# #.# # . .. .#  # #.#.### # #.# # .#. ## # .. .#..##.##
#  ## ###.##.##.#.#.##.# ##.####.##.#.#   . . . # ..###.#.  ## #....   #   #. # .#  ....## # .#  . #
###.#   . .   . # ##   # . ..    #..#.#.##.###.#..# ..  ..# . ...#.## #  #.#.##.#.## ##  #..# ### ##
#.. ..###.# ##.#     #..# ##.#.#. # .. .#....#..# # ### # #.#.##.. #.# # # .  ....#   # ##.# ......#
## ##.#   .###. .#.#. .#.# # . # ##.#.#. #.###.#   ..   #. .# .  #.. ..#.  # # ## #.#. . ...#.##.#.#
#.  #...##.##..#..  ## .. .. #... . # # #.. ... #.# # # ###  #.### # #   # # .       .#.## #.##.##.#
##.#  # . .. .## #.#. #.# ##.#.#.###.... #.###.##.##.##..  .# ...  #.  #.# #.## # ### ##.... ......#
#   # #.##.##   .#.## ###.# .#.  .  .## # .. . #....... ###. # #.#.#.# #    . .... ..  ..#.# ##.## #
## # . .## #..###. .  .. ..# # #.###.#..#.##.#..#.#######   # .. #. .#.. #.#.### # # #.#.# .# # #.##
# . #.#.... #  .  # #.#.##.#  .#. .   # #. .. .#...  .....#..##.#  #.  # #. .......#. .#   #     ..#
####################################################################################################
