##########################################################################################################################################
# .  .# #   .#  ..# #  # # # # #=  .#     # #. #   #..#.#   .# .. #     .  .    .   .  .  # # #      . .# #   .   .          .   #.# #  .#
#### ##  #.### ## # # ##.# # # # # #. #####. #  ## # ## #### #.###. # # ###.# ## ## # # #.# #  ### ## # . # #.## # ##.# ## ####.#  #  #.##
# .     # . .  #  #.#   .  .  .# #. #.#  .  #  #     ..  ..# #..  # # #.# # ## ##  # #.# #  # #.. # # # ##  # # #  #  # #. . . # # # ## ##
#######.######  # #  ####.##.##  #### #####.## ######## #### # ###   # ## #   . #.#     ..# #.#.### #.#. .#.#.# .#..# #  # ####  # # .   #
# . .  .    .  #.#  #  . # . . # ...    .  ..     .        . # # ##.#       ##### ##.# # ## #.#.    #.# # #. ## ## #  # # =    # # # # ###
## # # # ## ##    # ####.### ##  ##.### # ## #.# ##.###### ##  #  . #.# ### #.    .# .##.# .#  #### ###.## .#  ...  #.#  # ### #.# # #.  #
##  # # # #.#. # #   .  .  #.#.#.  #  #. # .## # # #.      # # #### .# #  #.# # ###  #   ## #.# .     .   #  #.#.# # .# #..#.# # # #=#####
#  #  # #.# ## .# # # # #.#  # # ##  ## #  #   # #  #.#.##.  #   .#.#  # # .# #    #  ## .# #.# # ## ##.##  #.# # # # ## #.#   # # #     #
## .# # #    #.##\# ##.# #.# # # # # #.#.# #### ## # #.#.####. # #  ##   .# # # # #  # # ##.#.## #.###. ..# #  . .       # # # #.#.#.#.#.#
#. #. # ######.          .  .  ... ..  . ...     .     .     #.#  #..#.####.# ## # # # # #  # .  .    # ## ..# # # ## ## # ## #= # # .# ##
## ## #        # #.## ##.####################################.. ###.## #...  =     #.#.#  # # # ##.# #.   #.# # # #.#  #.# .   # # # # ..#
#.  # # # ## # # ## # .#.              .  .  .               # #    #   # # ### #.#..  # ##.#.###.# # # ##..# ..    #.#  # ## #= #.# ##.##
##.#   # #.### # .   # # # ## # # ## # ######.## #.# ## ### ## ####  # ## # # #  #.# # #.#. #   ..    #   #  #.#### #.## #.# #.# #.#..#  #
#   # #. .   . # ## #.#  # # #.#.# #.# # .. #.# # ##.#.#  #.#     # #  #  # # #### # # #  # # ####### # #.# #  #..# #  #.#..   ..# # #  ##
## #  # # ##.# #..# #.##  ## # #  .  #.# ## ### # #.## # ##  # ####  # .#.# #.     #.#.#.#  #.#... . #  # # .### ## # #  # ### #.#.# ## ##
#  .#.# # #  # #.## #  ..#  =# ####### # #  .  .    .. .. . ## #.   ## #  # # #.## #.## # #.#..# ###  # ##. #.  .   #.## # #   # # #     #
##.#  # #  # # # #. # ##.# #.  ..   .  # # #.# ## # ##.## #.#  .### #   # # # # #  #   .  # # #. . # #  ..#.# ## ##.#  #.#  ##.# # #.##.##
# #.# ## ## ##.##.## #.##.# ########### # #.# # ##.## ## # # #.#  #  # #  # # # .#.# ## ##. #  ##### ##.##  #.#.# # # #.#. #  .##  #..# .#
# ..       .         .      .             ...   .    ...   ..   #.#.##.### # #.### # # # .# # #.   .. .   #.# ..  # #  . # .##   # #.# ###
# #.## ## #.## ## ###### ### ## ## ## ## ############ ### ## # ##.# #         ..  .  #.# #  # ######.## #.#  ###### ###### #.#.# # #     #
# ## #. # # # #  # .   # # ##  ## # ## #.#     .   .# #    # #    #  # #.# # # # ### #    # #     . # # #.# #.       .  .    #.#.# # ## ##
#.   # ##. ## # # # ## #   .# # . #    #  # # ## ## #  ## ## # #.#. # # ##. #.# ##.#  ##.## #.## #.#  # # #. ################.#.##.# . # #
# # # .# .#   . #.#.# ## ####.### # ###  # # # # #..# ##.##..# #  # #.    .# .#.#  . #   #  #. #. # # # ##  #.    .    ...  .      # ###.#
#  # #  ## #### # # .                  #     . # .# #  ... # # #### ####### # #.#### ### ## # # .#  # #   #  ## ### ## # # # ## ## #...  #
# ## # # .         # # #.## ###.## ###.# # #.# #.#  #.#.###  #.  ...       . .      .   .   # ### # # # ##  # # # # # #  # ##  #   # #####
#.   # ##########.# # # #.###.## ### ##   # # .#  # #.#.#. # # ############################# ..     # # # # . #   # #  # #   #  ## #     #
# ### .             .. .       ...    .# # . # # # .# #  # # #       .   .       .     .   .# #### #  #.#  .## ### ## # # #### # # #.#####
#    # #################################  #.#  # .#.# # # .# # ## #.############## ##### ## #     # # # # #           . .. .             #
# #.#  #  .    .         .              .## ## # # .# # ##.#.# # # #     .  ..    #    # #  #.#####.# #  ## ### ###.## # ## ## ## # # # ##
#.#. #.# #.#############################     # #..# ##.# # #.#.# . . ###.# #####.#  ###   # # #.    # # #  .#  #   # #. #.#.# #.## # .#  #
# ###  # #.#   .  .    .        . ..  .# ##### # # .   .   # #  #### # . # #   .# # #. # ##.# #.### # #  ##  #. ## # # #  #.#  .   .# # ##
# .  # #.# # ### # ## ## ##.#.# ## ## ## #.  ..#  # ###### # # #.  .  ### # ###.# # # ## #  #  ##.# #.# #   # .#   # #. # # # ######  # .#
# # #   ## # # ## ## #.###.# # # ###.##  .## #.# #       # # #. #### #   ..     .         # # #..     # .## .#  ## #   ##.#     .   # #.##
# # .# #.  #   .    .                  # ##.# #.# # ## # # #.# #=...  # ## # # # ##.# ## ## #  # ## #.# #   #  #    ##.  .# # ### #.# #  #
#  ###  ## # ##########################  #       .  # # # #  #  #### #.## #.# # ##.#.# # # .#.#..# #  # ### ## ### #.#####.#.## ## #.# ###
#.#    #      .    ...        .   . .  #.# #.### ##  .   . # # # .    .  ...      .    # .# # .# #  # #   #  .      ..      . .  .   .   #
#. ### .##.####################### ### #  # ## ## # ######## #.#.#.# ###.#### #####.# # .#  # ##.# #. # # # ## ################ #### # # #
# #  . # # #    .                  #. .#.#     .       .   . #.#  ## #.. # .  #   # #. #. # # #   . # #.# # # # .  .  .    .  ..#   #.# ##
# ##.# #.#  ### ##.## # # # # #o## ####  # #.## ## ###.## ## # # # .  ### #### ## ##.###.#  #= #.# #  #  ## #  # ## # #.# ##### # #.#.#  #
# .# #  .# #. ## # #. # #.## # # #.    #  ## #  # #    #.# # #.#  ##.# .    .  .   .   . ##.# #. .#.# # #   # #.# # ## #.#  ..#.# # #.# ##
#.#  # # # # # . # ### #      .  # #.# # #   .# #.#.## .  .# # # #   # # #.###.# # ##.## .# # ## # .#.#  ## # #  .. . .# # # #. # ###.#  #
## ### # #.# ### #      # ##### # .#.# # .##.#  #.### #####  #.## ## ## # ##.## # ## ##.## # ..# ## # # #.# # ########## #.## #....   # ##
#    . # # #  .. # # # #. #    # # # # # #    # #          # #.  .     . .   . .   .     ...# #    .# #.  #.#         .. . . .# #### ##  #
#######.# ## #### #.# # ## ###.# ##.# # #.#### ## ######### ## ############################## #######.# #.#.#.# ## #### ##### #    # #..##
#          .        ..    .      .       .   ...    .                 .   .. .  .. . .   . .. .  .    .  ##.# #. #.#   .# ..  # ## #  # .#
#.# #.##.# # # #.## ## # #.#.#### #### ## ## ########## # #.## ## #.#### ## #.## ## ## ### # # #.## ### #   # ### # #### ##### ## #.###.##
## #.#.##.#.# #.## # #  #.## #  .#   # # # ###    . .. # ## # #  #  #  ## ## ##.# ## ### ## #.#.# # #.# ###.#    .   ..   .  . .    . .  #
#..#    .          #.# #     # # # ### # ....  ## # # # .# .# .# .#  #   ..   .. ..   . .    .  . # # #.  # #.##.####.## # # # ##### #####
## .### ## # ###.# # # ##### # ### #    ###### #.# # #.# #### ##.#  # .###### # ### # ## ### ### #. # # ## .#.#  # .#.#   #.# #    # #  .#
##.#. #  # #.# #.#.# #.    # # .    ## ##   . .  .   .  . ..      # ##  .....# #  ## ##  #.# #. # #   #   # #  #. #.#. # ##.# ##.##  # ###
# .# ## #  # #.  # # # ### #. # ## # . #  #.### ######## ## ## ###   # # # # # .#      # # # # ## # ## .###.#.#  ## ### ##. #     .# #.. #
## # #.. # #.### # # # #   # #.# # # #. # # #.. #.   ... ###.# # .# # . # # ## ##.######.#.#.#    #.  # #  .#..#.  .    . #  # # ##  #.###
# .# ####  #   # #.#=# ### #     # # # ## ## ### ########.## ## # #  #.#..       ..  ... # # .### # ##  # # # ## # ##### ##.#  #   #.#.. #
##.      #.# ## #..# #.  # # #####.# #  ...  . . .   .  .  . .    # ##  # #.# # #.######.# # #   .#   # ##  # #  #.#.    #   # # # # # #.#
## # # # # #  .  #.# # ##. #.#.    # #.# #.# # ##.# ## ##.## #.# ## #  #  # # # # #.o..# # # # ## #.## .  # #  ##.# ##### # #.#  # # #.# #
#. ## # #.# ###### # ##.### #.#### ## # # # #.# ## ## ## #.## #.#. # # ### # # # ## ### ## ## # #.# #.#.# # #.#.    .  . .     # #.# #.# #
##.   .        . .   .      .  ..   .    ... ..   .   . .  . . . .#..   .    . . .   ....    .  .  .# # # # # # ## # ##.### ###  # # # # #
## # ##.# ################ ## ## ##.##.#### # ####.## ## # ######## # # # # ####.# # ## ########### #   # # # #.# #  # #  #  . #  ## # #.#
# . ## ## #.     ...o.   .#   #  # # #  .  # # .  #.#.# #  #        ## # ## #  .# #.# ##        . # ### ##  # #    # #.# #..# # .#  .# #.#
## #  .   .# # # # #### # # # ##.#. .# # # #  ## # .# # .#. ## # ##  # # #   ## #.# .  . ######### . .#   # # .#### ## # ## ## # ###.# # #
## # #### # #.  #.# ..  #.# #  # # ## .## #  #   ## # # # .##.#.# # #  # ## # # #  # # #  .   .   # ### ##  # #.   .   ..      . .   #.# #
# .# #  . # ##### ####### ### # .#   #     #. ##  #.# #  # #.   .. . # #  # #   #.# .# # ### ######.# . # # #. ##.# ## ######## ####.# #.#
##.#  ### #  .            .   %#.# ##  ### # #.# #  # # #. #.## # # #.   ##  ## #.###.#  # # #     . ##   # #.#..#.### #      # #. # # # #
#  # #   ..###### #.# ## ##.#.# .#.. # # ##= # # ## #.#..# ### # # . # # #. #.  #      # # #.# #.## # # # # #  #.# ##..# ####.# # #..# # #
## # #### #     #.# ##.### #  ###  # # .   #      #.# # #     ..  # #  #. # # # # # ##.#.#.## # ##  #   ##  # #      # #.# .# #. . #.#.# #
# .#    # ##### ##     ..   # .. #  # ###### ##.##. #.# ##.## # ##...### ##.##  # #  # # .        #  ##.  # # #### ## . # #.#.# ## #.# #.#
## #.#.#   .. .   # # ## ### .##.#.# .       #.. .#.# #  #.# # # ## #  .   .  # # # # .# #.### #### #.# ## .#       .#.#  .   # # #  # # #
## # #  # ########   #.#.#  # #.#  # ## ## #.#####   ## ## #        .###### ##. # # ## # .#  #.#      #   #.# # ##.##  ### ## # .= #.# ###
#  #.# ##       ..# #    ## # # ## ##  # # # ..   # # . .  # # ##.# #  .  # # # # ## #.# #. ##.# ## ## .# # # ## # # #   # # .#.## #..   #
## #.# #  ## # ###   ###  . # #.    .# # # # ## # # .#.# #..#.#.# # # # # #.#        #.#.##.# #.# #  ## # # # . .#.  # # # .# #  # #.## ##
##.# #  # .# #    # # .#.## # #.##.### #.### # #.## # # #  #      #  # ##.## ####.### ##.         # #   # # # ### ### # # ### ###.#.#.## #
# .#=# ## #  #.## # ## ## ##.  # #.   . .      . ..     .# ## ### # #            .  .    ## ## #.# . ## # # .         .            .     #
##.# #.#  ##.# #..# .   =   # #  # ##.## # # # # # ### # #  #  .#.#..###.## ###.### # ## # ## # # # # #.##. ## ## ## # ### ########## # ##
##.## # ##.## #.##.######### #.#.# # # ##.# # # # ## ## # # #### ## #   # #.. # #  # #.#  ..   .. #.# #   # # # ## ##.## # #    . .  # #.#
#        ..     ..      . ... ..   ..       .     . . ...       .   # ##  #.# # ## ..  # ##########.# # ###.#....           # # # ## #   #
##.### # ## # # # # # #.## # ##.# #.# #####.## ### #.## # # ###.# # # # # #.##.# # # ##..# .  . .   #  .# . ## ###### #### ##.# ## # #.# #
# #  .#.# ## #.# # # # # ## #  # # # .    # # #.   #.#.#.# # ..#.## #.#          #. #.## # #### # # #.# #.#  #     .# #    #  #.   # # # #
#  # #  .       .. .   ...  .# #.# ##.## #  # #####..# # # # ## .#  #. #### # # # .#. . .# #  # # #  ##.### # ######.# #### ## ##### # ###
#.#   ## # # ########### ## ## # #  # # #.#.#   .  # #.#   #  .# ## # #    .## # # ##### # # ## ##  #.  .  ..   .    ...  . .            #
#..# ## # # # .        #.#  # .# # #     .# # ## ##  #.### #.##   #.#  ## #..   .#     # ###.#... #. ## ## ###### ###### ## # #.### ### ##
# #  #  # #.##.## # ## # ## ##.# #.##.### # #   #. # #     # # #.#  # ## # #######.##.#    .  # ##  # #  # #  .  #.   .# #   #.#..# #.## #
#. # ## # #. # # . # #.#  #  # # #.     # # # ## .#  # ####  #. ..# #       .  .  . ## #.#####.## # # #.#  ##### # #### #.###.  # #.   . #
# # ..#.# # # . # ## #.#.#  #  # ####### #.## . # ##.#     #  ##.#.  # ## # #### #.#  . .   . . ..# # #  #      .    . .    .# ## ########
# .# #  #.#.## #  #.   # .#  # #   .       .  ##.  #.#.# ##. # # ## #.# # #    # #.# ###.###### ###.# # #..# ## ###.## ### # #  .     .  #
# # .##.# #   . # #####  #..#.  # # # # ##.## #.#.# .# # # #   #. # # # ## #### ## ### # #.     # . # #  # # # .#   # # .#.# # # #.# ### #
#.##  # # # ## #   .   #.##  # #  #.#.## ## #..... # #.### # ##. ##     . . . . .   .  #. ## ##  ## # # #  ## ## #### # #.#.## ## #.##.###
#  #.##.#.#.#  .# # ## #  # #  ##.##.   ....#.## #.# # .. .# # # # .## # ##### # # #.##. #  # # # ..# # .#               .  .            #
# # .#  # #  # # .###.#  #.  #  #  .# # # # # .# #=# # ## #    #. # .### #.  .#.  # #  #.# ##.#  ## # # #  ###############################
#  #. # # # #   #      #  # ## #  ##  #.# # # # .# # #. #  # # # # .#.   .###  # # ..# #.# #. ..#   # #  # . . .     .   .  .  . ..    . #
# #. #  # #  # # .# # # .# .#.  #.  #.# # # #..# # # # # ##. ## . # # ## #. #.#   # ## #.#  # # .## # #.# .# ### #.# ## ## # ## #.# # # ##
#  # .# # # ##  # .# # #. # ## # ### #.# # ## # # # .#    .#   # # .## # # #  .# #   ..#.# # #  #   # #. #.### ## # # ### # ## # #.#.# # #
#.## #  # # #. # .#      #    . .        .  .  .  .# #.# ###.### ## .# # # ## ##  # # #  #.#  #. ## # # #.    .   ..      .   . .  . .  .#
#    ## # ##.# ### ######.# #######################. # # #   #.  .# #    #    # .#  #  #.# #.#. ### . #  # ### # #### ## # ##.# #.## ## ##
# ## .          .. .      .            .           # # #  ## # ## # #####.### ###.# ####.# #.### #  # # #. # # # # .. #.# # ## ## # ##.# #
#.#. ### #.#.#.####### #.###.##### # ## ### # ### #..# # #  .# # #  ..     ..   .   .  .   ..   . #.# # .# #.. # .# # #.   ... .    . .  #
# ## #  # ## # #.     # #    .  .# ##  #  .# #  ## # # #. ##..   .#.## # ## # ## #####.#### ## ## # #.# #  #### ## # # ###################
#  # # ## #  # # #####.  # # # #.#   # .# # . #  . # # # # # ### ##..# # #  .# # #    .#..# #   # # ##.  #  ..    ...  .   .  .  .       #
#### #  .. # #   .... # # # ..# # ####.##.## ## #### # # # #.# . #..# =.#.####.#.##### #.#.  # #  #   # #  ############### #### ## # # # #
#    # ## #  # ##.# # #    # #  . ....    .     .   =  # #.#  ##. #  # #    .  #     #.#  # ## .#.# ##.  # #..        .   ...  #.## # #  #
####  # #  # #  #.#.# #.###  # # # # ##.# ### ## #.# ##  # ..# # # .# . # ## # # ###.#.# #  #  #  # # #.##  ############## ## #     # .# #
#    #.  .## # ## #  ##.   # #  # #.## #.## ###.# #..#.#  ## #.#. # #### # ### ### ## ##.###.## ##. # # #..#..    .  .   ..# # # ###  # .#
####  ### #  # #  # #   #### # #...                #   #.# . # # #. .. .  .  .    . . .   .     . # #.#. # ############ ##          #. # #
# ...#    ## # .# # #.# #    #. ###### # ## # #.####.##.# ## # # .#.### ###### # #.## ## ##### ## #.# # # ..   ..   . #  # # ## # # # #  #
####  #.#..# # # #.#.#.  ### # # .     # # # # #     #  .    # # #  # # #   . .# #  .#  # . .# # ## # #  # # ### ###.#  #  ### # #.## ####
# .. # ## ## # .  .   # ## # # #.##### # #...#  # ## # ## ##   #  #.# #  ###.##.# ####.#  ###  # #  # # #  # # # # # ##.##   .   .  .. . #
## # #    #  # ## # ##   . # #. #    # # # # # # . # # # # # # # # .# #.#   ....   .    # # ## #  # # #. #. ## ### #  #. #.# ##.# ## #####
# ##  ###  #.#.# #. #.# ###  # #  #### #.# # #  # #. # #  .  .##  # # #  ### ### # ### #. # .  #.## # #.## # .  ..   ## # .# # # # #.#   #
# # .#    #  #  ..# # . ...# #  # #.  .#=# # # #.  # #.# # # #   #  #. .#    # ## ##  #.#=## # # #  # # #   ###.#.##.#   # #.# .  .# # # #
#  # # ##  # #.#### #.# #.#  # ## ###### # ##. ####  #  # #..###  # #.# # ##  .  .  #.#    ## ## ##.# #. # #  .# # #  #.## # # #####.# # #
# #  # .# #. # #  . # #.#  #.#    .   .  #.. # ..  # # #   #   # #  # # #.#  ###.#.#  # # #  . .. # #.# #   # ##.#.#.#  #  # # #.   .# # #
#.## #### ### #.#### ## ### # ############ ### #### # # # ## ## # #.# #.## ###.## # # ### ######.#  # #  # #  .       # =#.# # # #.# #.# #
#  . .  .   .  ..    . .    .      .      .         ... . .       ..# #  . .   . ....       ..  . # #.# ##  ### ## # #  # .# #.## ## #.# #
##.## # ### #.### # #.## ############### #.## #.## ##.# ## ## #.# ##  # ## # #.# # # ########.# ##  # # #  #   #.  #. #  #.# #.   .  ### #
# ## #.#    ### ## #.#.#.#  .    .     .#. # # #  # ## ## # ## # ## ##  # # # # # # #.. .    . #  # # # ## # # # ##  #  #  #. # #### .   #
#   .#  #.#    .     #.#.## ## # ## # #  #.# # # # .    . .     . .   # # .   . .=#  # ###### ## #  # #  #. ##.###.##.#. # # # #     #####
# #### # #.########## .#  # # # # ##.#. #  # # #  #.######## #####.#.#  .######## # # ..    #..   # # #.#  #   .. ..    #  # #  # ##.#  .#
#     .     . .  .  .# # ## #..  .  . #. # # # #.##        # # .   ##.# # .       #..# #.##.# ### # # #  # ############# ## ## # ## # ## #
# #####.##.### #.####  # #   # ## ##.#. #. # #   .  ### ##.#  ####.  .#.##### # #.# #  #  #.# # .##.# # #     ..             ..  .   .   #
#.# ..# #  #  # # .  # #..#.#   #.#.# #. # #..#.# # # #.#  # #. .  # #. .  .# #.# #. # #.#  # ##.# .# #  # ###.# ##.##.################ ##
# #.## # ## # #.## ##  #.## .# #  # # # # .# # # ##.# ##.## # #####.# #.#### #.## # # #.# ## # # ## #.# #  # #..# #.# # .. ....        #.#
#.#.      .        # # # #  ## ##.#   # ## #       ..     ..         .#      .          .. .. .   # # #  # # # #. # #  #.# # # # ##.##.. #
#. ## ## # ## # ##   #.# .# #   # # # #. # # ## #.#.## ##.# ## # ## ##. ###########.# ####.# ### #.   # ##.#.##.#.### # #.# # # ## # #.###
# # ## ## ##.# # # ### # #.# #### ###.# # ##=#.# # #.### #.# ## ## #.##           # #.#.  # #  # .# ##  #       .       .                #
# .     ..              .#             . .     .    ....               .## ## ### # # # # #.#.#  # .# #  #.#####.# # #######.# ### ## #.##
# ########=## ## ## # ##. #.### ### # ## # # #### ### #### ## # ####### #..# ## ###.### ### # ## ##.#.# #  # . # #.# #   ...# #.. #  # # #
# # . .   #  #  # # #. #.# #  # #  #.#   # #.#   #   #   # # #  #     #  #.#.       . .       .#  #...#  # #.#.# # .##.######.## ## #  . #
# #### #### ##.##.# # #..# # #  # ##.###.## # ## ## #. ##  # ##  # ## # # .# ##.###.# # # ##### .#  ###.#  #.# #.# #   .     . .  . # ##.#
#  .              # # ## #.#  # # . o          . . . #.###..  # # . #.#  # # # ##.#.# # .#.    #  #.#.   #.# #.# # # ## #.## ## # # # # .#
################### #  # #.# #   # ## ## ### #### # #   ## ### . # # .#.#..#  .   # # # #  ## ## #. .## #..# ##  #.# # # ##  # .# # ## # #
#                .  #.## #.# ## # # ## #    #   #.#  # #.. #  #.#  ## # ###  # ###  ## # # # ##. ##.# #. # ..  # #.# # #   #. ###.#    # #
##.#.# # ####.# ###.#.#  #.#. #.#. ..  ..#### ###.# #   ## ## #  #  # # . .# #.#. #  .  .      #  #.#.  # .####  # # #   ##  #   .# # #  #
# # # # #  .#  #  # #. # # # #. #.# #.## #    #  .# .# #    # #.#.###.# #### #. # # #.# ## ####..## .##  #  .  # # # ###  .# #.## # # .# #
# # #   . # #.# .# .# #  # #.###.#.# # # .### ### # # .### #   ... .. # #    #.# .# # #   #    # #. #.# #  ### #=# #. .# ##   # #.# # #. #
#.# #####.## # # ##.# ##..    . .    . # #  # . # #.## . # # ## #.####.. ### # .#.#  #.#### ####  # # #. #.# #.# # ##### # #### ### ## # #
#. .   .            #  # ########### ##.  # # ## # # # ###.## # # . . #.#.   # ##.# #.   .    .  #    #.## #  .# #. ..   .             . #
## # #.# ## ## # ## # #. # .  . .      #.#     .  .           # # ## # .# ## #    #  # ## # # ##  #.# # # .# # # # #.# ##.## #.# # #.# #.#
##########################################################################################################################################
