############################################################################################
#.   ....  ..  .. ... ... ....... .#..... .    .   . . ..#.    .....## #. .. .. .  ..... . #
#.#.# #.#.#.###.#.# #.## ## ## # # #.#.#.#.# # ##.# # ## ..#.#.## #.... .# ##.## ## ##.#.#.#
#...... ........  ..... ...... .   ...  ..  ...  .# . ##.#.. ..  ...## #. . . ..     . ....#
# #.#.###.#.# #.#.# ##.# # #.#.# #.# # ##.##.#.##  .# ... .#.#.##.#.## # #.## ##.## ##.# # #
#...#... .  #.. #.# ## # ## ##.#.#.# # ##.## #.##\# #.## #.#.# ##   ....... .  . ... .     #
#.#...#.#.#.##.#...  ... ... . ............ .. .   .. .. ..  .... #.##.# #.## ##.## ## #.#.#
#.# #.  ..#.##.##.#.#.##.# #.# # #.#.# ##.## #.##.#.# ## #.# # ##.  ##.  ..   .  ..   .    #
#..  .#.#......  .. .  ..   .  .  .    %.... ..  .. .  .  .. ...#.#   .# # ## ## ##.##.# #.#
#.#.#.  ..# ## ## #.# ##.#.#.#.## ##.#.##.##.#.##.#.# ## #.# #.# .. ## .   . . . . ...     #
# #=  # # ....  ..... . ....  ......   ....  ..   . ..  ... o  .# # .. #.## #.##=##.##.#.#.#
#.. #.##.# # #.##.##.#.##.## # #.#.# #.##.## #.## #.##.#.# # #.## #.## #.##.#.##.## .   ...#
#.# .    ...   . .##.# ##...  .  .... ...  .  .. ... .. ......  .. .. .. . ..   . ..##.#.# #
#  .# ## #.# #.## ... . . #.# #.##.# #.##.## #.##.## #.#.# #.#.# ##.##.#.##.# ##.##  .... .#
# # # ## #.# #.##.##.#.##. .=.....  . ... . .... ..    .. .   ... ..... ...  .## ##.##.#.#.#
#.. .  .. .......   . .   ## #.#.#.# #.##.# ##.## ## ## ##.#.#.#.# #.#.# ## # ..  .. .  ..=#
#.#.# ##.# #.## #.##.# ##.## #.##=##.#.##.#.## ## ## ##.##.## ##.#.# # #.## #.## ##.## # # #
#. .=.##.. =.... ....  .   . . ....  ...... . .... .... ....... .....  . ..... ..   .. ....#
# #.#.. .# #=#.##.## #.##.##.#.## ##.#.##.# ##.##.#.# #.##.# #.# # # #.# # ## ## ##.## # #.#
#.  . ## .... .  ...... .    . .... . .  .... .... .. .... .    .... # #... = .   ..... .  #
#.# #.##.# #.## # ## ##.#.# ##.## ##.#.##.# ##.##.#=#.# ## # #.# #.#  .. # ## ##.## #.## # #
# ...... . . .   . #.## .... ..  ...  . . .......... .... .. . . . # #.#..... . . ..# ##.# #
# #.# ##.# #.##.# # ....#.#.##.##.## # ##.## #.## #.# #.##.# #.#.#  .    #.## ##.##.   ....#
#  . . . ..# .... .#.##.# #.##.. ......  .     .#.=.   .##.#.#.# # # #.#.# ..... ...# ## # #
#.# #.## #  .## #.#. .  .   .. ## ##.#.#.#.#.# #..#.# #  . . . ... . ... ..## ##.##.#.##.# #
# . .. . . #.# .# .# ##.#.# ## ##.##. #.##.# #.## # #.#.## # #.#.# #.#.## # #.##.## .  ... #
#.# #.##.#.# ## #.#.  ...  . .  ... .#. .   ...   .. .......... .... .....  . ..  ..# ##.# #
#... ....  ... ....#.## #.# ##.##.## #.# #.#.# ##.#.#.#.##.#.#.#.#.#.# ##.#.#.##.##  .  .. #
# # #.##.# # #.## #   . .. .   ....  ..... .  ... . .... .  . . . .   ....  . ..  ..# ## # #
# .   ...   ..   . #.## # #.##.##.##.# #.#.# #.##.#.#.# ##.#.#.#.#.# # #=##.#.##.##. . .   #
#.# #.##.#.#.# ##.## ##.# #.## ## ##.# #.#.# #.  .  . .... ..    ...   .. . .  ..#.##.## #.#
#..   .... ...  ... . .....    ..   ..... .....## # #.#.##.#.##.##.# #.#.## # ##.. .  .... #
# #.##.#.# #.#.##.# ##.##.# ##.#.# # #.##.#.##.. .  ....   .  ...    .  . #.# #.#.#.# ##.#.#
#..  .. .  .    ..#.## ... .....  .....   ...#.##.#.#.#.## ## # ## #.# ## .... ...   ... . #
##.# ##.# ## #.##... ..## #.##.# #.# #.#.## # .. ..... ..=. ... .#..  .. .# #.# # #.#.##.# #
# .# ##...=. #.##.#.##.#. ...  # #.  .  ..   #.## # # #.##.# ##.#..# # ##.#.# # # #.#.  . .#
##.#.##.#.##... ....##..# # ##...  #.#.## # ## ##  ...   .. . ...#. ...  .. .    . .  ## #.#
#.##........ #.## #. ..#     . #.# . ..    . . ...#.#.#.##.#.# #.  #.#.##.# #.# #.# #. ..  #
# . .## #.##... ....## ## # ##...  # #.##.#.##.## .. ... ......  #.     . .   ...  ...##.# #
# ##.##.# ## # ##.# ## #.#.#.#.#.#..         .....#.#.#.## #.## #..#.#.##.#.# #.#.#.#.. .  #
# .     ..... =... .  .... .. ..   #.# ##.#.##.## #.#. .##.# ##.##.# # ##.#.#.# #.# #.## #.#
#.##.##.# ## #.## #.##.#.# #.# #.#. ...  ....   . .. .# .. .   .. .....  . .     .  . . .. #
#.##.## #...= . ..  ...  ... .   ..# #.##.# ## ## #.#...## #.##.##.##.# #.#.#.# #.#.#.## # #
# . .  . .##.# ## # ##.##.# ##.# #..... ..     . . ...#.##.#..  ## #.  . . . ......  . ....#
#.## ##.# ..  ..  ..##..    ..   . # # ##.#.##.## #.# #..... ##  . .#.#.#.#.#.#.#.#.#.##.# #
# ..... ..##.#.## #..  ## # ## #.#..   ..... ....  .....## #.##.##.##.#.#.#.# # # #.#.##.#.#
#.## ## # ##.#.##.# ##.##.#.## # #.# # #.#.#.# ## # #.# ## # ..=    . . . ..  ..  . .=.... #
#.      .... ..   . ..  .....  .... . ...   .  . ..  .  . . .## ##.## #.#.# #.#.#.#.#.#.##.#
#.### # ##.##.##.## ##.##.#.## # # ##.## # #.#.## #.#.# ## # #..  ..   ...# # #.# #..  .. .#
#    . .  ... .. .. ...## #.##.# #.##.##.#.# # ## # # #.##.#..#.## ##.#.#.. ... .  .#.#.## #
#.# # #.## ## ##.##.##     . . .  .  . .....  . .   ..... ...##.##.     #.##.##.#.#   #.## #
# .. . .  .##.## ## ##.## #.##.# # #.#.# #.#.# ## # # ## #.#    . .##.#.. ..  . .  .#.. .. #
#.###.#.##.  . . . ..   .. .  .... # #.# # #= .  . ..   .  =.##.## ## # #.##.## #.#. .# ## #
#.# .  ....## ##.##.##.##.#.##.#.#.. .....  .# ##.# #.##.#.#   =....   . ...  ...   #  .## #
# . #.#.## . . . .. ... ...... . ..# ##.###.## ... ...##.#.# #.#.#.#.## # ## ## ##.## #.. .#
#.#.# # ##.# #.# ##.## ## #.##.# # #.#.#.##.#. ##.#.#......  # #.#.. .   ... ..  ....  .## #
#.    .. .   ...   .... . ..   . .. .      ..#...  ...##.# #.  =   # ## #.##.#.#.# ##.#.   #
##.##.# ##.#.# #.##.# #.# # ## #.# # #.#.##.##.##.# #.. . . .# #.#.# ## #.## #.#.# ##.# ## #
##.##.#.## #.# #.=   . .  .. .. .. .  ....  #... .... #.##.#....  .   . . . .   ... . .....#
# .  ..   ... .  ##.#.#.#.#.## # # # #.#.##. #.##.# #.#.##.# #.#.#.##.#.# ## ##.## ##.# ##.#
##.##.#.## # #.# ## .  ...  ....  . .. .. . #.   .    .       .. .   .  .... .. . ..   .. .#
#... .  ..  ...#  ..# # # # ##.# #.# # ##.#.##.#.# ## # ## #.#.#.#.## #.#.## ##.## ## #.## #
## ##.# ##.# # ..## #....  . . . .    ...... ..   .. ......  .  .  .... .  . .  . . .   .. #
#    .... . .  #...  .# # ##.# # #.# # #.##.##.#.# ##.## #.#.#.#.#.#.#.## ##.## ##.##.#.## #
#.# # # ##.#.# . ##.#.. .. ..#.. . ......    ..  . . . .  . . ....... . .  ...  . .  .. . .#
#.#.# ... .. #.#..... #.##.#...# #.#.#.## # ##.# #.##.##.##.# ## #.#.#.## ##.## ##.##.#.##.#
#    .##.# #.  #.##=# .. .  .#.. .  ....   .    o. ...... ...... .  ... .....  .. .... .. .#
# #.# ## # # #    . ..# ##.#. .#.# # #.#.##.##.# #.##.##.## #.##.#.#=#.## #.#.# ##.##.# ## #
#..  .. ...... #.## #... ..# #.# #....   . .##.#.#.##.##.## #.##.#.#.# ##.#.  #.##. .... . #
# #.#.## #.#.#.. ## #.#.##..  ...  #.#.## #..  ... =    . .. .=..... .... . # .....## #.##.#
#.#.#.##.# #.#.# .. . ... .#.# # #.#.#.  . .## ## # #.##.#.# # #.# # #.## #...# ##  ...   .#
#.... .. .. ..  .##.#.#.## .. ..  .... ## # ##.## #.#.#.. .# #.....# #.##.#.# # ## ## # ##.#
# #.## #.#.# # #.##.# # ## #.#.#.#.#.#......    ..  . ..#.#... #.#...... . .... .   ... ...#
# ... ... . .... .... ....  .... .  . .# ## ##.##.# # #   .#.#     ##.#.# #.#.# #.# # # ##.#
# # ##.# #.# #.#.## #.# ##.#.#.# # # # #.## ## ## # #.# # ##.# #.#  . ...  . ....  . .  ...#
#.. . ..  ......  ..   . ..=.. . ....     . .. . ......  ..  ..... #.#.##.#.# #.#.# # #.##.#
# #.## # # # #.#.## # ##.#.#.# # # #.#.#.##.# #.#.#.#.# ##.#.#.#.#.#.#.##.#.#.#.#.# # #... #
#. .. ..... . ....   . .... ..  . ...  . .=.   ....  .. .. .. ... . .. ...=.....  ..  . ## #
#.#.#.## # # #.#.#.##.## #.# #.#.#.# #.#.##.##.## # #.##.#.# # # ##.# # # #.# # #.# #.#.## #
# #.# ..... . ... . . .. ...  .  o . .  .  . ..    . .... ..  .  .  .. ... ........ .    ..#
#....#.#.#.# # # ## #.##.#.#.# #.# #.# # ##.## ## # # ## # #.#.#.# ##.#.# #.#.#.#.# # # ##.#
# #.#. .. .... . ......  ....    .   .. ..  .... .... .. .. ..   ... . .   .. ....    =.. .#
# . ##.# ##.## #.##.#.##.#.#.## ##.#.#.## #.#.# #.# # # # ## #.#.#.##.# # ##.#.##.#.#.#.##.#
#.#.  . .. .  . .= . . . . . ... #  .  . . .. # # #.#.# ..    ..  .. ..  .. .  .. ..    .. #
#  .##.# ## ## #.## # ## #.# ## #..# # ##.#.# ..  .  .  ##.# # #.# ##.#.# ##.#.##.# # #.## #
#.# ##  .    ......  . . ..  .#.##.#.#.##.#.#.#.#.#.#.# . .o. ......= .  ..  .......  . .. #
#.=.   # ## ##.# ##.#.##.#.#.#. ....  ...... .   .. .. .##.#.# ##.###.# #.# ##.## # #.#.## #
# #.##.# ## ## #.## #...   # ##.## #.# ##.# #.#.#.# # # ##.# # ##.#.#.#.#... .  ...... . ..#
#  .  ........  .. ...##.# . ... .. ..    . .....     ... .....  .   . ...#.## ## #.#.#.##.#
#.# ##.#.## #.# # #.# ## # # ## ##.#.#.#.#.## #.#.#.#.# ##.#.#.# ####.#.#..... . . .  ... .#
#...   ... . .... ..  . . .   ..      . . .  ... .  . .   .    .. ..... ..# #.#.# #.#.#.##.#
############################################################################################
