#################################
#.    . # ..#.#   .# #    .    .#
##.##.# # # .  .#.#    # ####o# #
# .     . # # #.#. # #. =      .#
# ## ## ### ## ## ## #.##### # ##
#  # # .   o  ... . .     ..  .=#
#.# ..#.##.#o##.# # ##.#.## #.#.#
#  # # . . ## # ##  . .#  # # # #
#.##=#.#.#  .    .#.##.# #   .. #
#          #.## ## .#    .# #.#.#
####.###.## ## ## #  # # # # ##.#
#. .     . . . %. . #  # ..  ...#
# ## #.# ##### ## # ## # ##.# # #
#.#  # # .. =     # .# # #    #.#
# .# ## # ##### ## # # #.# # ## #
# ##  . .   .  .    .     . .   #
# #  # #.# #.#.# # # #####.##.# #
#  #.# ## ##.#.#.# # # =   .#   #
# # .     .      # #  # #.#   # #
#. # ####.## #.#.  #.#.   . # # #
#.# . .   #. # # #  . # ###.#   #
#  # # ##=.# # #.  # #        #.#
#.## #    # ..   # #  # ##.## # #
# #  # ##.## #.# #.  #.## #.#   #
# .# #    .# #.#   #  .. . .  # #
#.## # ##.# .# #.# # # ##.### # #
#    . ##..# #  .#     # . .    #
# ## #. . # .## # #.## ## ### # #
#.   #.## ##    .    .    .  .\ #
# ##.#  #  . ## # # ## ## ###.###
#.## # #  ##o#   .   #    .. .  #
#. .    # #. .# # # #  # ## # # #
#################################
