#############################################################
# .#. #   .. ...#...# #....#. # # #.#.. . ....... ... . ....#
## #.#..#.#.#### .###.###.#..#. . ..#.## ##.#################
#.  ..#.#  # . .#.   ...# ##.## #.#.#.#.#  #... ... .. .... #
####.## #.##.####.###### . #  #.##.# .# ##.###.##############
#.  .. .#.#. .    # ....#.#..#... ..# # .    .    .  .   ...#
#####.#.## ######.####.#...# .#.## #..# ## # #.# ## #.##.##.#
#...#.# ..... ... ... ..#.# .## #.#.# #.#.#.#.#.#.##.##.##.##
##.##..#### ##.## ######.  #.# .....  ... . . ...  .. .... .#
# ...##  .. #. .#.#. ...# ##..#######.## ##.##.#.#####.##.###
#### #.#####.##.#. #.#### #  #.. . ...#.# #   # #. .  . # #.#
#... # ..  .....  # .. ....#. ##.#.## # # # #.#. #.### #. . #
####..# #.#####.#..## #.# #. ## #.# # # #.#.# # #....#..#.#.#
# .#.#.##  %. . #.# #.#.#.##... .   # #.#.#.#.#..#.###.# .###
#.#..#.#.#######. #.#.#.#..#.####### .#.#.#=# # #..#....#...#
#.##  .  .. ... # # # #.# #  #..  ..#.#.#.#.#.#..#..##.#..###
# ...############ #.#.# #. #.## # #.#.#.# #.## .#..#.  .#.. #
##.#..  ... ..  ... .. ## #...# #.#.#.#.#.# ..#..##.## #  ###
##.########.###.#.##.#. ..## #.##.##  #.#.# ##..#. . . .#.#.#
#...   . .# . #  #.#  # #. .. .  . .# #.#.#.# #.#.####.##.#.#
########### ##..# .#.# ##.####.### #..#.. #.#.#.#.#  #....# #
#.......   .# #..#.#.#....#  # #..#.#. ## #.#.#.#.## #.## # #
### ## ##.# # #.# .#\.###..#.#.#.##.#.#.# # #.# #. #.#.. .. #
#. .#.# #.#...#.##.#.# .# #..#.#..  # # #.# . #.#.## # ##.###
# #.#.#.#.#.## ....#.#.##.##.###.###. ..# #.##. #....#. #  .#
##.##.#.##.#.##.# #.  ....... ... ..# ###.. #.#. #####.#..# #
#. . ...  ..  . ##.#.# # #.##.#.##.#..#...#.#.#.#....   #.#.#
#.# ####.##.#### #.# .#.## #.# # #..#.###.#.. #.#.####.#.#.##
#..# . .#.# #o...#. .#. ...#.#.#.. ## ..#.# ##. # #..  .....#
# #..##.#.#..#.###.#. ####.#.# ###.# .###.#...#.#.#.##.###.##
##.# # ##.#.#...  ...#  ...#.   .#. #. ...#.##. #.#.#.. .#. #
#. ..... .. ########..#.##.#.#####.#..###.#...# #.#.##.##  ##
#.# # #####... ..  # #.#.#.# .  ....# ..# #.###.# #..#...# .#
###..# ..  .###.##.# #.#.# #########..#.#.# #. .# #.##.##..##
#...# .##.# #..###.#.# # # . ...... #.#.# # .##.#.# # .. # .#
####.#.#.#.# # ## ##.#.# ###########. # ##..#...#. . #.### ##
# ..  .#.#. ............ ..... . .  # . . #..##.#.# #. #.. ##
##.# #.#.#.#.#.# ### #.#.##.# ###.##. ##.# .#...#.#..#.####.#
# # #.## #.##.# ##.## #.##o#.## ##.##.# #.##.## # .###.. . .#
#  ..  ... ....... .. ..   . ... ... . =...  .. #.#... ######
# # # ##.## ## ##.# #.# # ##.##.#### ##.#.# # # .# ###......#
#..# #.#.#.## # ##.# #.#.# #  # #  #.#..## .## .#    ..# #.##
#.#... #.# # . .. .#...#.#.#.#  # #.  #...#...#.#.## #..# #.#
# ##.## .#.#######...#...#.# .#.. .#.# .##..#.#. #.#.#.#  ..#
#.... .#.# .  .....#.#.## .#.#..###.#.# ..#.#.#.#. ..# .#.###
#.##### ##.#########.#..## ##.#.#.... . ##. #.# .#.#.# #....#
#.#.  .... .. .  .... .#.. . . .#########.#.#.#.#.## #.##.###
#. ########.##.#######.#.# ##.#.  ... .....##.#.#. ... .....#
#.#..... ..#..#  ....#.#..##.##.##########.# .# .##### #### #
# #.######..# ##### ## #.# .. .. ....... #.##.# # .  . #..#.#
#.#.# .....#.. . ....  # #.#.##.#########...# #.######.#.##.#
#. #.#####.######## ##.## #.# #....... ..#.#. #..... # #....#
#.#......... .o..... .. . .. ...########## ###..# ##.# .# #.#
#..# ##.##.### ##.#.#.##.##.#.# #. .... ... ..#. ##.## # #..#
# #.#.## ###.##.##.#.#.##.##.#..#.# #.## ##.##..#.... .#..#.#
#.  ....  .... .  . ..... ....#..# ## #..#o #.#.#.#### #.#..#
#.#.##.#.#.##.#.##.#.#.# ##.#.#.#. .  .# .#.#.#.# #....#..#.#
# .##.# #.##.##.#.#.#.# ##.# .#.=##.#.#..#... #..#.### #.# .#
#=#.. ... ... .....  . .. ..#.#.#.  #..#..# #.# #. ..  #.##.#
#..## ## #.# ##.#.# #.#.## #..#. ##.# #. #. # #..#.#.#.#. ..#
#############################################################
