############
#    \# #..#
# #.#.#.#.##
# # # # # ##
#  o oo%# .#
## ## # # ##
# .#     . #
## .# # # ##
#  #. # #  #
# # ###o#=##
#==    . = #
############
