#####################################################################
# .# # # ## # # # # # # ##  ..       .   # # ##.# # .# #.           #
# #.   o   .               ##### # ### #.# #   .    ##.# # ### # # ##
# # ##.#### ############## #   .   #.# # .  ## #.## #.  .# #    # # #
#. # #     #             # # ## # ## ## ## #    ### .# # #  ## #  #.#
# #  # #.##  ### ## # # #.      .        # .# # ##  #  # # # # .# # #
#  #.#.### # # ## ##.#.# # ### ### ###### .#  #  .# #### ### ####.#.#
# #  # .  . .            #    #. # #.    # ## # #           ..      #
#  # # ### #### # ## #### .## # #  # # #.#  #... .#.# # # # # ## ## #
#.# .# # # #   # #       # #  .  #.#.#   ..# .## #  #.## # # #.# #=##
#  # # # .  # ## #### ###   #.#### # # ###  # #   #      . . .   .  #
# #. # #.# #  #      .   # #  #      #   #.#  ####  # # ## #.##.## ##
#  # # #    # ## ##.### # . #.# #### # ##.  #     #   ## # # # # #  #
#.#  # # # #   # #  #  ..# #         #. .# # .#.## .# .  # # # # # ##
#..# #  # # # ##.### #####.# #######.# # #. # ### # # ## #    .#  .##
# # .# #     .              #  .   # #o# #o#  .   #   # ## # ### ## #
# .# #  # ######## ## ## # #  # #.#    # #  # ## #  #.#   . ..  ..  #
# # .# #.       .# #.    # ## # ## # ## #  #  #   # # # ## #.#### ###
#  # #  #.####### # # # ## .           . # .# ##### #.#  #=# #  # # #
# #  # #   ... . .         ####### ##### # # . ...  # ##   # # #. # #
#  # # # #.## # # # #.## # #      ..   #.# # # #### #  # # # # #### #
# #  # ## # # #    # #.###  # # ## ####  # # # #  # # #  #.# #  .   #
#  #.#   .      ##.  #     ### #       # # # # # #. # .#.# # # #### #
#.#. # ## ## ###.# # ## ## .## # # ## #  # # #   .# # ##.# #..      #
#  # # #   .    .   ..   # # .     # #.#.#.# # ###  #   .# # ###### #
#.#  #  ############ # # #  .### # # # #   # #    #.# # # .#     .  #
#  #.# # .    .      #.# # # # ### # #.# # # #####  # #.## # ######.#
# #  # .### #.#.# ## #   # #  . .  # # # # #  .   # # #  # #      # #
# ## # ## ## # # # # #####  ## # # # # #.# #.## ##. # # #  # #####. #
#  #.# #           .       # ## #  # # # # # #  # # # # ##.# #   .# #
# #. #  # ## #.# #.#.## ##    #. # #   # # #  #     # #  # #  # #.#.#
# ## ### # ##.# # #.## #.# ####.#.## # #.# ### #### ## ## # ## ## ###
#.  .  .  .     .  .             .              ..               . .#
# ### # # #.# # # # ## ### #.# # ### ### ### ### ######## ####.# ## #
#.# # #   # ## #.#  #  .  # # #  # # #  #  .#. # #   . .# #  .# # # #
#   # # ###.. .   #  #### #    # #    # ##.## # # ####.# ## ###   #.#
# #     #   # # # #.#      ## # # ## #.     .    .        .\    # #.#
#  ##.## ## ## #  #   # # # #   .  # ##.#.###.# ## ### # #.## # # # #
# #   .        .# # ## #  # # ### ##  ## ## ## # # # ## #.## ##.###.#
#  ##.### # ## #  #.    #     # # #  #           .         ...     .#
# #.. = #  .    #   #.### ### # ## #  ## # # ## ## ## # #### ### ## #
# # ### ## ##### ##.        ..     # #  #.# # #.  # .##.#    #  # #.#
# #     .   .       ### # ## ## ###   # #.  # # ##  #    ### #.#.   #
# #.# ### ## # # ## #.## #  #.##   # #    # #   # #  ## #..#.#.####.#
# #  # . #. # #.. # #  #  #     .# #  ###   # # # # #  .#.## #    # #
#  #  ##  # .  # ##.# ## # .### ## # #. # # # #     # # .    # # #  #
# #  #. .## ## # #     .. #.#    ..#  # # #.#  # ##. ## #### # ##.# #
#  # .## #  .# #  # #######  ##### # #        # # # #     .  #.   # #
# ## #=   # # .# #  #    %. #      # ######## #   . # # # ## # ## # #
#    .## #. #.#.  #  # # ##  # ###.#..    . #  #### # ## #.# # # # .#
# ## #.#  #   .# #. #..#  # #. #   # ##.# # # #..  .    .    # #  # #
#  # # # ##.###. ##  # # #  ## # # # ## ##  # #.# # ##### ## # # #. #
# #            #  # #  #  #  # #.# #      # # #  ##. .. #  # #.#  # #
#  #.#.## # ## . #  ##   #  ##   # # ######.# # # . # # # #  #.# # .#
# # ##.# ## # ###.## ## # # # # ## # #     .# #  ##  #.## ## #.# ## #
# .       .                .#  .  .  #.#### # # #   #.     # #    . #
# ## # # ## ## # # # ## #.#..#### ## # #    # # # # # # # #   ##### #
# # # # ##   ## # # #  ## # # . #  # .# ##### ## # # # #.# # ##   #.#
#    .    .#  ..  .  #.     #.# . # .#  .              ..       ##  #
###### #.# # #.## #### ## # #   #.## .## #### ### ### ### ## ##   # #
#      ##. # .         ##.#.# #    # #  #   .# .# #. # .   #. # ### #
### ##   #  # ## ## ##    #.#  .# #  # ##.## # ##  #  # # # .#   .  #
#   #  ## .# ## ##.# # #.##.# # #  # # .          ## ## ## #  # ### #
# #. #   # #..  .           #   . ##. # #### ## #   .   .  # #  # # #
## ## ## #.######## #######  ## #.#= ###.  # # #..#### #####  #.# # #
#       .  . .  . o   ..    # # # ## .## ###   .# #  #.#     #    # #
## ### # # # ## # ##### #.# # # #  #.#    =  #### # ## ## ##  # # # #
#   .  # #   #  # #  . .# #.  # # #  ..## ## # . .    . ..   # .# # #
#####################################################################
