#########################
#  # ## .. #.#  . .    .#
## #    # # ..#.# ### # #
# .####.## # #.# #  # # #
##.   .  .   ....#.##.# #
## ## ## ### ## #  . .# #
# \ ..#. o # # .#.# #.# #
### ## # ## #.##.# #..# #
# ..   . .     .. ..# #=#
## # #.## #### ##.##.## #
#  #  #    o # #. . ..  #
##  ## ## ##  # #.## ##.#
#. #   .  # .#. #o#.#%# #
### ##### .#.# #  #  . ##
# .     . # ## ## # ##  #
# # #.###.  . .=#  . #=##
# #.#   #.### ## ##.# # #
##  # #      #.#..#.# #.#
# # #   # ####.#.#. # . #
#  .## #  .    .  # # # #
#=#.  #.##.# ##.###.# ###
###.# .  #=#  .# .   .. #
#  o# ##.# ####. ###.##.#
# # #   #. .   # #    # #
#########################
