################################################################################################
#  # #...=#   # # #  #  #  ###  # #   #..  #  .= #    #   .    #  #         #   #    # ##. #.  #
# #    # # #.#.    #. .#  # #  ## .##  # # # # # ## #  ## # ## .# # ##.#.# #  # . # #     # #.##
#  # ##    #   # #. ##  # . #.#  #.   #.#   # #  . # #  ..## ##   #  # .# # =#  #. #  ####     #
##  ##  ##  # #   ##..#   #   .# . # ## # ### ## # #   ##. #   ## ###  ##.# #  # .#  #     #.###
# #    #  # .# .#   #  # # # #  # ##    # .. .   #.###.#. # #.#     # #     #.#.##.#   ####  # #
#   ### .#  #. #  #  #  #    .# # .  ## # ### ## #    # #      # # #   # ##. ##  #  # ##    #  #
# # . # # #  .#.#  ### ##.# ## # # #    ### #.#. ## #  .### # # ##  .##   ##    #  #. #  ##   ##
#   #    .# #    #     #. ##      # ###     .#. # # ###    #  #   # # . #  # # ###.  # #  #### #
#.#  #.##  #. ### .# #   # . # #.#     # # ##  #  ..=  ## #  #. ##   # ###  #   #  # #  ##    =#
#  ##   # ## ## ## ##  #   #. #    # ##. #  # #.# # ##   #  #  ##  # . #### # #  #=#  #    # #.#
##  # # # # .    #   #   # # #  # #     #  #.   #   ####.  # .##  ## #. ##.#    #  ##  # #  # ##
# #.#.#   ## # ##  #  # # #    #  # ## # #  #.## ##  # . #   #   #   ##    # ##   #  #   # #.  #
#  #.## #.  ## #  ## # #   ### .# #  #   # ##   . ##  # #  ## # #. ##.##.##.   # # #  ## #  # ##
# #  # #  # #   #.#  #  .#  .  #. ##  # ##. .## #   #  #  #    . #  #   #.# ## # # ## # ####.  #
#  #  .## #  .#  #. # .##### # #.# # #=.#. # # #. ## # . #  # ## .#   ###    #  #.     . #   # #
##  #.#   # #.  ### # # .#   #  #   # #   #  #  ##   # # # #    # # ##.  .#.###  ## ### ## # ###
### #   # #.  ####  ##.# # ####  ## #  ##   ## #   # .##  #  # #   # ## #  # ## #   # .    #   #
###. ##..## #.  #.# .# #   #.#  #   # #  # #   . ### # .#   ##  ###     # #      # #  ## #  ## #
## #   ##.   ## #  ##   .#    # # # #  #  . ### #   #.# # #.# #. . ## # .# # # ##. ####  .#  # #
#  # # #  # # #   ### # ##.# # # .# # # # #      ##.     #.  .# # #  ###   #.# #  #     #  ##. #
# # .#  # ##  o #. # # .#   #   .#  #    # # ## #   # ##.#.#.#  #  .# # .## #   # ##.# # #  # ##
#   ## ##  # ###  #    ## ##  # #  #.# #   ##    ##  ##. . ##  #  #.    #. .  ##   ##.## # #  ##
## #     # #    ##  ## # .#  #   #  . # #.#  # #  . #  .# #   #  ## #.#  # ####  #. #.     ##  #
#   ## #.  ##=#   # #  # # #.=#.#  ##.# #  #..#  #### #   ### # ## ##  .#      .###  # # #  ## #
###  .### # .   #  #  ## #   ### #  # . .#   #  ##  . ###    #. #  #  #  # #.# # #= # ##  # .  #
#  #.# # #  # #  #   ##  . #  #  #.# %## . #  #    # #    ## . # #  # # # #  ##    #    ### # ##
##   #    #####.# ## #  # #.##  #  ##.#  #  # # # #   # #### ##  . # #      #   # #.## # .   # #
# ## ## ##  #. # .# #  #    # #  #   # #  # # .#   # #  # # # . ##=    # #.## #####    #.### # #
#  #   .#  ## #  ##   ### #  ..#   #    # #  ##  #   ##      # ##.## ##  # #  . #  # # .   .#  #
# # .##  # #   # #  #  #  ## ##  ## # #  #  #   # ##   #### ###   # #  #  #  #### ### ## # #  ##
# ##   #   ## ## ##. ##  # #  .#  #  # # # #  # #.  .##.   # # #.##  #. .## # =   ###. #   # # #
#    ## # # # #   .#   #    # # .#  ##.  # # ### .##   .## #   #=# #.## # .#  # #  #  ##o#.   .#
## #.#  ##  #  .## .##  # # .#  # #.   ##   #####  # ## #  # #    .#.  .##   ##  #  # #   # #.##
#.. # # . .#  # # # #  # ..#  ##  # ##  # #. ###  # ##  # # . # ##   # # ## #  # # #.   #   #  #
## #  # ##  #   #  #  #####  #   #    ##  ## .# #   #  # #. #  .# # ##       #    #  # ## # ## #
# #  #   # ## # .# .#  #   #  ##  # #    #  #   # #  ##  # ## #      . # # ## # #  #.###  #.=###
# # #  ###.    #   ##.#  #  #.### . ##.##. #.# #  .#   #   #   # #.####   #    #. #.  . # .# . #
# . .##   # ##.#.# #. # ###  ..# .##    . #     ## # #  # #. # .. #.  # #  # #  ## .# ## #  ####
#.## . .# .  #   ##  ##  # .##  ##  .## ## # ## .####. #   ##  # ## ## . #  # #   ##. #  # ##  #
# #  # # ### # ##. # #  # ## ..#  ##  #  ..##  #   #  #  #   #  #   # .## #  =### #  ###   #  ##
## ## ..   #. #   #   ##   ### . #.## . # # . #  # .#### ## # .# ## .#    # ##  # ## .#### # # #
#  .. ### # ##  ##  #    #=    # .  ### =## ##  # # . #    #  # . ##.  ##.  .# ##   ## #. ##  .#
# # # . #     #   ### # ## # # # #.#  # #  . # ##  # # .# # #   #   # # # ## . #. #    # #   # #
# .# ## ## # #  #    #   .###   # # # #  # # #.  #    #  #    ##  #. .. .#  # # #. # # #   ### #
##.#  #  # ## ##  ##.  ##  # # #  .   # #   ### ## # # #  # ##  #   ## #  #     # #.  #  #   . #
##  #  # ##      # # #   # . # # ## #    # # #    ###  # #   # # # ##.#.# ###.##    #  # # #.#.#
#  ## ##    # ###.   ### .### #. # ##.# ## #.#.## ##. ##  # #    #     . #       ##. #    #  # #
# # . . .# #  #  #.#   #.#.    # #   # ##   .  #.    #   #. .# #  # # ##.# # # #  # # ## ### . #
#   # ##. # ## #  ## ### #### # #  #   # # ##.#  # ###.## .## #. ##  # ##       # ##   #. # # ##
# ## #.##       #.  ##      #  .##  .#.# .#    # #..  # # #  .# #  #.# . .# ###   . # ###    ###
#     . # #.### # #.  .# ##  ##  # # # . #  # #. # ###    # ## . #     ## # #   ## #.  #  ## ###
## ## ##   #  .#.  ## # #  # # #  ### .#  ## # #  #.  ###   #. ######## #  #  #   ## #  #     ##
# # # #  # # #### #       ## #  # ##  #  # # .. #   # #  .##  # .#       #  #  # #  . # #.#.#  #
#    # # #     ##. # ## #.#  ##    .# .##  ..###  # #  # #   #.#   #.## # #  .#  ### #     ### #
## # # ## ## #   # .## #.   # # # ## #. ## ###  # #  #.# ## #  #.## # # # # ##.#   #  # # # #  #
#  #.#  ..  # ##  # #. # #.#    #    . # #    #.#  #  # #     ###   # #   # # . # # # ##  . .###
# #   # # #  . # # #  ### . # ## # ###   # ## . ##  #   # ###  # .# # .# #   # #     .   # #   #
#  .## #   ## #.# . #  ## #  ##      # # # # .#   #  # #      ## #    #  # ###  # ## #.##  # # #
## # . # ##       #. #   . #   # # #. #.#   #..# #. #. .## ## #  ##.#   # #  .#   #. #   #.#  ##
#.   #   #  #.## # .#. # # .##    #  #  # #  ##  .#  ## . #o   ##    #.# .. #  ## .##  ## #  ###
# ###\# #. # #    #   #. # ## ###. # .#  # #  .# # # #  ##  # #   # # .# ### .##  #   ##=   # ##
# # .  ###    # ##  #   # ##  #  ##  # #.#..##      #  #. # #  #.##  # #  . #    ####. .##.#  .#
#   ## .### #.# #  #  #   # .#  #  #.#.# .#  . ## #.# #  ###.# # #. #   ##=## # ### # ##.. # # #
# ## . # # # #   ## ###.#.  ###   #  #  #  .##  #.#    #  #. #   # # # #.# #   # #   #. .# #   #
#  #.# #   # # ###  .   #### ###.#  # # ## #   #  ## # .#   ### ###  # #. #  #     #   #  .  ###
# #   #  ##     .  ##.#  .    ##   #    .# #.# ##   ## #  # .##  # # .  #. # ## ##..##  # # #  #
# ## #  # . # ## # #.. # # ##   # #. ###    #   ## #.   # ##    #    ## # #   = #  ##  ### #  ##
#.. # .#  #.# #  #. # # # # ### #  #   # # #. #   #  # #.   # ## ## # . #  #.## ##  .#  ## ##  #
# ## #  # # .#  #  #  #.        ##  #.#      # # #  ## ### #   #   #  ## .#  ##  ###. #     # ##
##   .#     #  # # # #  ## # ##   #    ## # ##  #  ##    # #.#  # #  # # #. #. #   ## #.# ##  .#
#.# #  .## # # . ###.# # .#  # # # # #   # #  #   ##  ##      #    ## .   #   # ##   # .#    # #
#  #.# # #    # #    ## .## #   .   #.##    #.  ### # #. ## #### # #  ###   # # ###.#  ###.#.# #
## # ##  ## ##  ## #   # .   # #.# ## # ###. .##=   #. #= #   ## # .#   #.#  #.  # # #  #  #  ##
##     #  ## . # ## ##  # # #..#. ##. #.   # #. #=## #. # .#.#   ###. #  # #.###     ##  # ### #
# ###.###    ###  #   ## #   #  ##   ### ##.  # o #   # # # ## ##    #  # .##    ### =## # .  .#
# .   ###### #  .#  # #.=  # ## #  # ##   . #  ##  ##   . #    #  ##. # ##.   # #   #    ## # ##
### ## ##  #  # # ##   # # #  .#  #     ## ###   # .## ## .# ##  ### ##   # ###  # # # #    ## #
#   #    # .# #      #   #####  ## ### ###. #  # # #  #. # #  # ###  #  # #.#.  ## # # #.##.   #
## ##.#.### #.  ### ## # . #   ###    # # #  # ##   # . ##. # #  #  # #  # #  ###  #   #.   ## #
#  #  .# #   #.#  #  .## ## #.###  ##   #.# #     #   #   #  #  ### # ## #   #   #  # #  ####.##
# #  ##  . #.#  #  #.#. ##.   ## ##.  ##.    # # ## ## #.#. # .# #    .# # ##  #   ## # #     .#
#. # #  # #   #  #  .##.   ##    #  #   ## # .#      # . ###.# #  #### .#    #  # ## #..# # # ##
##     ##  # ## # # #.  ##.  #.## ##  # . #  # ## ##   #     #   ##    ## ##   ##   . # . ##  ##
#  #.# #.##    .   #  ##   ##  #.  # # ##. ### .     # # # # #.#=# #=# #  #### # # #.#. ## ##  #
## # ##  # .##.#.#   #   #   #  # # # .  # .   # # ##   #   # .##   #.   #.# . #  #   # # =  # #
#  .#   ### ##  #  # ### ## #. ## #. .## #### #  ## .###.# #.##  # #  # # . ##.#.#  #  #  # # ##
## # # # #  . ##. # .     #  #     # ##     .#.#   #.  #   #    ##  # # # # # .#.  ###   #### ##
#  #.  # # # # #.###.# ##  #  ### ##.#.## # #   # #  #   #. # #.   #  #   .# #. # # #  ## # ...#
# #  ##  . ##.. # #. .#  # # #  #.   #  #. # # # . # ### ## # # ## . # #.###  # .#  .## #  # ###
#. #. ## #  .##    ##.##    #. ### ##  # #   #   #  #  =#    ## .# # # #.   #. # # ##     #    #
# #  #  .# ##. # #   # # ##   #.# #   #   ### # #  #  # . ## #  # # ##   ##  .##   #  ##=#  # ##
## #  .####   #   ##.   ##  # .   # #.## ##.   # ##  #  #  #   ##      #.#  #   # #  #.# # # # #
##   #.  ##.#   #  #.## .  #.## #   #    #  # #  ..#  # ##  # ##  ## #  #  # # ##   ##  .#  .  #
#  # # #  = #.##  #. #  ##        #  # ## .#    ##  .#    #    . #     #  #      .#. . #   # # #
################################################################################################
