########################################################################
# ###. #.##.###....#  #  #..##. .#.#.. #... #..#.#......#.. . .# ..#.#.#
# .#.#.... ..#..####.### ##.. ##...#.#.#.###..# . #.### ..###.#.##   ..#
#.#..#.#.###  #. . ...#. ..#.#..## #  # . ..#..##.#.#.. #.# . ... ##.#.#
# .# # ##..#.#.#.###.#.#.###.## .#.#.#..#.#.=#. . # .###.##.##.##.#..#.#
##.#  ... #..#.#.#.# . . .......#  ..#.#..#.#..## ..# . ...#.# # ..#.# #
#   ##.# #.#...# #.### #.#.########.##.### . #..#.#.#.#.##.#.. #.#.# ###
##.# ...##.### # .  .#.# #......#.#   ....# #.##...#..# #.. ###.#..#...#
#..#.#.# .   ##. ###.## #.####.#..####.####.#. ..##.# # ####..#  # #.#.#
##..#... #.#. .#.#.# .... ...#.##. . # #... # ##... ..#.. ...#. # .  # #
# # ##.## #. ##. #.# ###### #....###.#..#.# .#..#.# ## ##### #.#.####..#
#.#... ##. #  .# #.# #.. .#.##.#.. #.# #...## #.# ##. ..... .# ..#...###
#.#####. .##.#.# #.#. #.## #.#.#.##..#..# #.   .## ..# ##.##...#..## ..#
#. ....#.# ..##..#.#.## #..#.#.#...# #.#.#..# #. #.#..# # #.####.#. .# #
# ## #.. #.##.# # .  # %.#.  ..#####.#.#.##.##.##..#.#  #. .....#..##..#
##.## ##.#.#...#.####  ###.####. ..    .. .  . #.# # # ######## ## #..##
#  . .#..# #.# ... ..#. . .#..  ##.### # #####.#.# #. .##=. ..#.... ##.#
# # #..#.# .#.######.# ###..#.#..#.#....#. . .##  #..##..####.##.## .  #
#.###.##.#.# .   ...  .# . #.####..#.##.#####.#.#..#####...  ....# .##.#
##  ..#....#.# ##.##.##..#... #..# #..#  .....   #...####.##.#.##.#.. ##
#=#=# #.###  # .# #..###..#.##..# # .# ## ###.##..#.#.##.#. # ##. ..##.#
#....## ...##.#.####  #  #. #..#  ##.#.#... .###.#.. ... ##...  .# # ..#
# ## .. ### .. #..## #.##  #.#...#..  .### ## #..##.#.## ...#.###.## # #
#. .#.#.#. .## .# . ..o.###.. .# #.###.. .#.... #. .## #.## #..... . .##
# ## # .#.##.# # ###.# #..  ###.# .#.## #.## ## ####.#  .#. # #.###.#..#
#.##. # #..#.# # ....###.### .. . #.. #.#. #..#. .....##..# # ##... ####
#.  .## #.#.. .#.###... .. ###.#.# #.#= ### #  ##.###.#..# #   # #.#...#
##.# # .## ### #... #.##.#....#. #..  .# .#..## ..#.  .#..  # #. .#..###
# .#.##... . #. #.##.#....#.#..# .## # .#..#. ..# .##.#..#.# . # ##.#..#
## ##..#.#.#  # #.#..# #.#.#..#. #.##.# #.## ####.# ..##  #.## #... ..##
##.  #.#..##.##  # .#  #.#  #.###  ...#... .#.   .###..# # ...#.# #.#  #
#.## #..## ..   #.#.###.. .# . ..####.#####..# # #. #.##.#.##...### # ##
#.#. ##..#.#.# #. .... .###.#.## #..#.......#  #..#...#..#.#.##.. ..# .#
# .#..# #.# ## #.##.##.#..#....#. #. #.# ##.##.## #.# .# .#... #.#.##.##
## .### ..   ....# ...#. #.##.#..#..# .#..#..# ..## .#  .#.#.##.# #..  #
#..#.  # ######.#..##.## # .. ####.# ##.##.#..##.#.#..#.## #.. . . ## ##
##.# ####........#..#..# .###  . .   ........#.. #.#.## ....# # ### .. #
#. .. .#..# ##.##..#. #.#.. # ##.# ####.## #.# #.#.# # #####. #... #####
####.## ## #.##.#.#.# # ### ## ##.#.  #. .#  #.#....#. . .. ## ###.....#
#..#....... ..  #.# #. . ....    ...##..##.# ##. #### # ###.#.....###.##
##.#.# #.# ##.#.#  . ##.##.###.#.#.#. #.#..#.  #.... .#...#..##.###.# ##
##...# ##.##.#  # ###..#.##.  . ##.##.# ..#. ##.##.#.#..##..#.. . ..   #
#..#.#....... #.#.# .#.   ..##.#... #..### #.... ## # #. .#. .# #.# ####
#.#.# ####.##.#.. .#..#.#### #..## #  #. .. .####...#.#.#..#.#.##.#..  #
#.#... .\.#.# # #.#..### . . .#  # ##.#.#### # .#.# ...#.##### .. ######
##.#.#### ... .# .##.##  ###.##.#   . ##.  ... #...###. . .#..# #.... .#
#....#...###.##..# ..  ## o#. .. #.#.# #.### #..#.##. #.## #.##.########
#.##.# ##..# .#.#.####...#. ### #.#.... # .#..###... #  #.## # ...o.  .#
#.####.#..## #.#..#.  ## ..##.#. . ##### #.# ##. ###.# ##. ...#.###### #
## #.  ##.# .#. #.###. #.##. ..#.#.. ..# # #.#..## ..#.  ###.##.  ...# #
##.#.##..  ## #. . .#.##.#..##.. #######.# # .#.. .##..##..# #  # ## #.#
#..#.#. # #...#.##.#.. .  # # ### .......   .#. ###  #  .#. ..#.#. # #.#
## # .#  # ##.#. #.####.#.#.# #.#.# #### ##.# #.#...# .#.##.## ###.#. ##
## # ##.#... .. #.. ..# #.#.....# ## . .#.#  ...## #.# .# # #  .##.#.#.#
#....  ...##.# #.##.#... # .#.### ..# #.#..# #.#  ....# #...# #...##.#.#
#.#.#.# # .# #.=. .# #.##. #.#.. .##. #.#.#...#.## # # #### # # # .. ..#
# ## ## #.#### # ##..# . #.  ##.#.. #.#.#.## # ..# # #. #....#..######.#
##  .  #.. #....##..#..#..###.# .## # #.#.....# ##.##.#  ##.# ##.. ..#.#
# ## ### ##..#.#...#..#..#.. .##..#.#.#..##.## .. .. .# #  .  ...#.#.#.#
# .#... . ###.#.##.. #  #. ##=  .#. ...##..#...#.#=##.#..#.#### # .#.#.#
# ##.###.#. ... .# # # #. #.### ##.###.  .#..##. ##.....##   .#=#### #.#
#. ..#....#.#.# #.#.#.#..##  .##  ...o##.###.###  .#.##   ### #. . .#. #
#.###.##.#...#..#   ..#.#..#.#..### #.. #.# ..# ######.## #...### ###.##
#.# .  ..#.#  # ###.#.#. #.#.#.## # # #.  .#.#.. . #...# .#### ..... ..#
#.# # ##.##..##...#..##.#......# .#. #..#.#. .####.#.#. #...  .#.#.##.##
#.## .#.  .#.. ##.#.# ..######.##. ### ### .##...# ..#.#.#.##.#. ##. # #
# .## .# ##.# #  ...# ##... . ... # ..#.#.#. #.##  ##.. .# # . ##.##.# #
#.#.  #  #....#.###.#.#..#.## #.##.##  . .##.#..##.. #.## .##.# . . ...#
##.##..#  .##.#.#..  ..#.##  ## # . .#.##. ..# #.. #..#.## .# #.#.## ###
#.. # #.##.# .#.#.##.###.  .#...##.##.#.#.##. .#.# ###.....#. ##..##.# #
#.#..  ...# .#..#  #... .##. ##  # .. .... # # #.#.. ..##.### ...#  ...#
########################################################################
