#######################################
#.#..#.#...  .#.#. #.## # #...#.#o #.##
#.##.#.#.#.##=#.#.#.. ....#.##. .#. ..#
#....#..#.#.#.#....####.#.#.#.#.##.####
#.#.#..#.......##o#...#.#.#.... ......#
#.#.##..##.## #...#.# #.#. ####.###.#.#
#=##.# #.#.#..#.#. ##.#.#.#..  .#.#.###
#....#.#.. .#..## #....o#.#####.#.#...#
#.##.#..#####.#....##.#.#.....#.# #.#.#
#.#..# #. . ..#.#.###.#.#.##.#....#.#.#
#..#.# .#####.###.##.#.## #.#.#.##.#.##
#.#.##.# ..  .........................#
#......#####.##.#.###.#.#.#.####.#.#.##
###.##.. ...#.#.#.#..# #.#.#...#.#..#.#
#.# #..## #.# ##. .#.#.#.#.#.##..#.#..#
#.#.##.#.#.##...#.#....#.#.#...#.#..#=#
#.#..#.#......##...# #.#.#.#.###.#.##.#
#.####.######.#=# ##.##..#.#.....#... #
#.... . .....  .. .....#.#.###.#.#.#.##
#.#.###.#.#######.###.##.#...#.#.#.#..#
#..#...#.#......#.#. #. .#.#.#.#.#.#.##
# #..##...# ###.#..#.###.#.##.#.##.#..#
#..#.#.# #..#.# #.#.............  .#.##
#.#..#.#.##.#.#.#.#################.#.#
# .#......#.#...#.  ..................#
#.#..#.##.#.#.# #.#####.######.##.### #
## #.##.###.##.##.....#.#....#..#.#.#.#
#......... .... ..####..#.##.#.#..#...#
#.##.#.###.#.#.##.. ..#.#..#.#..#\#.# #
#.#.#.#...#.#...#%#.##..####.###.. ##.#
#...#.# #.#.####. #.#.# . ......#.#...#
#####.###.#.... # .##.# ########..###.#
#...........##.#..#.....#.....o.#...# #
####.##.#.# #.#.#..##.# .######.#.#.#.#
#....=#.#.#.....#.#.#.#.#.......#.#.#.#
######.#.##.##### #...#.#######.# ##..#
#.................####....... ..#...#.#
##.##.# #.#.# #=#.....#.#.#.## #..#.#.#
#######################################
