##########################
#  \#      # #.#     o . #
###.######%#.# ######o####
#       o        .    # .#
## # # # # # ########  # #
# # ## ## #  #        ## #
#          # ###### #    #
# ## # # ##   = . # # #.##
# # #  #.# # ##### #  ##=#
#    # # # # .      # .. #
#o# #  # = # ## ###=# # ##
# #. # # ##    #   .#.#  #
##########################
