##############
##.## #.##.#o#
#=  ...... . #
##.#o#########
##.# % ... . #
#.# =##o# ##=#
#.##..##.#.#.#
#..  # .. .. #
##.#  ##.###.#
## #.# #o  # #
# .#.#.####.##
##=#.  .  . .#
#.\#.# # #.# #
##############
