######################################
# .#.... .=..   .. .     .. .%.#.#.#.#
# #.###.# ## #.#.######## #### . ..  #
#=..... # #.  # # . . ..# .   #.#### #
#.#######  #.#. #.##### ###### .   # #
##.  .  ..#. .#.# #    . ..  .#.# # .#
## # ##.#.##.#  #.# ######.##.# #  #.#
#..#=#.# # # .#.## . .... #.#.#. #.# #
##=# # .    .#.   # # ##.# ..##.#.## #
# o#  ### ## .#.##..##.##.#.# ..# ...#
## # #...  #o#. ..#.  .... .#.#.#### #
#..## ##### .## ##\.####### #.#  ..#.#
## .   . . #   .#.# #    ..#.# #####.#
#. ##.# ##.# ##.  # #.# ###..    o. .#
##..# #  #.#.#..###.. #. .#.#.########
#..#  # #  #  #.....#. #.#  .# .   ..#
##.##.#. # # #.###.#.o#.#.#.# #.####.#
# ..# #.#..# #  . . ## ...  ... # .  #
######################################
