##############################################################################
# #.   # # #   #.  # ..#   # .      .     #.   .      #     #.. # # ..#  #.. #
#  ## ## # #.#.# #.# # ### # ## # ### # #  ## #### # # .###. # #  # # ## # ###
# #      #   #  ## # #   #  ## #.## ## ## #      .   ##  .#.#  ## #.#  # # #.#
# # # ## # ##  # ..#   # # #               # #.#.###  #.# #  #  #.# # ##     #
# ## # # #..##  ##.# # # # # ### ##### ## # #   #  # #  ##  #  ## # # #. # #.#
#    . . # #   #     #  .# # #         #  # ##### ## ##. .# ##    #. . # # # #
## ## ##.# ###   ### # ### #=  #.# # # ## #             ##   #.##.### ## . # #
#  #.# # #.    #     #     # # #  # ##  .   #.# ## # ## # # #      .#    #  .#
## # . # # # #   # #.# # # # # # #  #  ## # # #  # #  # #.  ##### ###.#### ###
#  ..# # #   #.## ## # ### ###.# ## ### # ## # # # #### ###...            .  #
#### # #.# #   # .     ..                   .          o    ### ## ## # # # ##
#       .#  ##   ## ################### ##### # ## #=##.### # ## # # # # # # #
##=##### # # #.#             . ..     .....   # #. ## #   #        ..        #
#     .  . # #  ############ ################ #. #  # # # # ###### ## # # ####
########## # # #      . ...           .    .  #.#  # .### # #      # ## .#   #
#  .        .   # # ##.#.# # # # # # ### # ## # .#  #     #  ##### #.   ## #.#
# ## #.# ## ## #.# #  #.#.## # .# #    #   .#.#=## ## ####. #=  ..   ## # .# #
# #.# # #   #  #.    #.        #  # ## # # #  #    #      # # #### ## #  # # #
#..    .  #  #.##### ######### ## # ##   .. # # ## .# ## ## # .   o     # .  #
# # ### # # #                 .        # # ## # # .# . #.#  # # ### ### ## ###
# # # #   #  # #### ## ## ## ## ## # # # # #  # .# .# #   #..        .       #
# #     # # #  #     #.### #.# # # #...#    #.#.# .#  ####  # #.# ####### ## #
#   ## ## # ##\ # ####  ## # #    .#o# # # #  #  #  #    .#    #        .## ##
# #.# ##  .    #       #. .  # ## ##   # #  # # #. #  ### # # #. ## ## #.    #
# . #   # ## # # ###### ######.# ## ## ### #  # ## ## #      # #  # #  # ## ##
# # # # #. # #.# . .      = . . .       .  .# # .#  #.# # # #   .## ## # #   #
##.## ### # ## # # ### #.## ## #.##### # # # .# # ### ## ## # ##  .  #. ..# ##
#        .      #.#  # # # # ## #.. .# # #  # #. o. .   .   ## # # ## ## ## ##
# # # # #### # #  ## ###   .  ..  # # ... .#  ### ####### #.      #          #
### #.# #    # ##        # # ## ##  # ####  #.           .# ## ##  ### ##.# ##
#  .# #   # # . # # # ##.#.#.     # # .  # ## # # #.# # #.  # # #### # # . . #
# #.   ##  . # ##.## # #  .##### ## ####  .#  ## # # # ## # #  .    .    ### #
# # # #   # #   .        #  .            #..#.      .     #  ## # # ## #.# # #
# #.# # #  # # ########### ########### ###.#  # ## ## # ##  ## #     #     # #
# # #   # #.   # ..      .        .        ### # ###.# ## # #   # ## # ##### #
#     ##   ###  #######.## #### # # ### ## =              #  # #.      . .  =#
# # # #.# #  # #   .    #     #. # ## ###. ####### ## ##.#. ##  # ## # ##.####
#.# # # # ## #  ## ####  # ##   # .      #  .     #  .# #.# #. #. # #  #  .  #
# # # #.#  # # #        # . # # ##.## ##.# ## # # # ##    #  # ##    # #.# # #
# # #.# # #   . # # # #  # ## # .   . .  # # # #.# .. #.##. # ..# # #  # ### #
# # #.# # #### # .    # #  #    ## ### #.#        # # #   #  #.#     # .  ...#
# # # # #       # #### # ## # ## ###.## ## ######## ### ### ##.## ##.# # ###.#
# # # # # #### #  .    .   .              .#        =   .   #  .  #    #   . #
# # # # # .   . # ## ### # ## # # #.## # #.# #.# ##.## # ##  # ## # ## # ## ##
### # #   ## # # ## ## ## ## # # # # ### ## # ## # # ## # #.# ## # #.# # ##  #
# . # # #  # #                ..         .            .. .           # #  . ##
##### # # ## # # ## # #.## # ## ######.### ### ## #.# ### ## ######### # ##  #
#    .# # #..#=#=# # # # ## # # #     #    #   # # # ## # # .  .          # ##
### # # # ###.      . .  .. . #..#### ###### # #  .     # # ########## # #   #
#  #  # #.   # #.# # #.# # #.# .# . .      . . # # # ###..          .# #.## ##
## ## #.# #.#   ## ## # #   #.#  # ## ## ## ## #  # #   #.## ####.# #        #
#     #   # ## #          #   # #   #  ### ##.## #. ## #  # #..  # #.# #### ##
## ## ### #.    .######## # ###  # #  #    . .    #. # .#.#   ### . .#.#     #
#       # # ##.# .              #  ## ########## #  ## ##. ## #  # # # # ## ##
####### # ## #  # # ## # ### ##  # .   ...     #  #  .    # #.## # # # .# #  #
#  .  .      ..## #  #.#.#  #   # ### ## #.# # # #  ## ##   #  # #.# # #.  .##
# ## # # ### #.#  . ## #.## # #    .# # # # #.##  # # ##  #   # .# #    # # ##
#    # # #  ## ## #    #      #.## #         .   ##     #.  #  #.#.#.# # ##  #
##.### # .# #  .  # ###  ## ###  #  # ## # # # # .  # #   # # #  #  .#      ##
#        #   # ## #    #.# .#   # .## .   # . ## ## ## ## #. .## # ##  ####  #
###### #  # ## ## # ## #  # # # .# # .# #  # #    .       # #    # # #.#    ##
#    ..  #   . .  # # ## ##.### ##  # ## .##   # # ## ### ..# #### # # # ## ##
# ## ###.# ### ##..    . #.     #  ##.  # #  ##. # # ## # #          #  # #  #
# #    # #%# # # ## ####..# # # ##.#  ##   #   # # #     . ## ## # ### #   .##
#  # #     # # #       #.# .# #  # ##. .# #  # #     ## # # =#.# # #    # #. #
# #    # # #.#.# ## ###   # #   #   # # #  #   # # #       #.#   # # #.# ## ##
## #####  ##.# ## #.#. # #  # #.## ##.#.# # # ## ## ### #.## ## ## ##  #     #
#  .   . #      #.#.## #  #  =  .#.#            ..      =            #  # # ##
##### ##   # # #  #    # # .### #   # # ##### ## ### ###########.##### #.## .#
#      #.# ..#  # # #.#   #   #  #.# .     .  #    # #    .       .    #    ##
####### #.## # ##.##.#.# ## ## ## # # # ###### # ### ### #### ########  #.#.##
#    .      .. .    .  .                   .  .      ..      ..        ## #  #
# # ## # ####### # ######## ### ## # ##### # ## ### # # ## ### #######  .   ##
#   # .# #     # .   .    # # . # #          . #  #.# # # #          # ####  #
# # .#.# # ### # ## # ## #    #  . # ## ## #.### # # # ## ########## #    . ##
#.# #  # . .  .  #.   .   # # #.# # .# ..# ..         .              # ## #  #
##############################################################################
