###############################################################################################################################
#   . #.#   ##  #      # . #  ##   # .     #.# # #    # # .#.#.    .     . . #.## #   . .# .#.. # #.  # # ## #   # #.   .   # #
### ##   ##  .#.# ###### # #.#   ##  ###.###.# #  #.# #  # #  ### ### # # ## #      ## # # #  #   # #   . .  # #.#.## ## ## # #
# # #.# #   ### # #      #.# #.# # # # # #.  # # ## # # ## # #  # # # # # #. .### # #  .##  #  ##.# # ###### ..\ .   # #  # # #
#       # # #   # ##.# # # #  .# # #.# #  ##   #.   .      # ## # # ## #   #.#  # # .# #  .#  #. .### #    ..# ###.# ..  #  # #
# ### #   #  ##.#  ### # # # ## .#   # # #   #  #.## # ### #. .   ..  . # #  .#   . ##.# #  # #.#      # #.# #.#    ## #  # # #
#  .. #.#   #   # #   ..     # # # # # #   # # # # ##.## # # ## # ### ###  # ## ###.  .  # #  # # ### # .# . #   # #   # #. # #
####### ###.### # ######## #.#.         .#.#.#      .  .    .## #.  # .   #  # .  ..#####   #       # ## ### # ### ### # ## #.#
#     .   .    . .   .       ### # #.###.#.# ## ##### # ####    ..## # ##. # # # ##      # #  ###.## .           .  .       . #
## #.## ###.##.## ###.# ## #     . .   .     ...         .   ## # #  .    # .# #. #.# ##   .# .     # # # ###.### # ######### #
# #   # #.# # # # #   #  # # ## # # ## #.# ## ## ## # ## ##.# .   ## ## #  #.# # #  #    # #  #.# #    .#  .      .  .  . .  .#
# # ## ## # # #.##.### ## ## #.# # # ##.# ## ## # ### # ## # ### # ##.## ###   # ## ###.##.## # #  .# #.# ###.### # # ##### # #
#...      ..       .. .        .. .         ...          .  .  .       .     #    . ..     .  # #.#.  #.#   #   # #    .     .#
# ## #.####### ## #.# # #.# # # # ##.### ##### #.######## ####### ##########   ###### # # # # #.  ### . # # # ##    #.# # # ###
##.  # #    .#. ## #.# # # ##  #.#  #. #          .    .          .  ..    # #   .  #  # # #  # #   #.## # ## # # #.    . # . #
#  # #. # ##   # ..           #  . ## #. ## ### ##### ##.# #.### ###.### ###.# ## #.# #     #  ## # # #.          #.### ### #.#
##.# # #  .# # #.## # # ###.#  # #     #.# . . #  . #     # ##.#   ### #   ..   . ###  #.# ## #   ###   ## ##.# # #      . .# #
## # #  # ## ..#  # # # #  . .##  # #.##.## ##. # ##..# # # #   .#. .  ## ## ## #     # ## #  # #     #   . # # # # # ##### # #
#  # #.#.    # . #. # # # # # #. # .#.#     .# #. # # # #.# ## #. # ##   . #  #.# ###  .    #.#.. ### ## #.# # ##.# #.#   # # #
##.#..  # #### #. #  .#     # .# # #   #.## #. .#.# ..#   . .   .#   # # ##  #. # #   #.### # . # . .. .. . .. .  ## ## ##  #.#
## # # #  #.   # ## ### # # #.##.#  #.#   # ##.## # # # ## ## ##  # # .#   # ## # #### ##.#.. ###.### ###.# ##### .       # # #
#  # #  #  # # #    #   # # #.     #   # #    .   . # #   .# #.# #   # # #        . .       # #.  .. .#      . .  ##.## # # # #
## # # #. # #    ## ### # # # ##.# ## #   # # # # #   # ##        # #  . . #.# # ### # # # #  #######. .#.###.###.# ## # .#.# #
## # # .#    #.# .#..     . .  .    # ## # . ## # #.# # #. # #.# # .## ####    #  .## # ## ## .   . # # #.# #     #     #.# #.#
#   .# ##.###  ###.### # #=# # #.# #   #. # # .     # #  #.# # #  #.   #   # #  .#  . .      .##.#.## # # # #.### # ##### # # #
####.#.    ..#.  .         .     .  # #  #    ##### #   #..# # # # ###.# # #  ##  ## # ######  # #  . #.# # #    .  .     .  .#
#.     ####### ## ## # ##### #.### ##  # .# # .   . # # ## ## #  #     #.#   # # # # #.  . .#.# .# ## #   #   # # ### # ##.# ##
#### #   .     #.  #  #  .  # ##  .#. #  ## ### # #...# .     .#  # ##.# # #.#   # # # #### # ## ## # ### # #.# #.# # # #=# # #
#  .  .##.# ## # #   #  # #      # .# .#  ..    ....#   ##### ##.# # # ### # # # #     .    #     ..# =   # #.  #     # #...# #
# # ##  .## #..#  .# .# #   # # # .## #  ##.##.# # #  #. . ...             # ## # ##########  ## ##   #####.. # # ### # # ##..#
## # # ###   # # ### ##   # #.#..#   . # #.  # # #  #  # # ##### ## ###### #     .         .# #  ...# #   ..#   #.#   #     # #
# . .     # #  #  .  . .#.# # # ## ##.# . # #     .#  #  #.        .      .# ######## ####### ### ###.# ###.####.#.##.####### #
#### # ###   # # ### ## # #.# #    #   # ## # ###.# ## # # ### # # # # ## #   . ..     ..      . .       .   .  . . .         #
# ...#    #.#  # # # .. #    ##.## ## #                 .# #    # #. #   # # # ## # ## ## # ## ## # # ## ### # ## ## ## #.## ##
### #  #### ## #   #.## #.# # . . .    ## # #####.###### #  # # # .#  ## # .  #.#.# #.  #  # # #  # # .#.# #  # .# #  # # # # #
# # .#.    .   # ##   # # #  ### #.## #.# .#     #       # #..# # ## #.# #.# #    # . # # #.    #   # ##.# # #  # o# #  #.  ..#
# # ## #######.  # # ## # # # ..   .  # # #  ### # # #.# # .# # # #  .. .  # ## ### # . # # ## # =#      . #  # .#.  .#   # # #
#      #     # # #      #   # ## # ##   #. #. .  # .# #. #.#  # #.## ## ## # ...     .# # #  # ## # ## ## ## #..## #.## ##.# ##
## # #  # ##   # # # ## # # ## #  ... ### ##.#.# . ##  #.#. #.# .  #  # #  # ####### #..#.# #     # # # # #  ## #  #.#       .#
# #. # ##..# # #   #.#  .        # ## #.  #    # # .  #  # #  # ## # #  ## #       .# # # #. # ## # #   .  #  #  #  . #.# #.###
#  # # # .#  # .# ## ## # # # #### ##  ##  # #   #.##  #.#  # # # #..## .  # # #.# #  . # # #     #  #### ## #  # .# ##.# #   #
# # ##  # .# # #   . . . .   .  .     #   ##  .# #  # ## # #.      #  #.## # ## # # # #.#..# #### # #   # #  ##. # #    # #.###
#    . ## # #  # # # ## ## ## ## # ## ## ##. ## ## # .   #.  ## ##   #..#           # # # #  .  ..#  # # .##   .#  #.##   #  .#
#.# ## #  .  # # ### # # ## # # #.# #      # #. .  #.### #.# ## #  #  .# #.# #### # . # # # ##.##.#.##  #  # ## ## #.# =#.# ###
# ##=#  # # #  #  .    .        ..    ## # # # ###.# # # # #     # # #  ..      # .## # ##.# # #  # # .# .#           # # # ..#
#      #  ## # # #################### #  # # #.. # ### #.# .### #    # ## ## # ## # ..#  .      #.#  #  #. #.# # ##### #.##.###
##.###  #      .            .  . . .  ## # # # # #. .  # #.#.    ###   # #     # # ## # #########.  #. #. ##        .      .. #
#   .  # .## # #### # # #.# #.# #.# ## = #   ## #  ### # #  # # #... # #  .# #      ..     .      # ##. #.   # #### # ## ## # #
# #### ## # #         .  # #  .# # # #.# #.#.    #..   #.#.#  # # ##.. # ##  # ### # #.# # ##.#.# .. # #  ## #    .. ## ## ##.#
# .     ..   # # ### # ### #.#=#    .  #.# # # #   #.# # #  # . .  # #     #  .   # # #   # # . # # #   #  . # ## # #         #
## # # ##.### .#    .          ##.## # #  .#   ###.# # # #.# .# ## # .## ### ###.# .#  #.## ## #  # .# #  ## #  #.  .## ### #.#
#.## # .  # ## #.## # ##.# ###   ## ##.  # # #.  #       #. # # .  #.#         # ## # # .#.  # .# #.## ##.# .# #  # # #    .###
#   .  ##.# ..  #    #.## .  # # ..  . ##.#  ##### #.###   ## # ##.    ##### #     .# .#  # ##.#  # #    = #.# ## # #   # # . #
# ##.# # .. ## ## # #   # ## # #######  .  #        .. #.#   .#.## # #       # # ## # #  ## # ..# # ##### ## #  # # # ## #.####
# .#   ## # . .# .# ## #     # .  .  #.# #.# # #### ## #.# ## #   .#  # # ## # #.#..#  # #.  # ## #    . .#. # #  #    .      #
##.# #..#  # #  #.# .#.# #.# # # # # #    .# # # .. .    #.##   ###  #  #.#  # #  # # # .## ## #  # ######.#    #.# ##.##.#.# #
## # # #  # #. ##.# ##  # ## # ##.# ## ##### #  ## ## ##.#   ##.# ##  # #  # #.# ##   .# .#     # #       .  ## #.# # # ## # ##
# .#.#. # =  # # .# #  # ..  # .=      #     # #.## ###  # #   .     #  # #  #.#.#  # #. #. #.# # ..## #.# # # #  # .         #
## # # #  ###  ## #  # #####.# # #####.# # #  ..   .   # .# #### #### # ## # .# # # # ## ##.##.## #.# ## # #    # # # ## # # ##
#  # #  # .  # .# #.#  .   # #.#  .    # #.#.###.####### #. .    .    . .    #           .  ..      #   .  # # #  # #   .# #  #
##.### #  #.## ##.# ## ##### #. # # ## # # # . #.. .     ## # ## # # #######  # # ### # ## # # # ## ### # ## .# # #.# ##.##  ##
#       #.# #  #    .   ..  .  ## .  # #    .# # ## ## #  # #  .# ## #    .  # .# #   #.   .# #  #  . .  .   # .  # # #    # ##
###### #  #  #   # #.######### # ##### # ### ## .# #%# # ##.# ### # .  # ### # #  ###  ####. ..#..# ## ## ## .# # # #  # ###  #
#       # #.#. # .#     .    #.        #.. #.  # #  .  # #  #    . # #     #.# ## .   #     ##   #      #.#. # .# # # #  #.  ##
#.## # # ## ## ##..## ### ## # ## # ##   # # ##   # ##.   # # # ## # . # ##    .# # #  ## # #  #  # ### ..##  # # # # ## # # ##
# #           . # # .      . #.#..#  # # ###   #.#.# # # # .  #  # . ### #.# ## # #.# # .   .# #.# .#. .#  # ## # # #  # #.#  #
#.# ## ### ### ## ### ### #.##  # #.## #..   ##  .     #   ## # #  #.#.  #   #    #.  ## ## #  #  #.# #.# #  #  # # # ##     ##
# .    #       #.       .      #. #.. .#.# # # # # # ##  # # # #.##   ## ###..#### # # ## #.#### # # # # # #  #.# #   #  # # ##
## ###.## ## #  ##### # ### ##  # # ## # #.# # #.#  ##.# .  .      #.# .   # #  ..    .    .    .     .      #    # # .#.# #  #
#   ..  #..#.#.#   .  #  .#    # .#  # # . .      #    # ## ##.# #   # # # #  ### # #.#.# # # # # ###.# # ## .#.#   # ## #   ##
## #.#.## ## ## ###### ##.## # ### ### #####.###### ## # # # ### ## # # # ## # ..    . ## # #  # #   # #   #.#    #   #    # ##
#    .        .  .       . .    .               .   ..  ..     .            .  ##.# # #.  .   #. #.#  .# # #.#### #### ## # # #
############# # ####.## #.####.# ##### ## ## ## ## ## # #.### ### # # ## # # #.  .# #. ## ### .# ###.###.### .   .   .       .#
# .    .  ..  .   .    #.    #  ..     #.    ..  #   #.# #  #.  # #  #  # #   # #   #.#   #.# #    .    . .  # # # # ###.#=## #
#.# ##.## #### #####.### #.##.##.# # #  # #######  # #   .#.# ##.  # # #.  # # ## ###  ## # #  # ### #######   #   ##  # ## ###
# ## # #.#  . ..   #      ..       # # ##..      # #   # #  #.# # #    .#.#. #    ..  #.  # # #  #.#   ..    #   #   # .      #
#      #.# #### ##.  #.##.#.######  ## #. ########.### #  # # #   .# # #   # # ## # # # # . # .#.  # #######  .# # #.# # # ## #
# ## # # #  ..#.#  # #   # #  .  # #  . #    . .   . #.#.#  #   # ## #  # #  ## #  ## # #.#. .##.## .  . . # # #... .  # #  . #
#   .# # # ## # .# # # #   # ### # ### ## ######## ###.# ## # # .   .  ##  #     .#. .# # # #.#    # ## #.## #   ## # #. # ####
# # ## # #  # #.## # . # #   ..  #. .# #..  .          .     .. # # ##.#  #..# ## ### # #   #  #.#        .  # # ## #  # # # .#
# .    #   #  # #  # #     # # # # # .  # ## ## ## #.# # ## ###. #      #  #.  .#     #.# ##  # # ## # ## ##  ##  . # ## # # ##
# ###.## #.# ## ## # ### # ###.# # ###.#   #  # # . #.# #.   .  #.# ## ##.## # # .# # # #   # #   .  .# #  # #   ## #.# .#    #
#        .              . .          .  # # .#.. #.#      ## ##.  # #. #   .. # # ##  #.# # #.# ## # # .  ## # # .# #. # #.## #
## # ###.# #.# #.# #.### ## ##### #### ##  #  # #  #.## # # # # # # ##  #### #      # # # # #.# #.#  ## # .  # # #    ## ## ###
# # #..   #.#. ## .    # #. #  . #  . .#  #  # . # ## ##        # #  # #    .## # #.#.  #     #.#  #   .# ## # #.# ##         #
# # #.##.## ##  # ## #   # #  # #  ###  # .# ## #  .    # # # # # # #  # ###  # # # # # # # #   # ## ###  #  # #    # ## ## #.#
# #.# .  # . #.# . #. .# .  # #  # #.  ##.#.. # .### #### ## # .#   ##  .. # #  # # #.  ..  #.# # #  # ##.##.  # # ##   #   #.#
#.# # ## ##.#  ## ## # # #### #### # #  . #.###.#   ...     . # # ## # ####. ##.  . # # # ##  # # ##.  o   # # #.#.#  # # #   #
#   . .   # ##  # # .#.# #    .   .   ### #.  . #.# #### #####  ..      .  #    #.# # #.# # #.#   .# ### ##  #.#   .# # # # # #
#.# ### ##   # #   #.# #   ##.### ###  .#  ## # # # #      . .# ## ### # # # ## . #.  # #.  # #.## # # # # #.#.# ##   # # # #.#
# #   #   # #  ## #    # #    .  #    ##. # #.#.# #  #.# ##.#  .# ## ## ## # # ## # #.# # #   # #  # # #   .   # # ##.#o   .# #
#.  ##  ##.  #  .  # ### # ## ##. # # #.# #     # # #  #. # # #            # #.   #.#.# #.# # # # ## # # # # #   #  #  .# #.# #
# # # #   #.#  # # # # ..   .  # #. #      ####.# # ## # # ## # # ##.## # #   # #   # # #.# . # #   .# # #.#  ## # #  # #.#.###
# # # ####. ##.#.#. .#.#.##.#.##. # # #.#.# .     # .  # #.   # #.# ## #. ## #. #.#.# #   ###   ## #.# # # #.# . #  # .## #   #
#       . #. #     # # #.# #  #. #  # ##    # #.# # ## # ## #   # .     #  #  #  .# #.# #. .#.# .  # #.   .# # #.# #. #.  # ###
# #########.## ##### # # # ## .#  #   . # ## ## #.# .# ## ### # # # # # # #. # .# #     # # # # # ##.#.# # #.  #    # ### #. .#
#            .  ..   # #.   . ##.##.# # # # .   # #.#.     ..    .#   # #  # .# #.  #.#  ..#  #....  .     # # # ## #   # #.# #
###.# ### # ###.# ## # # ## #.#     # ## ..## # # # #.## ##.# # #. # #  # ## ## ## # # ### ## ###.##.##.####.## ## # # # # ## #
#        # #. .  # # # # #  # .# ## # . # ## # .#.#. ## # # . #.# ## ##.# #    .        .  .  .     .   ..    .       .       #
# #### #.# #.## #    #.#  #   ## #  # ##  #   # # #.#       # #.  ..  # #  #.##### ## ## # ## #.# ## # # #.## # ##.# # # ## ###
#    #   # .    # ## # # # ## #  .# # # #.## ##.# ## #### ## # ### # # # #   .. . . # #.#.#  #.# #.#  # # # ## # #.# #..    # #
# ###  # # # ##. # #.# #  . #  #.##.# # #     ..      .  .   .     . . .   #.#.### ##.#.    #   .   .#..           #   ##.#   #
# #. #.# # ##.# #    # # # #. #     # # # #### ## # # # ## # # ##.## # ####  #     #. ##.## # # #.##   # ## ## # # # #   .  # #
#. # #        #  # # ...  # #. # # #.   # #      # ## # #.# # ## #.# # #   # # ###. #   # #  .# #  . # #.#.#.##  # #.. # ##   #
# #    ## ##.#  ## # # # #    ## ## # ##   #.## #   .    .      .  #  .  # # # .   # .#.. #.#.  ..## #. .# . . # #.# ## ## # ##
# ####  .#. # #    # #   #.##    .      # #  # .##### # # # ### # #. # # # # #.#.#  # # #    ###.#.#.# ### ### # #.# .  =   . #
#  .   #  # # # ## # # # # ## ###### ##.#  #  #    .# # # # .   # # ## #...# # ### ## ### # #.      .    .  ...# # # #### ## ##
# # ##.# #. # # # #  #        .        ## # ### #####      # ## # #   . ## #     .   .  . #  ## # ## ### #####  .  # #   #    #
# # # .# ## # #    #  # # ### ## ##.##.#.   .  ..     # # #        # #.# # # # # # ## ## #  #.#.## #.# ##    # # ##  ## # ### #
# #  #.# . . . .## #.#  #.# # #.. # #  ## ## # # ###### ##.### ######.## # # ##.#.##.# ##.#      . #.   #.#.#      # ..   .   #
# # #  # #.#.## ## #.##.#   #  #.# .##  . # .  #..  .      .       #              .   .    .### ##.# ## #.## # # #.  #### #.# #
# #  # #.## # #    #  # #.#   ##  #. # ## # ### # ### ## # #.# ##.## ## # ## # ### ##.#.### #     .. # ##   .  # # #.#       ##
#.  #. .        #.#  # # # ## # ## # #.##.# . .  =.  .#.#  # #..#.# . .    # # #      #   #  # # # #      # ## # # # # ## ##  #
# #  # # ##.### ## #      .          .    # ##.#.## # # ### .# #   #.###### # #.# ### #### .#. # # # #### #..  # # #    #  # ##
#   #  # . .  .. .   # ## #.## # ## ## ##.# # ## # # .# . .# #  # #  .       .         .  # ## #. .#  .  .# ## # # # ##.# #  .#
## # # ## # # # ## # # # # # ## ## # # # .#..       #.#.#### ### . # ## # #### #.## ## ###.  # # ## .#### ##.#   # # #  ...# ##
#      .# . # #.# .# # . ... .    .     # # #.####### #      .  # ## # #.#    . # # # .#  # #  #.# #   . .   . #.     ### #   #
# ## #.## # # #. # # ## ##.# # # # ## ##  # .           # ## # ## #. #    # #.# #.##.# # ##  # #.   .######### # ### #..# ## ##
# #  # #  # # #.#  #     # # ##.#.## ## # # ##.###.## #.# .# ###. .#  ## #    ..        .   #    # #               # ##   .# ##
# ####.##     #  # # # #.#.             # ## ###  #  #  # #  . .# ## # # # ## # ##.### ## # .# #     ##### ## # ###     # #.  #
#. .    #.# #.  #  #  # #  ##### ###### #     . #  #  # # .#.####  . #   .  ..  #    #  # # # .# ### #    # ##  # ## ##    # ##
# ## # #.   ### ##   #   #   .  #     .   ##.####.##.#  # ## # .. ## #.## #.# #  # #   ## #  # # # # # # ##   # .  #.   # #.  #
#  # # # ##        #  #.#  # ###  # ## ## #     .     #.       ##  #. # ## # ## #  #.# #  # ## #     #   #  ##. ##  .## # .#.##
### ##.## ##### ## # #.  # #.#  # # #   # .######### ## ##.## # # # .#    . .  . #   #  # # # .# # #.. # ## #.# #  #  # # # . #
#  ..   .        # #.## # #.## ## # ## #  #  .  .           . ..  ##  ######### #.## #.## #  # # # #.#  .  . .  ##.# ## # ## ##
# # # # # #.# # #. #.. o ..      .  .  .#  ## ## ## ##.# ## # # #    #    .   .    .  .#  # #      # # # # ## #.   #    #.   .#
###############################################################################################################################
