###########################
#.#.   #.#.  .   ..# #  . #
#   ## =  ####.###   # ##.#
#.# %. # #..   ..o # #. = #
#.# #.#. .#### ### ### ## #
# .  #=# #   .  . .. . # ##
# #.#  ...#### #######  ..#
# #.# ##.# . .    ..  .## #
# #.##.#. ############ ##.#
#     . .# o.. .  .  .  ..#
### ####.# ## #.## #.#.##.#
#  .  . .## ##.#.##.## ## #
#.#.#.##.    . .... . .  .#
#. .  . .##### # ##.##.#.##
# # ## #  o  .# #.#  # #.##
# #.#.#..### ## #.# #..# .#
### # ##.# .     .. ## # ##
# . #. ..####### ##      .#
# #.# ## .  .. # ##=### # #
#.#\ . #.## ## # o ....#..#
# #.###  # #.# # ## ##.# ##
###.# ##.. .. .#   .#  #. #
#.. . .# #.# ##  ##.#### ##
# ###.## ## #.# #   ...   #
#  ..  ....   .  .#.## # ##
## # # #.##.#.#.# #  . .. #
###########################
