##############
##.# . .#..#.#
#...# #..#o#=#
## #    #..#.#
##.##.#.##. .#
#.. \ .o.. #.#
## #.### #.#.#
#  ..  ..# #.#
# #.#### ##=.#
#o..... . .# #
# #.# ## #.==#
#.#.#o# ...#%#
# .....#.#.#.#
##############
