############################################################################################################
#. #.#   # .#  . # #  # #..#    # .#   # # .    .  .    ..   # #.  .# .=.. .#  # #.   ..  # . . .. #.#.#.# #
##.# .# ##.#..# # ..#.#..# #.## #.#.# # .# ## #.# #.# # #.### ..## ## ####### ## ########..## ####      .  #
#..# #. #.  # ## #.# .# #..##.#.#.# #.## #.# # # # #.# #.## ##.#   ...   . .  .. . . .. . # ..# . .# #.#.#.#
## #  #..#.#... ....#.# .#  .. . . . ....... .... . . . .. ..  #.# # ## ### ### ##.# # ##. ## .### ##.#.#.##
#. # # .#  .# ##.# #. #.## ###################################  #.#.##.## ### ### # #.# #.#...##.  ..   . .#
## #.##. # #  .# #  # #  .  . . .       .   .  ....      . .. .#.. ..        .. .. ..     . # # #.#.##.#####
# .#. # #...### ##.#. .### #.#.## ####.# #.## ####.######## ##  # ### ##.### ##.# ## #.## #.#.#  # #.  .  .#
##.#.#   # #... ... #.#   . # #..#  . #.#.#. #  ..#.      .  #.# #. ## # # .#..#  # #.# # # #.# ## ### ###.#
#..# ##.# ..# ## # #. .######.# ## ####.#.# #.=### #####.#####.#  # . .#. #  #. #.# # ..# #.#.#  ..  # ... #
##.#. #.## # ## ## ## #..   .       . .   . ## #. .  ...  . .. #.## # #  #. ## ##.#   ## .### # #####..#####
## #.##... .   . .. # .#####.##.## ##.##.##  # # ### #########.#.#. #..# .# #.. .  ##.#.#. ....... ..#.  ..#
#...= . ### ## ##### .#..  . #  # # ##.#.# .#. #.# #.#... .    #  #.#.#. # .#.###.# #.#. .## ##.# ###..###.#
#######.#  # #     .#. ###.#. # # ...#  #.# ##.###.## ######## # #..# .# ##  #..#.#.   ## # #. # #.. #.# #.#
#. . . ..# #. .#.#.#  #....#.#. # # #. # ..... . .  ..  ..   # #. # #.##. #.##.# .# # #.#.#.# #  #.###.#.# #
####.##.##. ## # ##.#. ###.#  # #.#.## # ### #.#### ### ##.### # ##.###. #  ....#  ## #.# .... # #.#. .#.# #
# ...#. #  #.  #. . #.#....#.# .#.#  # # #  #.# . #...# # .#.  . ..   .# ##.#### .#.. # #.######.#.### #.# #
##### # .# ####.##### #####.#.#.#.#### # # ## ###.####.# ## ## ####### #  # #.. # #.# #...# ... .#. .#.#   #
# . ....# . ..     . ..  .   ...    . . . .  ..   .. .     . # # % .  .#.#   #.##. ##.###..# ###.# ###..####
## #.##. ##.# #.# # # ##### ###.##.# ##.##.## ## # # ####### #..#######=#.# #  . .#... .. #. #   # #...#. .#
# # .# .#  #..##.#.# .. ..#.# #.# # #. # .# ## #.## #  .    # .#  .. ..  .  .# ## # #.#.#  ## ## # .## ### #
#.### #..#..# .. .  #.##.#  . # #.#.  # .#.  .....#.#.##.## .# # # # #.#### # # # .# # #. #.   ..# # .   \.#
#.      ## # .## #.#..# #.#.#.#.# .## .# .## ###.#..#. # #.#.# .# #.# #..   .  ...#...  #..##.## # # #.#.###
##.#.## #..## #.# #.# #. .. ##..# # # ## #. .. #  # #.#.## ##  #.   .  ## ###.###  ### ## # #  # # #.#.#.. #
# #.# #. #  #= .    #..####   # #   .... ###=# # #....  ..  .# .# # #.#.... .# .# #.....  #.# #..# .##.#####
#  ..   #..# .# # ## .# .. .##   #####.#...#.#.#  # #########  # # ## ###### ## # .##.###.# #  #.# # .  .. #
## ## #..# .# ## # ##..######.# #.. ..# .### # # ## .. .  .. #.#.   ....  .     . ###.#.# # ..#  #.# #.#####
# #.#.#.## ##....  .#.#. .....   #.## .# # ..#.#.#  #=##.# # #.#.#### ######.#.##  #..# #  ##..#.#.#.#.....#
# #.###.#.  . ## # #o .## # ### # # # ## .## # #. #..# #.# #.# # # .# #    . ##.#.#.# #...#  .#.  .# #.###.#
#. . ...## ##  # ##.# ###.# #. .# . .    ### # #.# .#. # #.# # #.## #  ## ##  . #.#   # #.####.# #.##  # # #
#######  # .#.##..#.#. #.# # ### ####### ## # ##. #  # # #.##  #..#.#.#.##.#.# #. ####.#     ..      #.# #.#
#.. . ..# .# .#. #    #.... ... ..... ..      . .##.#  ..#.. # # ## # #.  . .# .#.  ..  #.###.##### #. #.#.#
## #.##..#. # ## # ##.#.## # ##.## #.## #.#.## #.#  # ##.# ##  # #. #.## #.# # #..#.# # # #...#.  .#.#.#.  #
#.# # # #.##.# ##.# #.### #.##.# ## #.## # #.## # #.###.# # ##.## #.## ## # # #.##.# # ## #### ###.# #.# # #
#..   .  ..  ....   ...... . .  ... ..     .   .   ....... ... .  . . .  .. .       .. ...   ..... ....##.##
#.##.# #.#.# ##.# #.####.#.#.#.#.## # ### ##.#.# # #.## # # # # ## # # # #.##.## #####################  . .#
##o#  # #.##..# ## #  ..#.#.  # # .# #.. #  # #.# #.## #.#.#.#  # #.#.#.# #. # . #   ... ...    ..   .##.#.#
#. # #. .. . # .   #.##.#  #.#  #.#  ## # .#.   .. . ...  .   #.#.# # #.#..#. ##..#.#### ## ##.#.##.# # #.##
## ##.#######.# ##.#.=###.# #.#. . #  # .#.# ##.## ##.##.#.##.#.#.# # #.# #. #.  ## #  .#.#.# # #.#  . .# .#
#. . .  . ..    .# #.#  ..   .  ## # # .#..## .# # #  #  #. # # #.# # # # ##.###.#.  ##  .#.#.#.#.#.#####.##
#.# ####.# #### #  # .#.####.##..# # ##. #..# #. #  #.##.#.## # # #.# # #. . . #  # # #.# # ..#.#.#.# ... .#
# .# . # #  . #  #.#.#.#... #. .# .# .#.## ## ##.###.#.## ##..#.# # # # .###.##..## # ....# ##  #.#  ####.##
#.#  ##. # # #  #  # # ####.### .### #.   .      ....   .  .# # # ..#.#.#.. . .#.# . ##.# # #.# # # #. .  ##
#..#   # # ##.#..#.# # ..= .    #.  .##.##.################.# # # #.#.#.#.##.#.#. #.#  .#.# #.  #.# # # #..#
#.#. # #   . .#.#  #. #.#######  # #  #  #    .   . .     #.# # # #.#.# #  # # # # ..##.# #.#.# #   ##.#  ##
## # ##.#######.##.#.#.#....  #.# #  #.### ###############.##.# # # # # #.#. #.#  # # # #.#.##  .##..#..#. #
#=. .  ...    ...# #.#.## # ##. #. # .   ..       .  .... .   #.#.#.# # #. #.#.#.# .#...# #.. #.## .#. #. ##
### #.#.## #.## # # .#  #.#.# # # #. ##.# #### ###.# ###.#### #.#.# #.# #### ###..#. ##.# ####  ..# ##.##  #
# #..# #  #.# #... # #.#. # . # #  #.# #   ..#.#.  .#..# #  . #.#.# #.#..   .   .#. #.# # . ..# ## . ...#.##
# ####.##.  . #.## #.# ## #### .# ## #. #.##.#..# ###.##.## #.# #.#.#. ####.#.## .#...#.#.#.# #.#.# ####  ##
#. . .  . # #.# #.#..# .  ... #.#  . #.#.## ##.#    . #.  ..  # #.# # #.. #.# .# # .# # #.#.#.#.# ..  . #  #
##.####.#.##  #. ..# #.########.# ##.# .   .. .#.## # .#.## ## . .#.#..# #.#.### ## ## .#.# #.#  ##.##.## ##
#..# . #  . #.#.#.#  #  .  ...  .# # # # # ### .#   # # ..#...#.###.# #  .. . .  .# ..# #.# # #.# #.# .#. ##
##.# #. # ##..# #.## .## # ##.# ## # .# # #. #.# ####  #.# .##  #. .#..###.##### #. ### # # #.# . #. # .#  #
##.# # #.  .#.#.#  # # ##.#.### ...# # .# .#.#.# ..   ##. #.# #..## # #. .. . .# ## #...#.#.# # ##. #.##  ##
#  #.#.##.##..#.#.#. #    ...   ###...# # ##.#.#.# ## # .#. # #.#.# # #########  .#..##.#. # .# #.#. .  #.##
##.# #..#...#.#  # #..## #.####.  .#.#.   .. #..##. #. # ##.# . . #.#... .. .  #.#=.#.# #.# #.#.#   ##.# ..#
#  # # #  # # # #....## ## # =#.#.#.  #.#.## # #   ##.##..# ### # #.# ##### ###...#.#.# #.#.  #. ##.#.#.#.##
##..##.##.# # #..###.#. #..# #  # .#.# # # #.# # #.#. #. #.  .# # #.#.  ..#   .#.#  #.. # .##.# # ..... # ##
#  #. . ...##.#.#. #. #. #.#  # #.#..# .     . # #. # ## .# ## .# #.# ###.# ##.# .#..## #.#.#.# .## ### # .#
## ##.###.#.  # #.#  #..#  # ##.#.##.## ###### # #.##. # # .  # .##.# #.##.## ##.##.# ### # ###.#. .#.#.# ##
#...# # . #.#.# #  #  #. #.# #..#..# .#    ..# #.#.# .# .#####. # .   . ..     . # .# .. . ... . ## #.# #. #
## #  ### .## # # ## ## #..#.## #.# .#. #.#.## #.#..#..#.  ...#..## ###.### ####  #. ##########.#. .# # #.##
#   #...# #...#  ...  .. # #  #.# .# #.#.# ## # #.###.#.#######.# # #  #  # #..#.#. #.....o. ... ## # # #.##
##.#  # # .## # ## # #.##  #.# .# #.. #.   . .   .     .... ..    #.# #. #.  # #  #  ###.### ## #.#.#   #..#
# #.##.##.#.#.# ..##.#.#.#.#. # #  #.#  ##########.#####.# # ##.##. #.## ## #. #.#..#.. .#. # # #.# .##.#.##
#.   .. .=. #.#.## ..#.#.# # # .#.#   #.#. ....... #  . .#. ..# . # #.  . .  #.#..# # ## .# #.# #.# # ## .##
###.##.##.# #.# # .# #.# #. . #  #.#.#  .######### .#####.####.###.#.######.## . ##. #.# #  # # #.#  . .#..#
#.##.## ### ### ## #.# # #.#### # ....# # .   . .  # . . ..     . .. . .. . ..## #  ## # ##.#.#.# # ####  ##
#.  ... ..  ..   #.# #.#.# # .. #.## #  # ######## .#.##.#.#.#.##.###### ## #..#.## . .#  .  .# #.#o.  .#..#
############### #  #  ## ##.###.#  #  #.# #  . ....# ..#.##.#.#. #. .. .# ..# #  .# ### ####### # # ####  ##
#  . .. ..    #. #.#.# . .=     # # .# ..# ######## #.#. . ....#.#.####. ####. #.#   .  ...    .  #..   #..#
#### ########## #. #.# ## #.###..#.#  # #  ...   ..  . #.#.### # #.. .# #. .. #   #.# #.# ## #.#.#  # ##=.##
#... .   .  ..  .#.#.#..# #.#   #... #  .#.# # ######.# #.## ###.######.# # # .###.# #.# ##.# # # # ###.#..#
## # #.## #.##.# #.# # #..# #.#..# #  # # #.# # ....  #.. .    .  . . . ##.#  #..  .    ...     .. . . .  ##
##..# ## #.#. # #. # #  # # # # # ##.#..# # . #.#.### # ##.## # ##.#.## ....#  #.#.#.####################..#
#  # . .=.. # #  #.#.#.#.#.# ## # . . #.#.# ##..#.#.# # . #.#.#. #.#..#.#####.## #.#.# .  .  .   ...... # ##
##.#.###.# # .#.## # # .  . .   # ##.##     . # #   #. #### ### # .#.#. #... .# .# #. ###.## #####.## ### .#
## .#  # ## # # # ## ##########.## # # ####### #.###..# .  . ..  #.#. #..## # .#.# # ## ##.#.# ....#..#   ##
#. ## #  .. # . .  .. .  . .  . . . .. .            #..### # ## #..#.## #. .#.#.## # .  ...#. # ##  #..##  #
##.#  .#.## #.### ## ## ###.# # ## ## ## ######.##.#..# . # ..#. # # # .# #.#   ...# # #.##  # . #.##.##. ##
#  .# ##.# #..# # #.##.##.## # # # .#.# .# . . #  # # .## ##### # .# ## ## ## ####.# #.#.# #..# # .#.   # .#
##.## #  . .#.#.# # .............# #.# #.# ### ## #.#.#.   . . .##.#. #.   .. # ...#. # .# #.#  .#.## #.#.##
#..#.  # ####.# ..# ##.#.#.# # # #.   .#.#.# #. #.  # ######### .#.#.## ##### # ## #.### = #. # ## .# # #  #
##..# #..#.. .###.# #.#.#.#.#.# ##.#.##  #.. # #  ##.  . = . .#.# .# . #....#. ## # #.# ###.## ##.###.### ##
## #  .# # ##   #.#.. . ... ..... .#.  #.# ##...#...#.########.# ## #### ####.#.     ... ....  .. .    ..  #
#   #.##.## # ## # ################.### # # ##.##.### #    ... ....=..  . .    ### ## ###.####.#.##.##.##.##
##.#. . ..  ...        .     ... .  . .  ... ......  .#.# # #.### ## #.# #### # ..# #.#.# # .#=# .### #.# .#
#  .###.# ########## # # ## # ###.####.#.#.# ###.##.#.# #..# ##..#  # #.#...# #.# #.#   #..# # #.#. .  . .##
##.#.. .#.# ..  .. #.## ## ##.#. #.. .# # # ## #.#. # # # #. #. #..# .#. .##  # # #.#.## .#....#. #.###.#  #
#. #.## #  ###.# ### .#.=. .. .#.####  .      .# .#.#..##..#..#. # .#.#.#.# #.# #.#   .##. # # # #.##.##. ##
##. #.# # #.. #. #. .#.##.###.#..  .#.##########.# # .#  .## ## ## ##.### #.#.#.#.### #=..# #..#..  .  .# ##
## #. ..# =## ##..####.# ## ##.# #### #     ...   ..#.# #.. ..... . ....   .# # #. .# #.# .  #.# ###.## #. #
#.. ### # #.#  #.# .. .   .   .  .  .  ### # # #.##.#.# #.# ## ##.# ## # ##. .# #.# #.# #.#.## #.#..###.# ##
## ##.##.##.#.## #################### ## ## # # #.#=# ## # # ##.## ## # ##.### ## ##.#.#.#.##.#.#.#.##.## ##
#  .. .  .. ....  .   . .... . .  ..   . .  .... .  . ...    .  ...  .. .         .     .. .  . ..  .    ..#
## #.##.#.#.### ### #.#######.## #.## # ### ## # ###.#### ## ###.##### ####.##.## ## ### ###.#.##.## # #####
##..## ## #.#.#.#..## ..  . .# #.# . # # ...#.# .#=# #. .#.# #  #.  ..# . # .#.# .# #..#.#.# #.#.# ..# #...#
# .#.  .. # # # ## #  #.###.# .#   ##...### # ####.## ## # ###.## ##### ##. #.. #.#.  ## #.#.#.# #.# #.# # #
##.# # ##.# # #..#.##.# # ## #.##.## #.#. # . . .   . ... ..  .. ... ...  #. # #.. ##.. .# #.# # ## # ##.###
## #.#. #.#.# # #.  #. # ...  .  .... ..# . #.# ##.##.#.#.# ##.##.# #.# #.# #. .# # .# #.#.#.#.#  .  .  .. #
# .#.# #  #.# #.## #..# ##############.##.#.##.# ###..# # # #.#    #.# #. # .#.# .# #.#..#.# # # ##.#.# ## #
## #.#. # #.. #. # .#.# .      . .  .    . .  ... ..# #  # ## ###.#..#.##.#.#. ##.  . .#.#.#.#.#.#.# # ##.##
##.#.#.##  # ## #..#   ##.##.# ## ##.#.# ## #.##.## #.#.#    .  .. #.#..#.# .#..#.#####.## #.# .  ... ...  #
#. # #.#..# ..   #. #.#.# #..# #.## # # ##.# ## # ##  #.#.####### ## # # .#.## #   .. ...  # #.######### # #
##  # # ##.####.##.# .#..  # #. .  . ... .. .   ... #.# #.# .  ..  .  . #.# #. ####.#######. #.# ....    ###
#  # .  ..  .  .  . # # #.#. #.##.##.# #.# # # # ##.# # # .#.#.##.## ## # #  #. ..#  .   . # #..#.#.# ##=  #
############################################################################################################
