############################
#.#.#...# #...#.# ... ..#. #
#...#.## ..#.#.=.#.#.#.#..##
###. ....#.#.#.##.##.#.## .#
#. .##.##.##.#...   .#. #.##
###....... ..####.##..###..#
#.#.##.##.##.   #.## # .. ##
#.#..#....#.#.## ... .# #. #
#.#.#.# ##%..  .#.##=#.##.##
#.#.#o#. #.####..# . ......#
#.#=#.. #.=# .#.# .### ##.##
#....###.###.##.## #.#.....#
# ##........... . .#..#.##.#
##.## ##.# ### ##.#..#.. ..#
#. .# #.# ##.#.. #.# .#.#.##
#o##.... . ....##....##.#.##
#.. .# # #.##.## #.#.#..#. #
###.#. #.#.# ....# #o.#.#.##
# #.##.## #.#.###..# ##.#..#
#.... . .........#.#....####
#.#.##.# ##.# # #...#.#....#
#.#.. .##.#.#o## #.#..#.#.##
##..#.#.....#..=. ..#.#..#.#
#\.# #.#.#.## #.##.## #.## #
##............#..#.. #.....#
##.#####.#.##...#..##.#.####
#. ...  .#. ..#. #... ..  .#
############################
