#####################################################################################
##      # .   #..# #.  #.   #. # .#..       # #.# ## #  #.# # #.# # # .# .#   o  #  #
# ##### .# ## ## # ### ##.##..# # ..###.###.#.# .. ... #  .   . # . # ###  # ##### ##
#....  # ## #  #    .   #.#.# ..  # #..# .#.#  # # # # ## ## ##.# #.   #. #     .   #
###.##      # #. ## # #  ..  ###### ##  #.### ## ##.#   .#    # #.# #####  # ###### #
# # # .## # .. # # #  # #.#.#.       #.##    .#   . .# ## ####.  #     ## #  .     ##
# #  #.#.#  ###  #  # # ## # ######.## # #### .### # #  . . . # # .###  . ##.## ##. #
# .##. .. # # ## # #  #. .  ... .   .  . .    #  . # # # # ## # ## #.#.## .#  ## #.##
#.# #.#.# # #   .# ##..##.######.# ## ### # #.#### ##.### # # #  #  .#  # #. #  ... #
# #.# #####  # # .  # # # #. . ## # .#   # ## .  # ... ## # # # #. # # # ..# # #.# ##
# # #   #. #. #  # #  # ..# ##     # ## ## #  ### #.# #. ..   # ### # # # ## ##.#   #
#.#.#.###.# ## #  #.# ###. # # ###  ..    ..# #  ..# ## ######.. . ..    =  .. ..#=##
# # #        .   # .#.. # #    #.#.# ##.## ## #.###..   . .    ##.##.##### ## #.## ##
#. =# ### # ## # #.## ##  ####.#   # # ..# #  #.# ..#.# ######   #. #.  .##.##  # . #
# #.# #  #.## # #  # # ##   ... ##.# ## #   # # ### # #.# .  # #. #.# # #  ...# ## ##
###.=.  # .   #  #..   . ## ###   # # #. # #..#.  . # #.# ## # # #  # # #####.#. # .#
#...# ### ### # ##.##.###.### #.#   . # #   #  #####.# ## # # # # #  #    .    .# .##
# ##   .     # ...  # #     ..# # # # .#.# ## #.   .   . ..  . .. .=#o##.# #.## ## .#
##  #.# #.## #.##.# # .###### # .#.##.##.=# .  ####.#####.## ## # # # # # # ###  # ##
# #.## #.# # ##  ## ###  = .  # # . .    # ## #   #  .  # #.##.# #  #    ..  #. #  ##
#.       . .  .#.    .# #.# # #. #### #### .# #.#..#.###... .  . .# # ## #.#. #. #  #
#=#=# # #.##### ### ###  #. # # #     # . .## # #.# #.  # #.# #.# #  # # ##  ##.#  ##
# ##.###.#....    #    .# #.#.#  # ## #.## # .### #   ###. ##  # .# #  ##..# # #.#. #
#  #.## .# # #.# ###.##.# # # # #   #  # . ##...  .##.#   # . ## #  .# .## # #...  ##
# #.  .#  .## # # # # #. .# #.# #### ## ##  .# ### #. . # ##### # # # #. # #.# #### #
#  # #  ##=          .  ## #  #  . . ...  .##.#  #. # ###.        # # # #.   # #.. .#
### ##.#. # # ## # ## #  .  # # ##.#### ### # #.##.#  ....## ## ### # # # ####.#=####
#.    ..# # ##.#  #   # # ###o# # #    .#.         ######.# #  # .           . # . .#
## #.#.#.. #.. # #..#.#.##..  # # .# # ##### ###.#.  .. # # # ##.##### ## #.# ##.##.#
# # #  ### ### ## #.#.# .# ## # # # ##  #  ##. #.# # # #  #  .   # . #.# . # #. . #.#
#   .# =.  .   . . #.## #..#  # #.#.   # .#  # ##   #.# # .# # # ## #   #.#  ##.#.#.#
# ##  ###.# ## ## #   .  #. # . #  ### ## # # .  # #.     # # #  .# ##### ##  ## ## #
#.#  #     # .### .#.## ##.#  # # #    ...#. ## ## # # # ##   .# #.      . # #      #
#. # .### ## # #..#.# # # ..# ##  # ######  #      ## # #   ## #  #.# #.# #...# ## ##
# #  #. #    # ## # .   # ## .. # # #    ## # # # # .   . ##=. # # ### ##.## #   #  #
# .#.# ## ####    # ## #.#. ### # ##..# #. .## # #.##.#####.###  #  #        ## #  ##
# #  #     .  ### ## # # # #   #. . #.# # #..   .         ... .# #.# .### ###  . #. #
# .#  ##.# # #  #  #   ..#.#.## #.### #.#..# ### ## # # ## # #.# #. #.# .  .#.# ## ##
#.#  ## #.# ## # .# .##### #  # # #.. #.###.# .. ##. #  #  # #.# # #  # #### # #    #
#..# .       .  # .# #   .   ##.#. ## #   #=.#.#   ##.# .# # #.# # .#  # .   .  ## ##
#.# .######.### # #..####### #  # # #.#=### # #.###   %.#  #.# # # #. #  # # ## #. ##
# ## #      # #.#.##.     .   # .     # #     .     # ## #  ## # . ### #. # # # .#  #
# .#.=## ## #.# #   # #### ##. #.#####   # #.#######  .  # #. .# ## .    #    # ## ##
## #.# . #. # #=# ##.#   #  # # # . . #.# # .  .  ..#.# #  ##### ## ###.# # # #.#   #
##.#  ##  # #.# # #.   ##  #  # # #####.# # ##.## # #  ## # .       # # #  . #. ##.##
# .# #  .#  # #.#..# #   #. #. ..     . # .#.# # .#.#.#   #.##.##.# # #= ## # # .. .#
## #  ##  #   # #.# #  ## # #.# # ##.#### #  # .#  #   ##.# # #  # .#.  #   # #.## ##
## # #.### =##..# #  #.#.  ## .# #.# #. ..# ##.#..# # # #. ## ##..#  ##.### #.# # .##
#  # #  . #   #.#.# #.. ##.#  # ..   # ## # # . #.# # # # #   .  #  #.#=..#..  .##..#
## #.# ###. ##  # # .# # # ##.# ##.#  # . #.## ##   #.  #  ### # ##  . ##. ##.##. .##
##.# # #.## . # # # #..  .    # # #..# ## #. . #  ##  #.# # .#.#. # # # # # # # ##  #
#.#. .. .  # #  #    .####### # #. # #=.. .###=# #  #.# #  # ##. #.. ## # #   . .#.##
# #.###### #  #  # # # .    . # # # #  ## #... # # #  #.# #.  .#. # # .  .# #### #  #
# # ...   # # # # # # # ##### #.#.   # #...# #..## # ## # # ##   #.. ####.#. . ## ###
# #.### ##  .#      . .#.   # # # ####  # ## ## #  .#  .#.### .#  # #  ..  # ##  .. #
# #.#   . # ##.##.## ## # ##. #     . ##  # ..#. ##. ####... #.# #  ## ## ##  # ### #
# #.#.# #.# # .#  #  . .. . # # ####### #.#### ##.# #  ...## # # .#   #     # #.#.# #
# ..##  # # ### # # #.##### # #.#         .. .  ..  #.####.#.### #. #  ## # # #.   ##
#.##..#. #...   .# # # .. #.# #.#.# ## # # #.##.## #.#. .. .o..  ### ##.#.#  ##.##  #
# # # ### # ## #      # #.# # #.## #.###.##.#.### ##.#.### #####     .    .##.  # .##
#.... . . .#.###.##### ##.### #.  .   .  . .  ... .  . #. .. .  ##.## ## ##  ## ##  #
##.# ##### . = .               ###### #### ##.####### ## # #.##.# #.## ##.##.#  .# ##
# # #      ########.###### ###.# .  #.#   #  #.  .   ## ##.# =# #           .## ## .#
#.  # ## #.#       #    .#.# ##.## # # ##.# ##.# ##.#    ..#.#. # ##########   .#  ##
#.# # #  #.# #.# #. #.# #  #..  ..  . . .       # # # ####  # ###.# . . .. . ### #  #
#.# #..#.#. # #  # # ..#.# ##.## ###.#.#.# ## # # # ##  .. #      .# #.### #.    .###
# ##  ### .#   ###..#=#..   # # #.. #   # #.##.#  #  # ###  ##### #  # # # # ##### .#
# . #  # # # # . ..#   ### #.#.  ##. # ##    .. #.#.##   # # .    ## #.#  #..#   # ##
# # #.#. # #  ## ## #.#.   # ## #.#.#  .  # # ### # #  ## .#.# ### ##.#  #.#  ##.# ##
#. #   # # # # # #  # #### . .# #  . # ### ## #  .#  #  ##.# #. .    . #.# # # #  . #
# # #.#... # # ##.#.#.  . ## #.  # # #.# . .  #.#.#.#. #.    .## ## ##.#.#.#.#.#.#.##
#   #. # #.  .    . . #### # .# # ## # .##.## ##...  #=# ### # ## ##.#.#  .#.  . # ##
# ##  #.## # ## ## #.#   #  # #  .. .# #    #  .# # # .#   # # . . .   # # # #.# #  #
#   # #.   # #.## #... ### #.##.### # ..#### ### .# ###.####.# ## ## # #.## #.#.# ###
# ## # ### #.#  .  #.##  . .  .   # .# # .   =. # #..  . .  .# #.## ##.#   .. ..   \#
#         ..# # ## # .  ## #####.# .##.#####.## # .##.#=# ## # # .    .# ## #.# ### #
# ##########. #. # #.### ## . . # # # .  ..# .#.# #.### ##.# # # #######.#.#.#.#  # #
###.   ..  # # .#  # #    .# ###    # # ## ###. # #  ..   .# #.# # . ..          # .#
#  ##### # #  #  #.#.# # ##    #.## ## # #   .#    # ## ###  ##   # # #.## # #.#.##.#
##  .. = #.# #. #  . #.#.. # #.# #  . .  #.## .#### # # #. #.  # #.# #.## # # ##  #.#
# # ## # ### ### #####.##### ###. #.####.# #  #    ..   ##.# #.# ..  ..       .  ## #
#    # #   .              . .    #    .# #. # #.#.#####= #    # ##### ## ###### #.. #
###.##..####.## #.# # # ### # ##  # ## ### #. ## # .  # # ## #   .. .  #. . .. # ####
#   #  # . .  # #  ###    #.#.#  #  ..# ....#.   . ## #  ..#  #.# # # #. # #.#  .   #
#####################################################################################
