############################################
### . .     . .#  .#  #   #= .  .... .# # .#
## ## ##.##.# #  ##  #.##..## ## # ##  .  ##
#   #. ### ## ##.#.# #.   # #.#. # #.##### #
### #.#   . .    #.#.####.# ##.# # #.   .  #
# . ### # ######...     .    .. .### #.#.###
#.#     .# .=..# ####.## # # ###      # #  #
#.# #.#=## ####.#.     .# # #.  .## ###.# ##
#.## ## #...   ..# ## ##..#  ##.#.# #...# ##
#        ####### ##.#.  #.#.# . .   #.#  ..#
### ### #. ..        #### # # ##### # # ####
# ..# # #=## #### ##.  .  # ##   .# # #    #
##### #.#.# # . #.. # ##.# . .# #   ### #.##
# .  .#o# .. .#. ###.# # ##.# #.#.#  .. #. #
## ##.  ## ## # # .  . #. #.#.# # # ## # ###
## # ##...### #.## ##.#  #  .## . #...#... #
#..# . .# ##. #  #.%#  # # #.#  ###.# #.##.#
## .### o#  #.# ##.# ### ### ## #.. ###.## #
#  #  #.## #.## #=.   .   .   #  ## .     .#
## ##.#  .  .   .#####.# #### # # # # ### ##
# . o .##.## #.#.. ..#.# o \# #.    #   #  #
############################################
