########################################
#.# #.## ##.## # # #.#.# #.# #.## ##.#.#
#   .  .      .  .        .    .    .. #
# ## # #.## # #o# ## #.#.# # # ##.## # #
#.## # #.##  .   .            . .      #
#   .       #.# # ## # # # ## # #.# # ##
# ### ## ##       .         ..  .   .  #
# # # ## ## # #.#.## #.#.# ## # #.# # ##
# .           .     ..     . .=        #
# ##.##.# # # # # ## # # #.## #.# # # ##
#       ..  #.# # ## # # #     .# # #.##
# ## ## # #   .   .  .   .=# ##  ..    #
#. . ....   # #.# ## # #.#   =# # ## #.#
# ## ## #.#.# #.     = .. .##.       ..#
#   .         ..# ##.# #o# ## # ## # # #
#.## ## # #.# # # ## # # #.## #.##.# # #
#      .     . .   .    %       .   .. #
#.## ## # # # # ## # ## ##o## #.#.## # #
#       .    .  .       .     o .    #\#
########################################
