########################
#..#.#. .# #.# # .. # \#
##.....#.......##.#o..##
# ####.#o#.#.## ###.## #
#....o.#= # .   .....# #
##.##.#. #..#.##.## ##.#
###.. # # .# ..#..# ..%#
##..#= #..#. #..#..#.#.#
#..###  #.. ###.. #.# ##
##..#.##.#.# #.#.## . ##
#..#.    =.= .o#. ..# .#
########################
