###############
#   .  \  .  .#
# # ## # ##.# #
#.## # #  # # #
#      # #  . #
#.# ##     ##.#
#o.  # # # ####
## #   #      #
#    #.  # ##.#
##.#   # # # ##
##. .#    = ..#
#= # #.#.# # ##
## # .   = o% #
#   .# #o#=#o##
###############
