##################
#. o  . # #.##.# #
##.# ##  ..  # ..#
##.## # ####.#\###
#  ==. .. . ...#.#
## #=# ##.#.##...#
# ...%..=....# #.#
#.#### ## # #....#
#.# .#.. .#.## #.#
# .#. .##o#..#.#.#
# ## # ..   # . .#
# ##.. ##.#..# # #
#.#..#.##.  # .#.#
#  # # .. #..#  .#
# ##.#.# #..#..# #
# ##.# # ## ## # #
# oo.  ...#....  #
##################
