###################################################################################################################################################################
#  ....#.#.#.# #.#...#...# . #.#.#.##.# ##.#.#.# .. ... .......... .............#.#.#.# #.#.## # #..#... # #.#.# #.#..#.#.#.# .#.##.# #..#.#.#..#.#.#..# ##.##.#..#
##.####. #.#.#.#.###.###.###.......... . ....#..#.#####.#.#.####.##.####.#.#.##.# ........... =...#..###.#.#.#.#.#.#.#..  #.#.#..... ..#.#.. .#.... # # ..... .#.##
# .....#.#.....#... ..... .#.######.# ##.##.#..#.#.....#..#.#. .#......#.#.#..#.#.#################.#. #...#.#.. .=..#.##.# #..#.# ###.#.#.#.#..## ##..# #.###.#.##
##.#.#.#.#####.# ########## .#.....#.#.##.#.## #..#### ##.#.#.#. #.###.#.#.#.# .#.# .. .............#.#..#.# #.#.###..# # #.#.#...##.###.#..#.#..#.#..#.#.#..# # .#
# .##.#   . ...............#.#.###........#..#.#.#.. .. #.#.#.#.#.. .....#.#..#.#..#.#.##.# ##.#.##. . #.#.# #.# #.#.#.........# #. .....#.# .. ##..# #....#.#.# ##
##.....#.###.#.#.##.#.###.# .# ..# #.##.#.# # .#..####.#..# ##..######.# # # #..#.#..#..#...# ##..#.####.## .#.#...#..#.##.##.#...###.##.#..### #..#. .##.#..#.#..#
##.#####.#.##.#.#.#.###.##.#.#####.### ##.##.#.#.#......#.#...#. . . #.#.#.#.##.#.##...# .#.#.# .#..#......#.#.#.#.#.#.#.#.#.. #.#...#.# #.#.....#..#.#.  .#.#.#.##
#.. ... .#..........   .... ...=.... .. ....  .#.#####.## ####. ######.#.#.# .#.# .####.##.##.##..#.#### ##..## #.#..#.#.##.#.#. ###.#.#.#.# ##.#. ## ###.#....#..#
##.##.## ##.###.# ##.####.####.# ##.#.##.#.#.#.#. .......  .. #.#......#.#.#.##.#.#. ............##... #.# # ......# #.........# ... ......##.#..#.# ...#..#.#.#.##
#.##..#...#.#..#.#......#.#...#.#..##.#.#.#.#. .#########.###.#.#.#.##.#.#.#.#..#..###########.# #..##.# #.# ##.#.#. .###.###.#..##.## #.#....# #..##.###.##.# #.=#
#...#..#.#...#.#.### ###...##.#.# #...#.... .#.# .........#.#.#..##..#.# #.#. #.# #. .. . ....##..#..###.#...#.#.#.#.##.###.#.##.#.##.# ##.####. #. # #...#.#..#.##
#.##..##..# #... .......#.#.#.#.#.####.####.#.  ## ##.#.#.#.#.#.#...# .#.# #.# .#..##.#.#####.#..#..# .. .##.#.. ..#.#. . .. . ......... . .....#..##.#.#....#.#.##
#...#.#..#..#.##.###.###... .... ........... #.# ###.#.#.##.###.####.###.#.# ###. #..#. ....#.##. #..###.#...#.#####..# ## #.#######.#.# ## #.#.##.#..#.#.#.#..#..#
#.###..#..# #..#.#.#....#.# #.#.#### ##.#.###..#..... ..............  . .#.#....#..#..#.##.#...#.#..#. . #.#.#.#.....#.###.#.# ....#.#.#..#.#.#..#.## #.#.# ##...##
# .. =#..# .#.#... # ###..#.#..#.. #.#.# #...#..#.#.##.##.#####.###.#.## #.#.##.#.##.#.##.# # ##..#.#.##.#.#.# ..###.#.## #.#.####.##.#.##.#.##.#.#.#.#.#.##.#.#.##
#.#.#. #. # .#.#####....#.#.#.## ##..# ....## .# #.##..#.#... #.#..#.##..#.# .#.# #..  ..........#. .#.#.#.#.#.###.# #..... ..... . ........  .........##....#.#..#
##.#.###.# .# .......##.#.#.#.# ...#..#### #.#.   ...#.#=.#.##.#.#.#...#.# #.# .#.#.############..#.#....#.# ......# ##.###.##.#.#.#####.##.#.#.# #.#.#.. #.##.#.##
#. .... ..#.########.#..#. # #.#.###.#. .#.#.#.##.####.#.#..#  . ....#.#.# #..#.#.#.#... .... .# #...#.#.# #.######...#.#..# #..#.#.. ..#.#.#.##..# #  ## #.#..#..#
##.##.##.#... .... #. # #.#...... .. ##.#. #.#.#.... ..#..#..#.##.##.##. # #.#. #. # #########.#..#.#.##.#.#... .. #.#..#.##.####.#####.# ..#.. #..##.#.#.#..#.#.##
#.#o##.#.##.####### ##.#.# ##########.#.##.#.#..######.#.#..#.# #.# ...#.# #  #.#.#.......... ...#..#.. .# # ##.#.##. #.#......... ...#..####.#.#.#. .# ..# #..#..#
#. .. ............... ..  ..... ........... ...#.....#.#..#...#.# ##.##..#.#.##.#   ##.#.##.####..#..###.# # #.#.##..#...#.# # ##.##.#..#.....#.#..## ### ##.#.#.##
#.# #.##.###.### #.#.####.#.#.#.#.#.#.##.#.#.#..##.#.# #.#..##..#..#.#.#.#.#.#..# # .#.#.#.#...#.#. # ...#.# ......#..# #..##.##...#..#.#####.#.#.#.#..... .. ....#
#.#.#..#.#. #..#..# #...## #.#.#.#.# #.##.# ##.#.. #.#.#..#...#.#.#. #.#.#.#.##.#.##.#.# #.###.#.##..#.#.#.#.#.##.##.#...# .....#.#.###.....#.#.#.#...#####.#######
###.#.# ..#.##.###. .#.# ....  ..  ....... .... ####.###.## ###.##.#.# #.# # .#.#..#..##.#.... #..#.#........#.#=#....#.#..##.#.#.#.....###.#=#.#.#.# #...........#
#=..#..#.#........#.##..#.#.#.#.#.#.#.# ###.## #... . ............=.... .#.###.#..#..#...#.####..#..########.###.#.#.# # ##.##.##.##### # ## #.#.# ##.#############
###.#.#.. #.#######.#..##...#.##.#.#.#.#...#.# .##.#####.##.##.###.#.###.#......#..#.#####.....#. #... ......  .... .. ............ .... ...... ... ..............#
#.# #.## #...........#.#.#.##. . .......#.# .#.#..#.. . #.##.#.#.# #.#.#.#=###.##.#... ....#.##..# .###### #.##.##.###.#.##.#.## #.#.#.###.### #.# #.#.#.#.##.#.# #
# .....# ##.###.###.#..#......#.##.###.##.##.#.#.#..#####..#.#. ...# #.# #.#..#...#.##.###.# ..#..#.#.  ..#.#..#..#...#.##.#.#.#..#.#..#.#.#.##.#.# #.#.#.##.#.##.#
#######.#.#.#.###.##.#..#.#.#. #.#.# #... .#.#.#. #.#.....#..#.###.#.#.#.#..#.###.##.###.# #### .##..#### ...#..#..##.#.#..#.#.#.# ..#...#.# ...........#.#.......#
#......................#.#.##.# ...#.#.#.##..#.# #..#.#.#..#.###.###.#.#.#.#  .... ............#.#  #.....###..# .#. .. .#.#.#.#..#.#..##..#.##.#.#.#.##..#######.#
# #.#.##.#.##.########.#. . ..####.#...#.#.#.#....#.## #..#..........#.#.#..#.#.#.###.#.#.# ###...#..####.# ##..#...###.#..#.# #.##.##.# #.#.#.#.#.#....#. . ...#.#
##.#.## #..#. #... ..#.#.#.##....# #.#.# #...#.###...#.##..######### ..#.#.#..#.#.#.#.#..#.#. .#.##.#.... .. ..##.#......#.#.#.#.....# #.# #... ....#.#.#.#######.#
#......=##. #.#.##.##. .#.#.#####.# ##.##.##.#.#..#.#...#.#..........###.#..#.#.#.#.#.#.#...#.#. #..#.##.##.##.#...####.##.#.#.# #.#.#...# # ##.#.#.#.#.#.#.......#
###.### .#.#..##.#. .#.# ......  ....... .. ...# #..##.#...#.##.####.#...#.#..#.#.#.#.#.##.#.  #..# .## #.##.#..#.#. ......# #.# .#.##.#.#.#.#.#.#.#.#.##.#########
#.. ..#.##. #..#.#.##..#### #############.####.#..#.....#.#...#. ..#.###.#. ##.##.#.#.#. #..#.#..#..#..... ....#.. #.#.###.# #.#.#.....#.#..  .... ..  ....... ...#
#######.#..#..#... #.#....#.# =....   ....#....# #..###.# ####.###... .#.#.#......# #.#.## ##.##.##.####### ##..#.#..#.. #.#.#.#..##.#.#.#.####.###### ###.#.#.####
#........#..#.####.#.#.####..#.# ###.##.#..###.#= #.#.#.#..... . ..#.#.#.#..### # # #.#........# .#.......#.# .#..###.####.#.#.#.#.###.#.#.#....#... #.#.##. # #..#
##.#.##.#..#  ... ...#.#....# #.#..#..#.#.##.#.#.##.#.###.#########.#.# ##=##.###.#.##.######## ###.## ##.#..#..#......... ... #.#.....#.#.####.#.####.... #.### ##
#  ##.#..# ##.###### #..#.#.#.#.##.# #. #... #.#.. ........  .. ........................ .   ..... ..###.#=###.##.##############.# ###.#.#... #.#.#....####..... .#
##. ..#.#...#.#... .#..#.#. #.#... #..#.# ####..###.#.# #.##.#.##.### #.##.#.##.###.######.###.####.#...... ...... .... . ..... .#...#.#.#.##.#.#..###.....#.###.##
#..###. .#.#..#####..#.#..#. .#.#.#..# .#.#. ..##.##.# #.#.##.## ##..#.##...#.# #........# ..#.#. #..###.###.#.###.# #.####.#.##.#.#.#.#.#..# #.# ##.#.##.##.# .#.#
## #..# ##.## ... # #..#.##.#.#.#  #..#.#..#.#.... ................#.#.#..#=.....##.#.#.##.#.#.#.#..#...# .#......# #.#...#..#.#.# #.#.#.#.#  #.# # ...# .#.. #...#
#.#.#.#.#.#.#######.##.#.# #.##.###.##.#.##.##.#####################.#.##.########.#.#.## # #.##.##.###.#.#.#######.#.# ##.###.##.#.#.#.#.#.##.##.#####.##.####.###
#. .. .. . ...... .... .. . ..... .. .............. .... ........... ... ........ .  ... . .......... .... .... .. ....... ................ .. ................. .#
#.##.##.#.## ##.##.###.#######.####.#.###.#.##.##.### #.#.##.###.#####.##.#.#####.### ##########.#####.####.#.#.# ##.#.##.##.###.## ##.##.#.#.###.#################
#.#.#.#.#.#.## #.#.#.# # . ..#.#..#.#.#..#.##.#.###..# #.#.#.#.# #...#.#.#.# ...###.#.  .......#.#...#.#. .#.# # #..#.#..#.#.#.#. .#.# #.#.#.#. #..... ..  . .. . #
#.#...#.#. ...o..#.#...# ####.#.#.##.##.#..........#.#.#.....#.#..##.. #.#..##.#....#.###.###.# .#.##...#.#..# #.#.#..##.#.. ..#.#.#.#.# #.#..#..##.#.##.# ##.#.#.#
## ## ##.######## #.##.. ................#.#.#.##.#..#.#.###.#.#.#.#.##=.#.#.#...##.#.#...#.#..#... .#.#...#.#...#..#..#.###.##..###.###.#.#.## ##.#.#.##.#.##.#..#
#.... ............. . .###################..#.#. #.#.#.#.#.#.#.#.#.....#.#.#.# ##.#.#..##.#.#.#..##.# .##.# .# ##. #..#....#..##.........  ...... ...... .... ..#.#
##.#####.##.# ##.##.##.# ........... ..  ..#. #.#..#.#.#.#.#.#.# .##.##..#.#......... ###.#.# ##.#.# #..# .#.#.#.# ##..#.##..# ..# ###.##.###.##.##.### # ####.#..#
#......#...#.#..#..#.# #.#.##.##.#.##.#.##. #.#. #.# #.# ..#.# #.# ..# #.#.###.##.###.##..#.#..#... .#.##.#..#...#. #.##...#.#.# #.#...#.#..#.#.#.#.#..#.#.  #..#.#
####### ####.## # ##.##.#.#.##.##.#.## #.#.##.# ##.#.# ####.##.##.##.#.#.#. ..#..##.#  .#.# ###. #.#.#.#...#.#.#.#.#..#..##..#.#.#.#.#.#..# #.#.#...#.#....#.#.#..#
#.. .................. .... ..  .. ................................. ... ..####.#...#.###.#....# # ## ..#.##.#.###.## ##.#.## #.#.#.#.##.##.###.#####.####.##.#.#.#
##.#.#.## #.#.##.##.#.#.#.##.#.### ## ###.## ##.#.##.#.###.#.#.##.###.#### #. . #.# #.#...# ##.#.#...#.#...... . ............ ....... . ........... . ..=...... #.#
#.#.#.#..#.#.#..##.# ..#.#..#.#..#.#..# ##..#.##.#.#.#.# #..# #.#.# . .. #..###..##.#.#####.#.#. .###.#.# ##############.####.#####.####.## ####################..#
#.#.# ..#. . .# #...#.##.#.##.#.#. .#.#..#.#...#.#.#.#...#.#..#.#.# #.###..# ...#. .#. ........#.#........# ......o.  .#.# . #. ..#.#..#....... .... .  ........# #
# ...##.#.## #..##.# .#. #.#..#..#.#..#.# .##.#..#..#.####.##.# #.#.#.#. #..# # #.#.#.#.#####.#..#.# ##.#.#####.#######.. #.## ####.#.##.###########.#.#.#.##.##..#
### #.#.#..#..#..# .#..# #.##.#.# .##.. .#..#. #.#.#........#.#.#.#.#.#.#..#.# .###.#.#.#.... ##.#.##.##.........  ....#.##.#...... #....#. .. . ..#.##.#.#..#.##.#
#...#.#..###.##.##.##.#..#. #.#.##..#.###..#..#..#.##.##.#.#..#.# #.#.#..#. ..#. ...#.# .# ##. #.#=.....#.##.#.# # ####..#..#.##.##. ###..###.##### .  . ..#.. .#.#
#.#.#.#.#. ............#.#.#.......#..#. #..#..#.# .# #..# ##.#.#.#.#.#.#..#.#..##.#..# #.#.#.## #.#####  #.# #.##.#...#.##.# .#.#..#....#... .....# #######.###. #
###.#.#..######.#.###.#..# #######. #.# #. ##.#..#.##..# #..#.# #.#.#.#.##.## #.. #.#.#.#.... #..#.#...##.# .......#.##...#.###.#.##.###.#.##.##.# # ........ ..#.#
# ..# . #...... #...#..#.#... .....#.....# #...#.#.#..#..#.##.# #.#.#o........#.#.#.#.##.##### #.#.#.#..#.##.#.#.#.#.#.#.##. ........ .#.##.#.#.#.#.############..#
###.###. ######=#.##..# . ###.#.##..#.####.## ##.# .# .#.#.# .#.#.##.#####.#.#..#.#.#........=.#.#.#.# #...##.#.## # # #.#..###########.... ....... ......... ..# #
#.....#.# .. ...# #.#..#.# ..#.###.#..#... ..... #.#. #..# ##.#.#..... ..#.##.#.#.#.#.### ###.#. #.###.## #....... # ....##............#.###############.#.##.#.#.#
###.#.#..########.#...#..###.#.##...#..#.####.##.#.##..#.#..#.#.#.##.#.##. . .# .##.#.#.###.##.#.#.... .# #.##.###..#.##..#.#.#.##.#.#.# # ..... .... .##.##.# #..#
#.# .##.# ........#.#..#... .....#.#..#..#...#.#.#. #.##.# ## #.#.#.#.#.## ##.#.#...#.#... ....#.#.##.##...#.#.#.#.#.#.#.#..#..#..#.## #.#.##.##.##.## .........#.#
# #.#...#.#.##.##...#.#..##.#.#.#...#. #..##.#.#.# #..#..# #..#=#.....#..#.#.. .#.#.# #.##.##.#..# #.##.#.#..... #.....#.##.####.## #.#.# #.##.###.#.#.#########..#
# #.#.#..#.##.##.###.#.#.#.#.#.#.#.#..##.#.#.#.#.#.##..#.#.##.#.#.#####.#...#.#.#.# #.#.#.#..#.#.# # ...#.##.# #.#.##.#.... ............. ......................#.#
#.#.#.#.#............... #.......=.##.#...... .# #..#.# .#..#.#.# #..... #.#..# .## #.#.#.##.# #.#.#.##.#..##.##.###.#.###.######################################.#
#.. .##.################.##########.##.######### #.#.#.# ####.#.##.####.##..#.#.#.. ..#..........#.#.#.#..#.. .......  ............. .... .................... ...#
###.#.......... ...... . ...... .  ... ... .. ........ .............. .....#..#.#####. ##.###.##.#..=...#..#.###.#.#.#.#.##.##.#.#.#.###.#.##.###.#.##.#.##.##.##.#
#.. #.#.#.#.##.#####.#.#.###.##.#####.#.##.##.###.##.##.#.#.##.#.#.#.##.##..# #.....#.##.##.## #.# ##.##..#.## ##.# #.#.##.##.#.#.#.## ##.#.###.## #.##.##.#.## #.#
###.##.#.#.# .#.....# #..#..#.#.#...  ##.##.#...#.#.#..#.#.#..#..#.#  # .#.#..#.###.# #. ... ... #.# .#.#.#... .. ..=.............  .. .. ..... . . ............ .#
#.#..#...#..#.#.##.#...#.#.#..#..#.##. .....#.##..#..#.#.#..#.###.#..#..#..##.#.#...#..######### #..#.#.# #.##.#.##.###.##.### #.#.#.#.##.##.### ### ####.#.#.#.#.#
#...##.##..# .#.#.#.#.#.... #.###=##. ## # #. ..#.# #. #.# ##..... #..#..#..#.#..##.#.#.... ... .#.#.##.#..#...# .#...#..#.#..# #.# #.#...#.#....#.. ....#.#..##..#
#.#.#. ..#..# #.....#..#.##.#.. ....# .# #..#.#.#.#. #.#.#.#..#####..# ##..# .#.#.. # .#####.#.#.#.#.. .# # .###.# .#.#.#..##.#.# #.#.####  .####.##.##.#.. #...#.#
#.#.##.##..#..#.#.#.#.# #.###.######.##.#.###...#.#.#. #.#..#......#.....#  #.#. #### #  ...#.#..#..#.#.#..#.#... ##.## .#..#.# #. .. . ..#.#...... .#.#.#.#.###..#
#.#..#.#.#..#.#.#.#.#.#.. ..  .. ........... .#.#.#..#.#.#.#..###.# .#####.##.#.#. . .#.#.#... #.#.#.##.# #..###.#......##.#..#...###.####...#.#.#.# .. .. .....# #
#.#.##.#.#.#. #.###.#.########################.#..#.#..#.#.##.#.#..#.# ....#. #.##.##.##.##.###..#.#. .... #. .#..#.# #.#.. #.###.#..#....#.#.#.#.#..##.##.###.##.#
###.#..#.#..# #.......................... ....  #.#..#.#.#..#.#.#.#..#.#.#. # #..#. #  ........#.#.#.##.#.#..##..#.#.#.#.#.#... #.#.#..##.# .......#.#.#.#.#.#.#..#
#.. .#.. #.#..#.####.####.#### ##.##.#.#.#######. #.##.#.#.#. # #.##.##..#.#.##.#.##.##########..#.###.#..##...#.#..... ...=#.##..#.##.#.#..####.#.#.#.....#....#.#
###.#..#.#..#.#.#...... . # ..##.# #...#.#... ..#.#... ..#..#.#.#..#...#.#..... .... ..... ... #.#......#..#.###. ##.##.## #....#... . ...#.#....#.#..##.#..##.##.#
#.#..#.###.## #..#.######..##.... .#.##.##.#####. .#.#.#.#.##.#.### ###.#..#.##.#.#####.###.##.#.# ##.# #.#......#..#.#..#.## ### #####.##...####.##.##.#. #.# #..#
#.# #......#..#.##.#. . # # # ####.#...  . . ...#.#.#.##.... . .. . ..  .#..#.### #....#  ..#.##.#.%#.#.#.# ####..# #.#.# .. .. ....  ....#.# ...........#...#..# #
#...#.####..#.#.#. #.##.#.#...#....#.#.#.#.##.#.#.#......##.##.#.#.##.##.#.#..  ..####.#.##.#.#. #.##.#.#.##...#.#. ....##.#.##.#####.###.#.#.####.#.####.###.###.#
###.#.#..#.#. #..###.#.#.#.##.#####.#.#.#.##.# ##.#.#.##.. .#.#.#.#.##..#...#####....#..#.# #..# #.#.#.# ..#.##...#.#.#..#..#.#.#.....#.#.#.#.#....#.#.....  .....#
#.#..##.##.##.#.#........ .... ..... ........ ... #.##.#.####.........#. #.# .. #.##.#.#.. .# #. #.. ...#.#. #.#.#.#.# ##.###.##.###### ##.. #.#####..#########.#.#
#.#.#....... ...#.###.#.###.# #.#.#.##### ##.####.#..#.#.#... #######.#.#. .##.#.#.###.####.# ##.#.## ##..## #.# ....................... .#.#......  #  ......#.# #
#.#..##.# #.#.#.#.#.##. #.##.#.##.#.#.. #.#.# ..#.####.#..###...... #.#..#.#... ....... ..#.#=.# #.#.##.#..#.#.#.##.##.##.##.###.########## ##.##.## #.#.##.#.#.#.#
#.#.###.#.#.# #.#.# ..#.#. . .....#.# #.#.#. #.#... . .#.#. #.#.#.#.#.#.#..#.####.####.####.#.#..#.#. ..#.#..#...#.#.#. #.#..#...#.  ........###.#.#.#..#.#.# #.# #
# # ##.# # #.##.###.##.#.#########.##.##.##.##.#########.#.##.##.# #.##.##.#.#.. . ..# #. ..#..#.#..#.#.#..#..##.#.# ###.# ##.##..# ##.#.##.#........#.#..#.##..#.#
#.  ...... ..   .. ... ......... ... ......... .. ..... ....................# ######## ####.# #..#.#..#.#.#. #...#....... .......#.#.#.#. #..###.#=# # .# # ..#.#.#
#.##.#.#.### #.##.#.####.#.#.#.#.#.#.#.#.#.###.####.#.########.###########.#  . ............# .#.#.####.#. #. ##.=#######.######.. #.#.###..#. #.#.#..### #.##..#.#
## ###..#...#.##.##.#...#.#.#.# #.###.#..# #.#.#...#.#........#...  .....#. # #.##.##.#.###.# #..#.   ..# #..#.#.#. ......#....#.###.#....#..#.##.##.#......#.#.#.#
#.  ...#..##. . .....#.#. ... ..#.##..###.# ..##.###.##.###.# #.####.#.###.#.#.#.#.#.#..#.#.# ##.#.#.###. .#.#.#..###.#.#..#.#.#.#.... ##.#.#... ..  .#.###...#.#.#
#.##.#.##.. #.########.######.##....#..... #.#........#.#...#.#.#. ..#.#...#.#.#.#.#.###..#.#....#..#.. #.#..#.. ##.##.# ###.##.##.####.##...#######.#.##.#.##..#.#
#.#..#..#.#.#. ........... . ...#.#.#.#.#.##..#.#.##.#.#.##.#.#..### #.#.#.#.# #.#......#.#.# ##.#.# .##..##.###.... ........ ............#.#... .. .#....#.#.#.#.#
#. #.#.##.###.###################.#.#.##.##. #...#.#.# . ...#.#.#....## # .# #.# #.#####..#..#.#.#..#.#.#. ....#.#########################..##.#####..###.#.#.#.# #
###.##............................... .....#..#.#\.#..#####.#.#.####.... #.#=#.#........#.#.#. ..#.#....#.##.#.#........  .... ....... ...#..# #...#.#..#.#.. #.#.#
#..... #.#.#.##.#.##.###.#.#.# #.#.#.#.## #..#.  #.#.#.. .#.#.#....# #.#.#.#.#..##.#.##.#.#..#.#.# ##.## .# #..#.###############.####.##.#  #.##.##...#.#.#.##.##.#
#######.#.#.##.#.##.##.##.#.#.#.#.#.#.#.##.# #####.#.#### ###.#.###.#.#.##.#.#.#.##.##.#..#.#..#.# .#.. #....#.#.#........ .... .#..# #.#.# .. ....#.#.... .......#
# ... .. .......=........................ . ...  ............ .... ........ ...   ..... #.# .#.# #.## ###.#.# .#.#.####.########.##.#.#.#.. ####.##. .# ##.#.#.##.#
#.## ####.#.##.##.## ##.##.#.## ###.## #.##.#.#.##.##.##.## ##.#.#.#.#.#.#.#####.##.#.#.#.#.##.#.#.#..... #. # #..#...#.#.   .... ..#.#. ##.#.. . .#.#.##.#.#.#.# #
###=#....#...#.#...#.#.#.##.#.###.###.#.#.##.#.##.##.##.#.##.##.#.#.#.#.##.... #.#.#. #.#.#.#..# #.#.#.## # #..#.#..###.###.##.# ###.##.#.#.# ##.### ...........#.#
#....# #.####..##.#..#. .....  .  ............. ............. .. . ........#.##..#..#.#.#.#..### #.##..#..#..#.#.##.#......#.# #.... .....#..#.#.#...###.####.# #.#
###.#. #.....#..#.##..#####.##.##.#.#.#.#.###.#.####.## ####.# ###.#.# #.#.#...#.#.##.##..#.# ...#. .# ##..###.# .# #.#.#.#..#.#.##.##.###..#..# ###.#...#..#.#.#.#
#.#.####.## #..# ..#.#.. .#...#.##. .#.#.# .#.#....#.#.#....#.#.. .#..#.#. .####.#.  .. #.#.####.#.##...#.#. ..#.##.### #.##.# # #.#.#.#..#. #.#...#..##.##.##.#..#
# .......#.#.#.##.#...### #.##...=#.#....##.##.####. #.#.#.#..#.## #.#...#.#.....# ##.# # # ...#.#...# #...###.# #.. .. #..#.#.#.#  .. .#.#.##.#.#.#.#.... .....#.#
## #.#.# #.... .#..#.#... #.###.##...###. .........#.#.#..#.#..#.#.# .#.#. .## #.##.# ##..#.##.#.#.#.#..#.## #.#. #.###.####.##..##.##.#..#... #.#.#.#.#.####.##. #
## #.#.#.#.#.#.#..##..###..# ## #.#.## #.#.##.##.#.#.#.#.#..# #....#.#. .#.#.#.#. .. ...#.# .#.#.#.#.#.#. #..# #.#.#..# .. ....#. #.#...#.# #.#..##..#.#=#......#.#
#.#.#.##.#.#.#..#.#..#....#.. ... ........## # ##.##.#.#.##.#.#.## # .#.##...#.#.#.#.##.#.#.##.#.# ##.#.#.##.##..#.#.#..##.#.#.#.#.#.####.#. #.# ..#. ##. #.#.# #.#
#........ #.##.#...#. ###.# # #.## ##.##.#  ....... .#.#....#.#.#..#.##.#..#.#.#.#..#.# #.#.#..#.#  .. .#......#.#.#..#.#.#..#.#. ... ....#.#.. .##..#.. # .#..##.#
## #.# #.#  . .## #..##.#.##.#.#.# # #.#..##########.#.#.#.#..#..#.#.#=.##.#.#.#.#.#..#.#.#.##.#.# ###.#. ##.##..#...#. #.####.#.######### .#### #.#.###.=#.#.#.  #
#.#.#.##..####. #..#. .... . ... ... ..#.#. ...... ..#.#.##.#.#.# .#. #..#..# #.#.# #.### #..# #.#.#.##.#.#..###. ##.##.# .. ..#. ........# ...#.#.#...#.## # ###.#
# #.#....# .. .##.#..##.#.##.##.#.#.#.# .#.#.###.# #.#.#... #.#..#.#.#  #. #. ..  ...... .#.#..#.#.#....#..#  ##.#.......###.#.# ####.#.##..###.##.#.##. #..#...#.#
#.# .#.# ##.##.#.#.#.#.#.##.#.##.#.#.#.# #.###.##.# .#.#.#.##.#.##.#..#..#..#.#.##.##.###.# .#.#.#..###.#.#..#...#.#.##.#..#.#.#.#....#...# . .....#.. #.###.###..#
#.#.#.##..#..#.....# #...................#......=..#.#.# #.#..# #..#.#..#..# #.#.#. #.#.#.#.#..#.#.#......##..##..#.#.##.#.## #.#.####.####.##.#.#.#.# # ....  .#.#
#...#....#..#..####...########.##.######. #########.## #.##.# .#.###..#.##.#.....#.#. ..#.#..# #.#..#.###..#.#.#.#.........   ........... ..#.#.#.#..#.#.####.#.# #
#.#.####..# ##.#...#.# ......# ...#....#.#=.... . ......... ..# .. ..#...# .####.##.#####.#.##.#.#.#..  #.#....#..#.#.#.#.#####.#.###.## ##.... . .#..##.#...#.#..#
#. ..  # #.#.# #.#.#.#######.#####.#.##..#.##################.#.##.#.##.#..#...  ... ..  . .#=.#.#..#.##.. #.#.# #.#.##.#.#....#..#...##.#..######## #.. #.##...#.#
#.##.##.. ...#.#. .#............... ...#.#....... .... .....# #  #.#..#..#.#.##.#.##.######.##.#.# #....#.#.#.##.#..... #..# #..#..## ....#.#..... ...####.#.# ##.#
#.#.#..#.# # #.#.###.#.###.#.#.###.##.#..#.##.#.#.#.#.#.#.#.#.#.#. #.#..##.#.#.#.##.#.....#..#.# #.## ##. #..... #.##.#.#.#..#.#..# ..##.#..# #.##.# #............#
# #.#.#..#.#.#.# .....##.#.##.##.#.#.#.#.###.#.#.#.#.#.#.# ## ##.##   #.#..# #.......#.#### #..#.## ###.#.####### ##.#.#.#.###.###.###.##.#.##.##.#.#.###########.#
#.#....#.## #..# #.# #...#.... ..#.#.#.#..... ................... .#.##..#.# # ######..#.. ..#.#. ...............   .. ........ ............... ..  .. ... .... ..#
#..##.#......#.##.#...##.# ####.#..#.#.#.### #.###.#.#.##.#.####.##. #..#..#.#.#. ...#..#.#.#..# ################.#.#.##.##.#.#.#.####.#.#.###.#.##.###.###########
#.#.#.##.##.#..  ..#.#. ...# ....#.#.....# .#.##.#.#.#..#.#.#..#.#.#..#. #.#.#  ## ###.#.##..# #.#... .. .... ...# #  ...#..#.##.#... #.#.#...#.#.#.#..#.... .....#
#. . ....#.. # ##.#..#.###.##.#.#.  #.##..#.#...  .#.#.#....#.#..#.#.#..#..#.#.#  ... .#... #..#..############# ##.### ##.##.#.#.###.##.#..#.#..#.# #.#..###.####.#
########.#### #.##.##.##.##.##.#.###.#.# ##.#######.#.#.##.##.####.##.#.## ###.#######.#####.### #............... .=.......=..... ...  . .#..##.#.#. ..#.#..#.....#
#....... .  . ...   ....... ... ..............  ... ... .. ..............   .. .................. #.# # ##.#.#.#.##.##.#.## #.#.###.# #.#..# .# #.#.#.#..##.#######
##########.##########.#### ##### ##.#.## ###.#.#.#.##.##########.##.##.##.##.##.#####.##.##.#.##.#..##.##.#.# .# # #..#.#.##.#.#..###.##. #..#..#.#.##.#. .. . ...#
#..........#.........#...#.#.....#..##.#.# ##.#.#.#.##.  ... ...#.# .#..#.#.#..#. ...#.#.#.#.##..##  .....#..# #.# # #. ...# #.. #. ....#.##.##.#.##.#.#.##.#.##.##
####.## ##..######## #.###. ####..#....#. ..#.#.#.#....#.#.##.#.#.#.#..# .# .#.# ###.#.#.  ..  #..####.#### # # ##.# ####.##.###.########. ........ ...#.#.#.# .#.#
#....#.#.#.#.. . .=.... ...#.....#..#.#..#.#..#.#..#.#.##.##.#.## ##.# .#.#.#..#...#.#.#.### ##..#....... ....... ... ........... ....  ..##.#.##.#####..#....#...#
#.##...#.#.##.#.#.##.#.#.# #.#.#..##.#.#..#.# #.# #.#.............. .# #..# .# #.#.#.#.#.#.##.##.#.#.#.# ####.######.#.#.#.###.######.# # .###.#.#.....#.###.##.###
###.####.#..##.#.##.##.#.# .#.##.#.......#........#..#.#.##.##.##.###...# #.#..#.#.#.#.#.......#.#.##.#.#...  #....##.#..#.#..#.....#..##.#   .#..### #... .......#
#..........# .  . .....#.#.#  ...#### ## # #.#.## #.#...#.#.#.#..#...#.# .#.##.##.## #.#.######..# .. #.#.###..# #..# .#.#..#..#.#.#..#. ..#####.##.#.##.###.####.#
##.#.###.#..#.##.##.##.# #.# ###.....#.# ##.#.#.#.  .#.#.. .#.##.##.##..#.. ..... ...#.#. . . .#..#####.### ###.##.##.#.#.### #.##.##..##.#... .....  ...#......#.#
#.#.##.#.#.#.#.#.#..#..#.#.#.#.#.#.##..#........#.#.#. #.##.#..........#..#.####.##.# .#.####### #...... .. .   ........ ...... . ....#.#..##.#.# ##.#.# .##.####.#
#.#....#.#.#...#. #..# #.#.#...#.##.##.#.########.##.#.##.## #########..#.#.....# #..#.#.#..=....# ##.##.#.##.##.###.#.###.## #.##.##.. #.#...#.#.#..#.#.#...#.. .#
#.#### ##..#.#.#.#..## #.#.#.###...... #.. ........... ........... ..#.#..# #.##..# #..#.# #.###.###.##.#.##.#.###.##.## ##.##.#.###.####.####.# #.##.##.#### #####
#... ....#.##..#..#.#..#.#.#.#.. #######.##.#.##.#.#.#####.#####.#.##...#.#.#...#.# .#.#..##...#....... .................. .. ......  ............. ............ .#
# ###.###  ..#.# #.. #.#.#..#.##.#. ... .#.#.#.##.#........#....#.##.#.#=.#.#####.#.##.#.#  .## .##.# ##.#.##.#.###.##.##.##.## #.#.#.####.#.# #.##.#.# #.#.#.#.# #
#.#.#.. .# #.#.#. #.# .#.#.#.... .###.##.# #.# ....#.#.# #..# #.#.#... .#.#. .....#.#..#..##.###.#.#.# #.#.# # #... # ## #.## ##.#.#..#. ..#.##..# #.# .#.##.#.#.##
#.#.#####.#.##.###.# ##.#.# ####.#.. #.#.#.#.#.##.#.#.#.#.##.##.#.####.#.# #######.#.#.# #....##.#.....#.#...#. #.#.................#.##.#.#...#..... #.# . ......#
#............ .. ......... .......#.##.#.#.#.........................#..... . ... . ...#.###.#...##.##.###.###.#.#.################# #.##.#.###..#####.#..###.##.##
#################.#### ##.#.##.#.#.......#.#.##.#.###.#.#.#.#.#.###.#. ##.##.#.#.##.##.#...#.#.#..#..#........ . ........ ..... . . ...... ....#... ....#.#...#.# #
#.................#..#.#.#... .#.#######.#.#.#.#. #..#.#.#.#.#.#..##.#.# ##.#.#.## ##.##.##.#.#..#.##..#.#.###.#.##.######.########.##.##.#.#.#..##.##.#  .####.#.#
##.#.##.####.####. #.#.#..#.##.#.. ....# #.#.#.####.##.# #.#.#.#.#. ...# ... . .... ...........# ....#.#.#...#.## .#.  ....#......#.#.## #.#.# #.# ##.#.#.#. .....#
#.#.#... ..#.#..#.# .#.#.#..#..#.#.##.#..#.#.#.  .... .#.......#. #.##.# #.##.###.#.#.##.##.#.#..#.#.#..##.###...#.#######.#.######.#...............=.#.#.# #.#.# #
# #.########.#.#..##.#.# ### ##..## .#.#.#.#.#.#########.#######.# #.#..#.#.#.#..#...#...#.#.#.#.#.#.#.#...#...##.... .....#... ....#.##.##.#.##.##.##..# ##.#.##.#
#.... .......#. #..#.#  ...... # ..#...#.#........ .... .  . . ..... ..##=#.#.#.##.#.###.#... ...#.##..#.#.#.#.#.#.#######.#.##.###.# #..#...# #..#..##.#....= ...#
## ##### ###.#.#. #  #.#.##.###..##..#.#..####.#.#.###.###.###.#.#####.#..#.#.#.... .. .. ## #.# #. .# ##.# #..# #.#.......#.  #..#.#..#.##.#..#.#..#...#.####.####
#.#....# #.# ...#..#.#..#.#....#.#.#.#.#.## .#..#.#..#.#.....#.#.#.. #.##.#.#..#.###.### #.###.#.#.##... ..  #.#.#..####.# .#.#..#..#.## .#.##.# ###.##.# #. #....#
#.#.##.#.#.#.##.#.#..#.#..#.###....#.#.#...#..### ##.##.######.###.##...# #.#.#....#.#...#.....# #.#.#.#######.#.#.#... .#.##.## ##.###.##.#.#.#........#.#.#..#.##
#.#..# #.#.#.#..# .#.#..#.#... #.##..#.#.#.#.#............ ..........#.#..#.#..#.#.#..##.#.#.# #.# ..#.#.. ....#....#.##.# .......#............#.# #.#.#..#..#.##.#
#.#.#.#.##.##.## ###.####.#####.#.##.##.#.##.#########.##############.#.#.#.###.#.#.##.##.#.#.##..#### ######## ## #.##.#.########.############.#.# #.#.#.#.#.... #
#  ... .............................. ...  ....... ......... ............  . ...  ...............#.. .... .. ..................... .. ..  . ..... . ... ..#..#.## #
##.#####.####.##.## #.###.######.####.# #.##.# ####### #.##.##########.##.#.##.###.#.# ##.##.###..#######################################################.#.##. # #
#.#... #.#..#. .# #.##..#.#....# #..#.#.# ..#.#... ..#..#.#.#...... ...#..#.# ##.##.# #.# .#.#.#.#....  ... ... .. ....... ....... ............ ..........#.  .##.#
#.#### ###.#.####.##.#.#.#.##.# #.#.##.#.####.######.####.# ##.##.####..#.#.......... ..#.#  #. ..#.#.#####.############.#.#.###########.####### ##.#.#.#..#.#.#..#
#.......... ..... ..... . ...... ..... ..... . ... ..........#..#..  # #.=#.##.## #.##.#...#.#.#.#..#................ .#.# #.#...........#. .....#..#.# #.#..#..#.#
###################################################################################################################################################################
