###########################
#     #.#.#  ##.# # #.#.. #
#.###.# # .#    .   . #.###
# # #.# # #..##.##.###  # #
#   #=#.# .#.#    #=  # # #
#####.# #.##.#### # # #=#.#
#. . .#.#      .## ##.# #.#
## ##.# # # ##.# .. .o ...#
## .# # # # #.# # #### ####
# .#  ....#...# #.. .#.. .#
## ## #####.###.# ###. ## #
#...# # o   #     # .#.#..#
##.#  # ###.##### ## # ####
#  .# #.#   ..       #    #
##### ## # ## ###\###  ####
# .  .o.. # . #.  . .#.   #
# ### # #.# #. ## ## #.#.##
### ## ##.## ## ##.### #  #
# .. .= .   ..     . ..#.##
#### # ###.##### ##### #  #
#. %# #. . .  .   .... # ##
### # #### ## # ## #.#.#  #
#   .  .    # #o#.# #..# ##
#.## #.### # .#...   # #. #
##.#.# # .. #.# ### #. ####
# .. # # # #. #.  #. #.  .#
###########################
