##############
#  #.#.#.  #o#
##      ##  .#
#.##.#.#.#.#.#
# ..o#.\  . ##
# ###.## #.# #
##..# #.##o  #
## ##.o.#.##.#
#. ...# . ...#
#####. # ## ##
#.. ..#.#.#  #
#.# # . ..#%##
#=# .##.#=#==#
##############
