############################
## #.# #.  #o#.##o## # # ###
#  # # ## #    .  .  ..#  ##
##=#       # # # # #.# #.# #
## # ### ### ## # # ##.# # #
# .    o     .     .    =  #
#.## ## ###.## # #.#.# #=# #
# # # #  ..#.\   # #  #    #
# .  .# ## # # # # # ## ##.#
# #.# # # ## # # .  .#     #
#  #.   .   . .  #%# ## ## #
# #  ## ##.# ###  o#.   .  #
# =# .. #  .    .##..# # # #
############################
