#############
#=.    =  =.#
# # # # # # #
#.#o#.#.# # #
# ###.# #.#\#
#  .. # #o# #
##.##.# # ###
## #  # #  .#
#  ## #.# # #
## .# #.#.#=#
## #  #%# #.#
#   #.# #o#o#
#############
