####################################
#  .   ..      . #     .# # #  .   #
## ############# # # ###  #  # ## ##
##.       = . o# # ##.. # # #  #. .#
#  ####### ####  #.  # ## # ### # ##
###     . # .  #  ## # # o#    .   #
# ######.##.#### #      #.# # # ##.#
#       . .. .   #.# # #  # ## # ###
# #.### # # ## # # #.#. #          #
## #   #.###=#.#  ## #### ##########
#   # ## ## .# # #=   .            #
## # ...  .# # # # # # ## # # ## # #
#.. # ## ##  # # #o## # # # #.# # ##
##.# # # # # # # #.   # #.# #.    .#
## #    =    # # # ####.# # # #.## #
#  .# # # ## #.# #    . # # # #. # #
## # # #.# # # ## ####### ## # ## ##
#     .  ..# # .   .       .     . #
## #.# # ##  # ############ ###### #
#. # ## # ##%# #      ...   #..  . #
##.#       # #  #.## ## # # # #### #
# .########  # ## # #  # ##.# #  #.#
##     . . # # # ##\# ## #  # # #  #
##.######### # #     . . .# # #.## #
#  =.  .   ..   ## ## ###.# #=   # #
### #.## # # # # . #    # # #.## # #
#   #  ## # # .# #  # ##  # # .#.#.#
###.# #      # # #.#  # # # ### # ##
#.# # # # # ## # #  #   # #     .. #
# #.#.##.## #  ### #.### #. ########
#.# #. . . . # .       .  # .  =  .#
#.# #.## # #.# ############ ########
# # # #.## # # #  .  .        .  . #
#.  # # o  # #  ## # ### ##.########
#.#.#. # # # # #   #   # .#     .  #
####################################
