###############
##..#..#.. .#.#
#.#.=.#..##...#
#..##..o##.#.##
##..#.#.....#.#
###..### ##. .#
##=#..#.##..#.#
#...#...#..#. #
#.#%..#.#.#.#.#
# .#.##.o## #\#
#=# . .#.  .o.#
##..## ..## ###
#..##. #o.##..#
#.#.=.###....##
###############
