################################################################################################################################################
# # #.#.#.# # # #.#.# #. ..#.# #.# .# ##.#.#.#.#.#.# #  .  .  . . ..    ...   .... .. .#..# ## #.# .#.# # ##.##.## ##.# .#.##.## #.# #.# # # # #
#. .. .. . .. #.# #... .# #..#.# #.# . .......     #.##### # #######.# ##.## ###.# ### #.#   . #. # #  ... .  .. ... ..#.....   . .. ......   .#
#.##.## #######.# #####.## # #.  ..## ####.###.###.#.... . #.  ....# # # .#.#  .#... # #..## #.# #. #.# ##.# # ## #####. ##.## ### ### ### ## ##
## .# # #  ..  .#..  ...    .. # #. #.#...#. # #.# # ##.#.#  #.# ##..#. #.#.#.#. # #.# #.# #.#.#  # #..#  #.#  .#.#. . #.#.#.#.#. .#.#.#  #..# #
# .#. #. ######.  # ### ######.#.#.#..# #.##.#.# ..# # ##. #. # ##.# ###. # ###.# # #. # #.# # #.#. #.# .#.. # ##.#.#.#  # #    ## # #.#.##.## #
##..# #.#  .    #.# #. #. . .#.# #. #.#..   .# ##### #   .#. #. .       #   ..  .... # # # . # #  #.#. #  #.# ## .#.#..#.#.#####.### # #.# .  .#
#. #. #. #.# ##. .#. # .#.##.#.# #.# ...#.### .....   ####.##.#########.# ###### ## #..#..## #.# ## #.#. ##. .. #.#.#.#. #  ....  . .#.# .#.####
## ## #.#.#.# #.## ###.## # ## #.#  # ##  #. # ##### #.    . ... . .... . #.. ...# #.#.# # # # # #. # .# #  ## #..# #. # # ## ###### #.# ## ...#
#...#.#.#   ..# #. .   ... ....#.#.#..#.#..# # #....  #.####.##.####=## #.#.# ## #. .  # #. .#.#. #.#.#.. #. ## #.#.#.## # #    .... #.# # .#.##
##.## #.# ####. ######.#.## ## # # .# # # #. # #.#.#.#  #.   #.#...# # #. #.#. #.#.#.# #.#####.#.#. #. #.#. # ..#.# # #   ..#.##.#.# # # ## ## #
#...  #.  . ..#  ....# #.#.# # #.#.# .#  .## #.## #  ###.#####.#.##.## ###.# ##.# # #  #   .   .  # #.##  #. ##.#.# #  # #.# ##.#.# .# #   . # #
#.#.# # ## # #..####.#.#.# . ..#.#. # #.#. #.# ..  #   .. .  ..   ...  ..  . .. .. . #  #### ###.## # #  ## # # # #.#.#  #...     .#.#.#.##.#  #
## #  # . # #.#.#. # # ##.#### #.#.#  #...# . .### # ####.# ## ##.##.#.# ##.# ## ##.#..#.. #  .# #  #.##.#. #. .#.# #  #.# ######## ## # ..o # #
#.. #.# # . .  .#.# =#.     .#.# # .# ..# # ## #  ## # . #.# ### # ## #.## # #.#.# # # .# #..# #..# #  # .# .##.#.# #.# .#. ... .. .... .## #..#
## ## #.###.###.  .#.#.##.## #.## .#  #.# .# #. #.#...## #..   ..   ..   ..... # # #.#.##.### # .## #.## ## #.#.### ## # #.### #.# # #.#. #  # #
#.     .  #.#.#.#.## #.# #.# #  .#..#.# #.#. ..#=.##.#.. .#####.#.# #.## ##.## # #.# # ..     .#.#..# .  . .   ...  . .# #.#..#  .# #  ## # # .#
#### ##.##.## #..## ## # # #.# ##  #.. ## # ##.##. #.#.#.#  .. # # # ## #  #.#.# #.#.#.#.#.# ##.  #.#.#.# ## ##.#.# ###  .# #.##### ## .  #..#.#
#   # # #  ..  .# .. ..# #.#.#  .#.##.# ...#.#. # #. ##.. # ##.#..  .  .#.#. # # #.#.#.##.#.#..# ## # ##.# ### # #.#...# #...  ........## #.#..#
### #.# .#.# ##.# #### #.#.#.# ##.  #..## #  # #  ##.. # #.. # ###.######.##.# .##.# #. ..#.#.## #..#. . . . ....... # #  ######.##### .###. #.#
# ..#.#.## # #  #.#.   # ..#.#..## ##.# #.## #.##..#.#.#. ####. .    ...... .#.#.    # #.#  . . . # # ##.#.#.###.# # #.# #     .     # # ...#..#
### #.#.# #.#.#.# #### #.###.#.#.. #..# ...#.# .# # .##..# ... # ##.##.##.#.# . ## ##. ## # #### ## # #.## ###.## ##.###.### ######## #.### ##.#
# .. .  .   . ..#. . # #. .. #. ## ## # # # .#.##..# ..# # ###..#.#.# ##.#. ##.# ..# #.... ..  . .. .   .. . .   .  ..      . ..  ...  . . .  .#
#.##.# ## #.#.# #.# ## ##.## #.#. ..# # #. #.# #..##.##. # #  .#  ..#     #. # ###.# #.#.##.### #.#.#####.#.# ####.#.#.##.#####.################
###.# #.##.# ##.###.# #.##.###. ##.##.# #.#  # ##.#  #.# # #.# .#.# .###.## # .. # # #.# #..#.##.# # . . #.## .  #.# ##  #.. . .#.  .  . .   ..#
#    .. .. ..  ...  .  .... .  #.  #.   ..## #..#.## #.  ##.##.# #.###.#.# #.# # # # # # .# #..#.. # #.##  #  #.# .#.. #.###### # ##############
########.#####################. ##.## ###   .# #. . .#.#.  ..  . .. . .  .   # ..#.#.#.# ## #.## ###.##.## ### #.###.#.#..   .#.. .. .....   . #
#..... . .   ... .   ..   ...# # #..#.#.#.####..## # ## .#### # ## ###.## #.#..#.. #.# # # ##.# .. ..  ... .    . . .# # ######.# ####.###.#.# #
#.#.#.##.### # ### # # #### #  #.# # .# #.# .  #  #. . #.    # #. #. #.# .#. # .## #.# #.#..  # #.##.## ### # ## ###.#.#....  ..#.#. ..  . # #.#
##.# #.# #..#  #.###.#.#. ...#.# #. #.# #. ### ##. #.##. ## ##.##.# #.#.## ## .# #. .#  # ###.##.## #.###.##.## ## #.### ######## ######### # ##
#...    . #.## #  ...#.#.## #. # # #. #.#.# ....#.#  . # .# #.   . ..  .  .. #.#.#.#.#.#.  ... .....  . ..  . .. .....   . ....   ... . . ... .#
#.#### #.#.   . ##.#.#.# .#..# #....#.#.#.#.##.#.. #.#.# #.. #.##############.   # # # #############.# #.### # ##.##.# # #.#.# #.##.###.#.##.# #
#.#   .# .######.##.##.### ## .# # #..#.# # .#  # #  #.#. #.# . .............# # #  .#..  ......  .#.# # #..#.# ## #.#.  ##.# #.# #.. ## #.# #.#
#  #####.# ... ..  .   .   . # #.# .#  .# # #  #. ##.#.#.# # #.###############.# # ##. ### ###.### #. # #.#  ..    #  .#..#.. #.#.#.#.. . .# #.#
# # ..  .# ########### #####.#.#.# #..# #.# .#. # .#.##. # ........ .. .. ... .#.#.# #.#.#.#   #.. # # .....## ### # #.# ##.###.#.# .##### # # #
#.#.#.## # # . . .. .#.   .# # # #  #.# # # # .#..#    # .###.#.# #.#.### #### # #.#...# ##.###.###.#.#####.#.## ## # ## .. . . #.# # ...    #.#
#..  #.. # # #.## #.#. #.##. #.# # ## #.#.# ##. #.## ## .# .#. #  .#.#  # ...# # #.### #. . .  ..... ...   .....    =.. .######## ## #######.#.#
# ## # #  ## .# #.##.#  #.##.#.# #.# .# #.##.#.# .. .#.# #.## ## #.# ##.#.##.#.#. ...#..## ##.###########.##.#.# ###.# #.# .. .... ...... .. #.#
#.##.##  #.. #. #  . # #..  .#..##. #.#  .   ..## ##.#.# #.#. #  ..# .# # # .#.#.#.##. # .  #. ... ..  .# ## # .# .#.#.#..#.#.## ##.## # #.# #.#
# ..  .# ..#. #.#.####.#####.#.#. .#. ###### # .##.#. .#.# ###.###.# ## ## ##  ### # # .###.#.#######.##  .  # ##.# #.#. # #.#.#  # #.# # #  ..#
#.###.##.# # ## # #. ...   #.# .##  #.  . .. #.#.   .#.#..   ..    .. ...    #. .... # #... . #....   #.#.# ##... .   .# # .  .. ##.#  .. ##.# #
# # . # .#.#.#.  . #.#.####. # #.# ##.#####.# #.####.# # ## # # ##.# # ## # #..## ## #.# ##.# .###.##...#.# .. ### ## #. .#.##.# #...#.##  #.. #
#  ## .#.#.#.#### #.##.#.  #.# #..... .    .   .. .  ###.#.#.# # ##.#.#.##.#.# # ##.##.##.##.###.## #### #.##### ###.# # # ##.#.# ###.# #.# ####
# # . #. # #    #.#  ..# #.# #..###.##.##.##### ##.#.  .. . .. .  ..  .....   . .  ..   ..  .... .  .. .... ...  ... .... .  .    .  ... .   . #
#.#.#.## # #.####  ###.#.# # #.#.  .#..#..#... # #.# ##.##.####### # ##### ### #.## #### # #.#.##.#.# # # ##### ####.## ##.##### ####.##.#### ##
#  ## .#.# # # ...#    # .## #.# ##  #..#..#.### ##. # #. #..  ...# #  .... ...  # #...   # #. #..# ..#.# #. .#.#.. #..# # .  .#. . .# .# . # .#
# #...# .# # .#.#.# ##.#.#.. #.##.###  #  ## . .. .# # ## #.#### ##.#####.##### ## # ###### ###.## ### #. .##.# ###.## # # ###.# ###.##.###.# ##
#..##. #.# # #.# .#. # #..##.# .     #  #.#..#### #. #  #.# #  .. .... .  ...... .. . ..  .....   . . . # #.# #..........#.# . #....      # # ##
#### ## # ##.# ## #.# ## ## ## #.## #. #.. #.#..#..#.#.##.##.###.# #.##.### # # ## #######.##.#.##.#.###..#.# ########### #.##.########## # ##.#
# . ........ ..   .. ..  .  .. ## ##.## ####.#.# ##..#.   .   ...# #.#.#  ... #  # . .. ...#.#.#  .#. . # . #  .   . . ... ..  .. ...   .....  #
# # ##.# ####.##.# ## ## ##.## ....  .. . ... ..   # .#.## # #.#. #.## #######.##.# ######.. #.#.#.# ## # ##. #.##.######### ##.##.## #######.##
## # ..# #  .# ##.#.## ###.# #.##.###### ###########.#.## # # #. # .... ..    .. .. .  .   ##  # # # #.# .  #. #.# # .....      #.# #.#... . #.#
#. ###.# # #.   .  ... ..   .  .#.#......  ..  . ....  .   . . # # ###.################### # #.# # #    # ### # .. #.## #.## ## #.#. .# ##.#   #
##.   .  # .### ##.##.##.#####.#.# .# ##.##.##.#.#.# ## # ##.# #.. ..# #...   ... ....   #.# ..# # #.#.#. #.  .### ### # ## #.###.#####.#.#.## #
#  #### #. #  .#..#.##.#.#  .#. ..#.##.# #  #.#  # #.#.#.#.#.# # # ## .#.## ###.#.######.# .##.##.#  ##.#. ## #    ...  .. .. .  .. ....o ...  #
##. .....#. ## ## #   ...### #.# #  .# #  ### # #. # #...  # # # #.  #.###..  # #.  .  # #.#.# . ..#  ..# # #..#.# #.# #.## # ### ##.### # #.###
# .# # #.#.#     .######   . # ## #.# .#.#    . .#.=. ## ##  #.#.#.###.  .# ##.#  ###.## #.#.# #### ####..# # # #  # ## ## # ##.## ### ##.# ## #
##  # # ## ### ##  ....# # ## ... #..#.# .##.## ## # #.  ..#.# #...#. .#.#..  ..#. .#.#..#.   ..  ......# #.#.#.## #..  .  ... ..... . .    ...#
# .#.... .  .##.#.#####.#.## # # ##.# .#.#  ..#.#  #..##.## .# # # #.#.# .#.##.## #.# .#.#.#.## ### ## # . .#   .# # ## ## ###.### # # ## # #.##
##. # ## #.#.  . ...  .   .. ..#.# ..# #  #####..#.# # ... #.# # #.#.# ### # ###=# #.### # ##.### ## ##.# ##. ####.# #  #. #.# #.## #.#.#.#.##.#
#  #  .# #  ##.## ## ##.### ##.##.# ## #.# . . .#. #..##.# #  .# #.# #.  . .... ...   .. #... .   ...  .#.#.# #  . # ##..# #. .#... . # #.#....#
## .##.#.#.# #..#..#..#.# ###..   # # .# .### #. # #.# #.##.####.## #.################### ##############. # # # ##.# .# #.## ###.######.##..# ##
#. #... .# # #.#  ##.#. . . .# # # .## #.#  # # # ##. ... . . .. . ....   .   . .. .    .    . . .. . . #.  #.#..# # ##.. .  ..   .   . ..#.# .#
##.#####.#.# #.##.#. ######.#..# .#.  .#.#.##.#.#. . # #.# # # #.#.# #.###.#.## #.##.## #.##.# # # #.#.#. ## .#.# .#.  .##.# ##.# # ##.# #..# ##
##..  .# #.# #. # .#...... ..# #.#  #.#  #. ..# . ##.##.#.#.# # #.# #.## ## ##.# ## ## #.#.## #.# #.#.#.## ## ##.##.# ###.# # ##.# # ## #.## # #
#. ###.# # #.#.#  #  ######## .# .# ## # .# # #.## # .. . .  .. .   .... .  .  .   ... . ..   . ..   .. ....  .. .  . ... . ...  .  ... . .   .#
##.# # #.#.# #.##. # ...  .. # #.#  .  # # # #... .# ## #.# #.#.#.##.# #.##.##.########### ########### ## #### ##.# #.#.#####.# ##.### ## # #.##
##.#. .#.# # #  #.#  # # #.##. # .#.###.   .  # ###. #.# # #.#.# ## # #.## #  #   .  .=.. ..    . ....#..#. .. .## ##.. #.. . #.# # .#  .# #.# #
# ..##.#.#.# . #   #  #.# ##.# .###.#. #.##.#.#.# ##. .  . . .    . .....   #.#.## #.#.# #.# ## #.#.#. #.#.# #.#....  # #.# #  ##.##.#.# ..  ..#
##.# . #.#..## ## # .#. ... ...#  ..#.# .#.# ##.#. . ################## #.##...## # #.#.#.## #.# #.# .## ## # # ## ###. .##.#.#. . # #.#.### #.#
#. #### #  #....# .#..### #.##.#### # ## # ...  # ##.# .... ....   . .. #...#.#  .. .  .  . .#.#....#.#......  .  . ..#.#...# .##.# .#.# #.# #.#
##      .#.. #.#. #  # .. ###... .#.#  ...##### ### .################### ####.################.###.## ##.############# ..## #.#.#  #.# # # #.#.#
#..#### #..# #. # ## #### .. # #### ##.#.#. ..#  . #  . . .  .   .        . .. ..    .     ....       .. . .. .  . ...#.#.##  #.# #. # # #.# #.#
##.#... ## #  .#.#.  ...#.##.# #...  # # .###.#.#.## ##.#.####.#.###.# # #############.#######.######.###.# #.## #.###...  .#. .# .# #.#.# #.# #
#. # #.#   # #.... #.####.#  #.#.##.## # #. ..#.# # .#.. .#.. .#. ..#.##.#     .. .... . .   # # .. .#. #.# # #.#.#...#.###.#.### #. #.# . #.# #
##.### ###..# ######.#.... # # #.#.=#  #. #.# # # .#..## # ####.##### #.#.#### ###########.## #.#.####.# #.# ## #.###.#.#.# # # . .#.#.# ###.# #
# . .. .  .#. ...     #####.## #  # .#.#.#.##.# ###  # .    .  ...   .  . ... ..    . ...  . .. .. ...   . . .. .. .  . # ###..##.#. # # # ..#.#
# # # # ##. # ###.## #.    .   # #. # .#. ..  . ...#..#.#.#.#.##.#.###.#.#.#########.######### ### ##.#.#### # #.### ##.#.   .# #.## #.# #.#\#.#
#. #.# #.#.# #..# #   ### #.##.#. #..#.# #### ##.##. #..  ##.#.##.##. # ##   .    .#.#   . .  # .  # .# #   #.  ##= #.# .##.# # .  # # # ## .# #
# #  .   #.#..#.#  # # .#.# .#.#.#..# #..   # .#.#.#.#.### # #. ..  # # .. ########.  ##.#.##  ###. #.# # #..#.#.. ##.#.#  #. # #.# .# # . #.# #
# .# # # # #.##...##.##.# ###  # ##    #.#.# .#  # # #..   #.# #.## #  # #...  ... # #..#...#.# .  # .# .## ##. ##.# .#..#..# #.#. #.#.# # #.# #
# # ## # # # ...#.#  .. . ...#.#..# ## # .# #.##.#.. #.##### # ### ##.# # ##########. #  # # . # #  # # #. .  .#....#.# #  ##.#.# ##.# #.# #.#.#
#.#... # # #### #  #.## ### #. # #. #.  .#.   .#..## #  .  .      .. . . .. ..  .... #..#...#.# #.## .#  ## ##..## ##.#  #.#  #.#.#. #.#.#.# #.#
#..### #.#  .   # #. # ## ## #  #.# ####.######.## # #.## #.# ##.######.######.## ##  #..# # .... ..#.# # # .# #.. .  # # . # # #. #.# #.## .###
# #....#.# # #.#  ##....  ...#.#... ..... ..  .... . #..#.#.##.# #... .#.  ... # # #.#. # ..#.# ## #. # # # #. .## ##.#.##.#  #.#.##.# #   # . #
#. # # # # #.##.#..#.######## . ##.#.###.## #.# ####.### #.. ..#. ##.# .#.# ## ....#..#..# #.. ##.# #.#.#.# .# #...# .# .#. #.# # #. #.# ##..###
#.# #  #.#. .. .#.#    .    .# # ##.##.# # #. .# . #..    # # ##.# . # # .#..#.## #. ## # . #.#   ... # #.. # . ## .# #.#. #...##  # # # ..# #.#
#   .#.#.#.#.###  .# # # ##.##.# .#.   # #..#.#. # ..# ## # #  . .#### ## ####.#.# # #   # #..#### ## #..##. #.#...#  #..#  # #. .#..# # ## .# #
#.####.#.#  #.. #.# . # ##.##. #.## ###..#.# ..#..##.# ##.#  # #.#  .   .......   .#  #.# ..#. ..#.#  # # . # . ##.####.## #. ###.##.# # #.# # #
#.#    # #.## ###. # # .=....# #. ...  #.#. # ##.# # # . .# # .# .##.#######.# ### . #. ##.# .##.#. # #.. ##.#.#   . . . .  #.     . # # #  . .#
# ## # # #.#  ..  # ..#.##.### #.# # # #.# #. # .   ..###.# .# #.#  # . . .# # #.# #. #  # ## #..# #..# #....   #.##.## ### # ######.#.# # #.###
#  # # #.#..#####. #.# ##..#.  # ## #.##.# ## ##.###.# ...#.#.#.. # ### ##.#.#.# ##..#..##. # .#.# .# #..##.##.#  .#  #...#.#.. ...#.#.# ##  # #
# # #..#.# # .  . #. . . #.#.# # ... .. .# .   # #.#.####.#... #.#....#... #.# #   #. #.#..#..#.#..# .#.#.. #  ####.##..# #.# ##.#.#.# #. .#.  #
# .. #.#.  .##.##  # ### # # #.# # # #.# # #.#.# #.# .  # #.## # .# ##.###%#.#.#.## .#  .#..#   .#.##.# #.#. # ..   . # # #.# .#.##  # #.## .# #
# #### #.#.##.# # #..# .#  # #. ..# # .#.#.##.#. #.  ####.# #.# .#. # .. ... #.# # #  #.#  ## # # . # #..## #  #######  .## #.#  . #.# # ###...#
#.#    #.#..  . #..#.## .# # # ##.#.####.   . .#  ##.#   .#    # .#. ## #.##  .#.#.  ## .# #. ##.#.# .#.#   .#   . .. # # ..# .# # #.#.#  ## ###
# ######.# ##### ###..#.##.##..# ... ....######. # ..#.## #.## # ##.#...#.#..#.#.### # .##. #    #. # #.# # #. # ## ##   ## #.#.#.#..# # # ..  #
#  . ....# #. .  .   #    ...#  ## ##.##  ..  .#..## #.#. #.#.# .# . .#.# .#.# # ..#..# #  #  ###..##.#.#.#.##  # # # #.#.#.#  .   #.# #.### #.#
# ##.##.#..####.## # #.#.# ##  #  # ###. ###.##. # # #. # # #..#.## # # # # .# # ## .## ### #  ..#.#  #..#.#.#.## #.# #.#   #.# ## # # # ..# #.#
# # #..# # .   # .## # ##   .#.#.#. . .# #    .#.#.#  ###.#.#.# . .. ..   .#.# # #.# #. . ... ###.  #.#.#  . . # .# # # .## # # .. # # # ###.. #
# #...#    # # # #   #...# ##  #  #.### . ## ## .#.# # ...#.# ##.# #########.#.# . #.#.# #.## #..# # .#  #####. # #.# # #.  # #.## # # # #  .#.#
# ###.#.## # # #  ## #.##  ..#.# ## #..# ##.# ## # #  # #.#   .# #..  . . . .#.#.# ..#.#.#  #.#.## .#.# #   .  #..# # #..####.#.#..#.#.#.# # #.#
# ..     # #.# # #.. #  .# ##  # . .#.##.# . . .. ...# #.# #### # ###########.## ####.#.# ### # # ##.# # ###### #.###.# # .  .#.###. #.#.#.# ###
# # ## ##..#  ##.###..####.#.#  ### # # . #.#.##.#.#.# ..  . . . . ... ...... . ....   .. ......... ..  .  .  . ....... .#.##   .  #.#..# ##.. #
# ###.##.#.# #..   # #  .... ..##.#.# ## # ## #. .....##### #.## ###.## ## # # ##.## ### ##### # #.#.# #.###.# ######## # # . # ### .#.# .   ###
#   ... ...#.#.#.## . ## ##### #  ..     #.... #.# #.# .  #.#.#... # . # # .# #.## ###  # ..  #.# #.# #. #.  ##.   ...#.#.# # #.# .#.#. ## #.#.#
# ##.##.## #.##. ..#.# #... .#..### ##.#..# # ## # # .###.#.#. #.## ####.###  .  .....#.# # #.#..  ... #. ###.#.##.##.# # # # #. #.#.#.## ##.# #
#..#.#..#. #.. #.#.# #.#.##.# .#..#.#. #.# .# #. # # #.  ...#.#..    .   .. #.#.## ### .# #.#. ## # #.#  # ..   # #.# #.#.#.# # # .  #.....   .#
###.# ##.#.#####.## ## ##.##.#.## ## ## # ##.#.## ##..###### # # ####.#######.##.#.#.## ## ##.##.#.##.###.##### # #.###.# #.#.# .###.#.#.# #.#.#
# .. .. . .. . . . .. . . .   .. ....   ....  . .. ..#...  .... .  . ..  .  . .  .....   ... .  . . .   .  .   ..  .... #.#.#.# #  . # # # # ###
#.# # ######################.##### ##.#.##.#.#.#.###.# ##.## ##.#.###.# #.# #.#.### #.#.# # #.# # #.####.## # # #.## ## . #.# # ####.#.#.# # . #
#.#.# # ....    ....... . ...# . ..#  ##. # # #.## # # #  #.##.#.# . # # # #.#....#   ##.#  ## #.#.# .. ##.# #.#.#.## #.# #.#.#    # # #.## ####
# ##  #.## ##.##.#.# # #.### ######.##.#.## #.#.#. #.#..# #.   # #.# # #.# # #### ###.   .#....  # .###... .. ........#  ##.##.#####.#.#  .... #
#.. #..##.# ### # #.##.#.# #. . ..... . ..  # #  # # # ##..# #.# ###.#.# #.# .....  # ##.#  # #.# .##.#.########## ####.#  ....      #.# # ##.##
#.##..#   ...  .....#. #.# ..###############. # # .# # #..# # .# ... ...   #.####### #.##.#.## #.#.# .#.# . . .....  . .############ ##.#.#.##.#
#. .#.#.#.# #######.## # #.# ..   .....    .#.# ##.#.#..#. . #. ## ### #.#.# # .... .   .  .      ..#.#  # ##.#######.#.    . .      . . .  .  #
# # # #.# #.#  ...# .# #.. # # ## # #.#.# ##  #  .. .# ##.## # # ###..# # .# ############.###.####.#..# #.#  .. ... #.# ##.# ##.# #######.# ####
##.## #.##.. ####.#.# .# ### ###.# #.#.#. # #.# #.##.#.# .# .# #.....## .# #.  . .     .# #..# ..#..#.#.#.######.#### #  # # # #   ......#.#  .#
#  .. #  .# #. . . ..### #.  ...... .   # #.#.# #.#. # .#  # #  #.##.#..#  # ######.#### ..# # # # ## # #. . ..  .. ..#.# #.## #.#########.##.##
### #.#.# # ### #.# #. .  ##.#### ## ###..# # # # ## #.## #. #.#.# # .#. # #.#   . . . .#.#. .  ## # .#.#.# ## ## # # # . ....... . .  .  ...= #
# # #.# ##.. ..#.#  # ##.# ..#..  #. #  # # #.#.#  #.# #.. #.# #.#.#.#  #  #  ### # #####. #.#.#.. .#.# #.# # #.#.## .#.## #.## #.##.#.# ## ####
#.. #.#.  # # #...#..#.# .## # ##  #..# #.# # .# ### # .#.# .#.#.#.#. # .#.# # .. ..#  . .#.#...##.# .# # ###  .#.. # # .## ## # ##.#.# #.#... #
#.# #. ### # #.# ##.## ###.#..# #.#..## #.#.# # .   ..##.#.### # #.# ##.# .#..###.# ##### .. #=#  . #.#.#... .#.#.# # # #.. ..   ... .#.#. .## #
# #.# #    .. .... .  ....  .#. #..#   .# #.#. ##.## #.   .....# . #.#   #.# # ...#.  ..#.### ..##.# .# .#### ##.##.  #  ### ## # # ## ..##.# ##
# # #.#.### ######.# ## ##.#  #.# # .###      #.#  #..## ##.##.# #.# ## #..#.# ## #.###.# #..# #  . # # #... ..   . # # #..#.# # ##.# # ##...  #
# #.#.#.#.# #  .  #.#. ..# #.#  # ##.  .# # #.# # #..#  # # #..# # #..  .#.# #.# .#..   # #.# . ##.# .# .# ## ######..#. #.# #  .#..#.#  .# #.##
#.# #.# #.# # ####.. ##.#.# . # #  # ### ..## # #..#.#.# .#..# # ### ####..#.#..#.# #.# # #..# #  ..# #.## .#  ...  # #.##.## ##.## #.# ##  #.##
#.# #.#.# # #.    # #...  .# #..  ##.. .#.#...# ..# # ..#.# ##.. . ..   .# # #.#  # ##..# #.##..## ##.#.#..##.# ##.##.#..  ..    ..... ...# #. #
#.# #.# #.# #.#####  ## ###  .### # .##.# #.#  ##.#..# ##.# #..#.##### ## .#.#..# # . #.#o#.  .#.. #..# .#.#..#. #.# .#.#######.######.####.####
# # # # #.. #.#     #. .#..# #.    # #. #.# #.#. .## #....#.## # #.   #. # # ### #.#.#.# #.###.###.## #.#...# #.##. # # # ..    #.. . ......  .#
# # # .## ###.##### ####.# ##.#####.#.##.#.## ####.#..### #..# #. ##.# .# .#. .. .   . .  ... .. . . ..   ### #  . #..#.o#######.########## # ##
#.#.#.# .   ...   ... ..  ...  ....  ..... .         # .. #.##.#.#... # ## #.###.## ## ##.# ##.#.## ### #. ...#.##..#=#.#.    . . .   ......#.##
#.# #  ###### #.#### # ##.####.##.#.#.### ##.# ## ##  ###.#.#..# ### #  .#..#...#.# #. .##.# ## #.#...#. #### ##.####.#..# #.###.## ### #.# #  #
#.#.# #. . ..# .# .#.# ..#.  #.#.##.# #..#  # #.#..# #. #.#..# # .... # #  #..#.# #. #.#  .. .. . . ##. #. . ... ...  # # ..# .#.# #  .# ##.#.##
#.# #.###### #### #.# #### ##.##.#.#.##.##.##.# #### #.## ####.######## ## ##.###.### #.############.##.############## ..#.# .#  . .#.#..  .#  #
#.#.# . ..   .  ..  ... . ..   .    .  .. .  .. .  ....  .. . .     . . ..... ...    .. .. .. .   ...    . .  .  .  . #.# ..#.#######.#####...##
# #.# ## # ##.## #.#.####### #.##.##.##.#.#.### ## # ######### ##.# #.#### # ##.# ##.#.### # # #.## ### # ## #.##.# ##  .#.#  . .... .      #. #
# # #.#.## .# # #.  #.   ..#.##.# . #.#.#.# # #.### #.....  ...# #.#.#     .# #.## ##. . .# #  ## #.# # ##..# ## # # .#.#..#.##.# # #######.# ##
# #.# #..  #.# ..#.#. ###.## .# #.###  #.# ## ## ##.######## ### # # # ### # .  .... #.###...#  #.. # # . # . .  ...#.# ##.# #. #.#.#.. . #.#. #
#.# # .#.#. ..#.#   #.. # #. #   ...  #    . . . ..  . .  ... .. .  ..# .#.# ##.##### .# ## # ###.###.##### #########.# .# #.##.# # # ## # .#.##
#.# #.#.#.#####.#####.##.# # .# # #.# # ##.# #.# # ## ## #.## #.##.#.#..#  #. #.#   .# ..      .  .  ...   ... ...... # ## #  #.#.#.#.# #.# # .#
# #.#.   ...  .. .... . . .# # # #.# # ##.# #.#.#.#.##.## #.##.#.### ##.##.# #   ## ##.####.## # ###### ## #######.# # .# .#.#..# # ..  ..#.# ##
# # # #.# #.## ## # ##.# ##  #.... ..... . . ..   .. . ...   .. . .    .   #  # #.  . .   # # .#  .    .#.  ..   #.#  #. #.#  # #.#.#.#.#.#.# .#
################################################################################################################################################
