############################################################################################
#  ## #   #.   # #  #   #.  # . #     .#  #=# # . #. # . . ##  . #   # #   #  #  #. ..#  # #
## .. # #. # #   ##.. #  # #. # # ##.#  #.    #.#. #   #.# . # # # #  .## #  # .#. ##.  #  #
#.# # .#  # ..##    #. # #   #.    #. #.# ## #  ##  # #.#### #  #.  # #..  #   #  #  #.# # #
#    #   #  #  .#### # #.. ##.# # ## ###.  .#  #  #.#    #  ###.  # .#  ##   ##  # .##   . #
# #.##.###.#.#.#       ## #..   ##    #  ##  .#  ## # ##  #  ### ## #  ##  # #.#   ## #.#.##
#  #  # . #   #..## #.# ..# # #   ## #..# ## #  ##. .# ##.  # ##     # ..# .#.  # ##.  #   #
#.#. #.##  .#   # # .#. ##.  #  # #  #.# . #  .#   # #    #  .. # ####.#  #  ##  ##. ## .# #
#   #   ## #. ## .##. #    ##  ##.  #  .# ## ##  ### # # ## ## #     ..##  #   #   #    # ##
## # #.# #  #   .#  # # # #   # .##   #   # .# .#   .# #.#    #. # # ## # ### #  #  ## #   #
#. .. ..  #.. ## .#    #    # ##  ##.### #..#  #.###  ###  # # .#  ##    ###.  # .#.   # # #
#.# # #.# .## ###.  ##  # # #  ..# #  # #  #.#  .# ##  # .#   # .#   # #. #.## .# # #.# .#.#
#... # #.# . # ###.##.#  #    #.#    #.  ## .  #. . .#  #. ##  ##  #### # # . # ##. #  #  ##
# # #    .# ##  # .#   #  # ## . ##.#. ##. ## # #.###. ####  #.###   #.     ##   . # #  #. #
#  #..## ## . #...##.#. ##  #..#.#   #.. #    #. ##.. ###. .#   #  ### # # # ..## #. .## .##
#.#  ##. .  #   # #.. #   ##. ##  #.# .#  #.#  .#   #  #.##.. # ..## .. # #  # ##. ##  ..###
#.# #   ## ##.### # ### #  . # ..# ##.#.#  # # #.# #  ## . # ### #   # #....#  . # . # #  ##
# . ## ##  #. # .### . # .# #..# #.# ..  # #  # .#. ##.  #   ###   # ##  # ## # #. #    #  #
##.#.  #. #  # #. #..# = ###  # #. .##.## .# ###  #  . #   ## #.# ###   ###   # .#=.# # # ##
##   #  ##  ##.. ####  #. ####  ..## # # .#   ###  ## ### ###.   #.### ###  ##.#  #   #.## #
#.##  #.#. ## .#..#   #. # #.. #.#    # #   #. # .##   # .##  ##  ..#. ## .# #  #  #.### . #
#  ##    #..  ###  # #=.##  .#  # # # #   # # # #    ##.## . ### # #..#  .#.   #.# #. ## ###
##.  # ####.#..#  ### #   # ## #.. . ### # . #    # # #  ## # # . #. #.# # ###   ## #    # #
####.    # #  #. # #  # ##  # #  ## ##### ##.  # ### . #      # # . ## ..#   ## # .. # #   #
##   # # #  ##. #    #..#  #.  .# .# ### . ##.#  ##  #  .### ##   #.. .##  #..#. .# #   # ##
#. #.  #..#  # ## # #  #  ## # ## #   #. #.    #    # # #   # . #   ## #  #.#### ###..#  ###
##..# #  # .#  #. .#  # # #  #.    .# # # ### # #.##. #. # #. # ## #   #.#.   #.  # .# # .##
#.# #  #.  ##.## #  ##  #   # .## # #  ##  .   .   .#. .##  .#   #  # # . .##  ## . ##. #  #
#  #  #.## # ##.# #    #..#  #   ###.# .  ## ## ## ### #...## ##  #. # ##.##  #  #.#  #  # #
# #  #  ## . #  # ## ##  # #  ##. # . #.##   #. .#..#  # # .#. #.### . #     ###  .  #  #  #
#. ## #    #   ##  #    #.  # ..#  .#  #   ##  #  #.# #   ##.#  ### ### .#.#### ## ## #.# ##
## #  ## #  # #. #.## #. ##  ##   # ## .# #.. ##.#   # ##. #. #  #.    ##  . # .   .    #  #
#  . # #  #.#  =#    ..#  .# . # #    ## # .# #..# #  .#  ##.#.#   ## ##  ##   # # # ##  ###
#.##.    #  ## # # ###. # #  # #  ### #   # ## .# .# #  #    . .# ##  # ## ###  ### #  #   #
#   ##.#####  #= . #  #  # ###  ##. #   #  #  ##  #   #  ###.#.#  .  #  #.  ..# .#...#   # #
#.#  #  .#  .#  # #  # #.#     ##  #. #.#.##.##  #  # ##   #  #  ## #  #.# #.# # =## . ##.##
#.# ## #.## #  #    #     # # ## #   ####  ..#  # .#.#   #  ## #. . ## #...#  . # ## #     #
# .## . #  .### .## .# ## #  ##.  ## .#   # #  ##.#..  ##.#   .# # #  . ##  # # #.. # ## # #
#.##. ##  #   . ##  # .   .# # ## .##  ##   ##.# #..## .#   # # .#   ## ### #  #. # # .#  ##
#  ..# ..## #.##.  # ### # . .. ##  ##.#. #    #  #   # .## ## #  # #    ###.#  ##    #. #.#
# ## ## # . .#   #  .#     # ##  ##  # # ### #   #  # ## # . #  #.   #.#. # . #    # #. #  #
#  .# .  # ## .#. ##. # # # # ##  ##. #   ### .#  # .  .#  #  # #.# # .##   ## # # ##. # .##
# ##  #.#  #  #.#.# #. \ #.o   ##  ## # #  #  # #  # # #.#  #.#  #.  ##.## #  .  #.  #  #  #
# .# ### # ## #   ..# ##   # #   #     ####..#.  # .  #   #  #.#  ## #   # #.###  ## ## ## #
##    #   #    # # # .#.# # .# # ## # # #  # . ##  # #### .#  .  ###  ##.   #    # #..# =  #
# ###.# # .## # ### .#  . # # .# . #.  .  #.## #  #.  #.##. #.# # #  #  #.## # # . #.# # # #
# #  . ###    .. #. # .# # #..#. ## # # #.  # # .#  #.    #  ##     # #.##   ##.##  #. # #.#
#  # #. # #.# # # .#  #    # # .# #. ..#  #   # ## #..## ### . ##.### # .. #.    .#  .#   ##
##  # # ...# ..### .#  # # .#  ##. .# #..## #  ##   #.  # # # # #   = # ### .# ##  ## ###. #
# #    #.##. ##.###  # # # ## # .# #   ##.  .#. . #  # # .  #.  .## ##  #.  # #. #.#     # #
#   ## . #  #   .# # .#  ###   #  ## #.#.# #. # ##  # # # #   # #.#   # #%# #   #    ##.#  #
####  .# . #  ## # ## # #.. ## ## #  # #..##.#.#  #   #    # # ## . #..# #  # #  ## ####  ##
#.  .## =#. ##      #. #  #.##  .. # .#.#   ##. #  ## #.##  #  .  #  # # # #  # #. ####  ###
#.##   #  # . #.# #. ###.#  .. # #  .# . # ## .# .##..  # .## #.#. #  ##  #  # ##.####. # ##
#####.# .### # .#  ##   # ### #   # #  ##  . .# .##..##.  ## ## .#  ##.. ###   .. ###  ##. #
# ##   ####    ##.# . #       .### . #  . ##.## ##. # ## ##  # #..#    #..# ## ##  #. ##  ##
#    #   #  # ##  .# #  # # ##   # #   # # #  .   .#   #.. .#.  # ##.#  ##  # # .#. #    # #
#.#.#  #.  # #   #. #  ### #### #   ##.##  # # #.#..##   ###  #   .# # #.##. .## .#   # #  #
## .. #### .. .## ## # ###. #### # #    ## # ##   #. # #   #.# # #  # #     #  #.### #   #.#
#. ### #  # ### #     # # .# ##.  #  ##.   #  # ##  ##  ## #    ###=  #.# #. # .. # # ##   #
##.# #   ##   #   # # .. .# ... # # #   # # # #.   ##  #  .  ## .#.# #.#...#.## #  .  #  # #
#.##   ###= ## .#. # # ## . ## ### . ###. . ##  # ##= # # #.# .# .     #.#.  . =##.### .# ##
# .  ###. #   .#. #. #  ##.#   ##  # #.o# #   # .#   #  .### # .# ## # .### ## #  .   ##.  #
# ## . .#  ## ####.#  ## # .# # .#.# . ## .# ###  # ## # ## .##  . #  # ###  .  # # #.  #.##
# . # # ..##.. #    #.#  ## ##  #. .# #. # #  #  # #..  #   # . ##  # #  #  ## # ###  #    #
# ## # =#    #   ##   .#. #  . #. ##   #  #  # # .  # ##  #. ##   #  ###  ## #  . # ##..# ##
##. . .# # ## # #.#.#.### .# #.#.#. ##  #  ##.  # ##  #.## # # ##  #.###.#.# ..## . #  #  .#
#  # ##  # #    #.  #  ### # ##.   ## # .# . =##  #  #. .# #.   # #   #.    ##...##  # .## #
##.    # .  #.#   #  #  #. .#  # #.#   #.###.##  # #  #.# .# ## ##. #  ##### . # # #  #  # #
# # # #. ## #.. #  ## # o #.  #  #  # ##   . #  #   # .  #    #  # # .#      ##.#   ##. ## #
# ## #  #. #  ## #  #   ## #.#. ###   # # ##  #  ## ## #  # # #.#.# #   # # ## .# #.  ###. #
#   .##  #   #   ##### ### #   ##### #...##.#   ##. .#  # ##. #...  #.#. # #. #    # ##  .##
# ##   ## .# . ## . # . #. # ##.###.=.#.#    # #   # .##     # ## ##.. ## .  #  ## #  . ####
#  # #..  # # ##  # # #   ###.   #. #    # ##  # # #.#  .# ##    #  .#   ## # .#. .# ##.# ##
# # #  # # .  .  # # # # # #. # # .#.#.#...#  # ## # # ##.#  # # .#=#  #  #.## .# # #   #  #
## .# #   .# # # #.#    #.. ##.  .##  #  # .=##   #  # #. ##.. ## .#  #.##  .  #.#. # #  #.#
# #  ## # # #   #    #.#  # . ### # .##.#. # # ##..#  o # .# #   # ## . ## ##.## . ##..#.  #
# ##   #     ## # #.#.#  # ##.  .# # #  ##.# # .##.  ##  #  # # #   # #    #.#   # #  #. ###
# . # ###.## .   #   .# #   #.## # # #.#  ..# # .  ##..#  #  .  # #  ### # #...#.#. ## .## #
# #.   # #...###   #=#  #.#..   ##   # # # #  .# #   # .#.# # ##.#.#  # # ..##..#. # # #.  #
#  # #. . # # .  # .#  # #  ## # . ## . . #  #  ## #  # .  #  # .#. ## .  #. ## .# #..  # ##
## .# #.#  ## #.# ##. #   .##    #  # ###   # #. .  ### ## . ###   ## ## ###   # #.  # #   #
# ###.  ##   ## . #  ##### #  # ### # . ##.#    ##.# .  # ##  ###.#  . # .### ###. ###.  # #
#    .#   ##   # #.#  #   #  # .##  # #. #  # #  . # #.#  # #  #   .#.# #  ## .# #   .#.## #
## # #  #  # #   #   # .#.  ##.#. #. ###  #  ##.#.# # ###  . #  #.## #   #.  #   # # ###.  #
#   ### =# #  #.### # .# ## #  ## ##  #. #  ## #. . #  # .##  # # #.  ## . # # # .##  #  # #
# #  #  #   ## # # .. # .# #  #   .##.  ####   # # # .# .#  # ##   .# .# ## ..#.##.. #  ## #
# ##  #.# #. # .  ##.### # # #.# # . #.# # # #. #  . #  ### #  ## #  ##  #.###    ##.  #  .#
##  # .# ###  ###  #  #. # . #  #. #  .  ...###  .# ## # #  ##..   # #  ## #   ##  # ### # #
#  #.#...## #    .# .### . ##  #  ## ## ###  #. ### . .#   #. # ##  # .##....# #.##  #    ##
## .  .#   . ## #  .#####.####   #  . #    #   # .. ##   #  .#    #.. #   # #. .  ..###.#  #
############################################################################################
