########################################
#.# # #... # # ##  .. .    .. ..... ...#
#    ...# # . ....##.##.#.# #.##.#.# # #
# #.##.#  .# ##.#. ..#.## # # ## #.#.=.#
#..... .#.## .#.#.##.. . .  .  .  .. #.#
#.###.#.#... #    .# #.#.## # ## #.#.# #
#.#.  ..  ##. .#.#.#.  . ##.#. .. .  .=#
#...#.# #. . #   ..  #.#..  . #.#.## # #
#.#.....  ##.. ## ##.#.#.# ##   #. .. .#
## ##.#.#... # ##.#.. .  .  ..#.####.# #
#    .. . ##..... . # ##.##.# #...  .# #
##.# ##.#... # # ## .  . .# #...##.#. .#
#.....  #.##.. # ## ## # # ...#.##.##.##
##.#.##   .. #.    .## # ## #.#....  ..#
# #.#.#.# ## . # ##. . .  . #.# ## # #.#
#.........  .# .....##.##.#.  .. ....#.#
#.##.##.## # ..#\## ## #..  #.#.## #. .#
#   .  . .  .#.... . ... ## #.# #....#.#
##.# #.#.#.#  .# ## ##.#..# ... .#.#.#.#
# ## # #.#.# # #.#.....## ..# ##....   #
# . .  .. .... ...#.##. . #.. ...#.#.# #
#.# # ##.###.#.## # #.## ## #.##.#  ...#
# ## #.. ...... .    .......# =.. .#.#.#
#      # ##.##.#.##.###.#.#.  ##.#...  #
#.## # ##.#.## ## # ..#.#. .#    .#.#.##
# .....  ... . ... .# ..  #. .##.##.## #
#.# ## #.#.#.# #.#.#  ##.# ##.. .  .   #
# = . .=.. ..#.# #.##  . .    ##.## ##.#
# #.#.## #.# .  . . . #.# #.# # .# ..o.#
# # #....# ##.# ##.##..=.. . ..#..#o##.#
# . o ## ...#. . # ## # # #.#.##.#.#.# #
# #.#. ..##. .##.......  .. ..... .   .#
#.#.#.## #.o#.## # ## # # #.#.#.# # ##.#
#.. .      #. .  ....  .    # # #  . ..#
#.#.# #.# #.# ##.#.#.# #.##... .. ## # #
#  .. .. .. . ... .. ... #  #.# # . ...#
# # # # #.### ##.#.##.## .#.##.#. ##.#.#
#.#.# . #.. .. # #.#  ##.##.....## # #.#
#.....##  ##.# .    #....  .#%#  ...  .#
########################################
