################
#= #   #o#. #. #
##.# #.# .# #%##
#... #.#.##.#  #
######.# # ...##
#.. ... .##.#. #
#.# ##.#.. \# ##
#=##.#  ###.#..#
# . .#.## ##..##
######.#  .o# .#
#..   ..# ###.##
#=####.#  ..o .#
##=. . .### # ##
## # ##.o # ##.#
#  #.#..# #. ..#
################
