############################################################################################################
#... ... . ... ..   . .   . .. .#   . #. ... .#.#.     ... .#  #  .#.#.## ##.# # #  #.#..# ..#.#..# .#...#.#
####.##.######## #=#.#####.##.#.##### ##=#### # #.###### ###  ## ###.#  =.    .#.#.## ## # ### ##. # ###.= #
#..  ..# .. . . # #=#    #  # # . ......   ..  . =.  .      #.#..    # ##.#### # #.  . . ..   .  .# .  # ###
# #.##..#.##.#.#... # # ## # #. ##.########.#.# #.## ## #.##   ## ## #..# #  # # #.#.## #.# ### #  # ###...#
# #  #.## # ##.#### ### # ... #..#.#  ..     ## #.  #. #..# #.#..#  . ##.# #.#.#  #.##.#.#..#   #.##.#...###
# ##     ... ... .. .....#.##.#.##..####### #. .  #  #  # # . .#. .# #.    ..#.#.# .%.    #.#.#.#.#.. ##.. #
#    #.# ##########.##.# # #. #.#..#  . . #.# #.#.# #.=#.. ##.#. #   .# ##.# #.# ##### ###..# # #.## #.# ###
# # #   #.     .  # .# ## .##. ...#.##.###.#.# #.##.##.## #.. .#.# #.# ##.##.#.#.   ......#.# # # .#.# #.  #
#.## #.#  ## # ## #.# .. # .#.# #...   ..  .... ...... ..   # #  #.#.#.  ... #.# ## ##.##.# ##.## ##.# # ###
#. # # .# # ##.# ## .#.# #.#   ..########################.#... # #.# ##.##.#.#.# #.#.#.# #..      #..#.# #.#
# #. # #.....    ...# # #.  ### #.  .    .. . . ...   . ..###.#. #.# .# # ## # #.# #.#.#..# ##.##. # #.#.  #
#. #.# .# ##.#.####. . . #.# ....#.#.#.# # #.###.# ####.#. .#..#.#.# #  ..    .# #.. . #.# . = # .##.#.# ###
#.# .#.#  # ### . # #.## # ## # #.#.#.#.## # #..# ..... #.#.# #  # # .# # #.##.#..#### #.##.##..#.# .#  .. #
#.##.#. # #  ##.##..##.# #.. .#.# # # #. . . #.#. ##.##.#  ## ## ##..#. ##.# #.#.# ... = .. #. #...# ### ###
#.. .# #..#.# ....# .. #.# ## #.#. .# #.# ## #..#.# ..# #.# ...    #. #.... .#.#.########### ## #.#.  ... .#
##.#.# #### ###.##.#####.#.#.#.=#.### ## ##.## ##.## ##.#.###.##.## .## ## ##  #.     . .  ....    #.##.# ##
#. =.. .... . ..... . .....  .#.#  . ..... ... . ..    .  ..# #.#.## # #.###.# #.##.#.## ## ####.##  .# #. #
############################### ######### ################### # .  ....=.      ..# # ##.  .. ..#.# #.#. # ##
#.  .. .  .  ... ..  ... . ..... .. ....  .      .  ....... . .#.######## ##.###.... ..# ## ##.#. .#. #.# ##
##.##.## #.# ## ## ##### ##.####.## #.#.# #.#.#.# ## ##.#.# #.#.#.  ..  # #    ..#.## #   # #  # #.# # .# .#
##.#.## #.# # #..# # ..# # ...  #.#  # # ....#.#=## ## #.##.# # ####### #.#.####..# ##.#.#  ##.# # #.## # ##
#  #..  ....# #.#. #.#.#.# ## #.. #.#   #.#=## ..    . .. ..#   . . .. .# # .....#.  ..#  #..  # #.# .#.##.#
##.######.# # #  # #.#..  ..  #.##.. # # .# #  ##### # ###### #######.# #..#####  #### #.# ####.# ## #  .. #
#.=  ...#.##  # # # #  ##.# # #.# #### .#.# .# #  .# ..#.. ...... . # # #.#. .. .#.. .. ... .. .  ....#.####
## #### #. .# # ...  #.# # #..#.#. .  .# # ### # #   #.# #### #.#.# #.# #.# ##o# .#.# ##.#.## #.# ##.#... .#
## #.  #..##..# #### #.# .. # #. # #.# # .. . .###.#...#   .# ##.##.# ## .#..# #.# ##.# #.##.# # # #..# ##.#
# . ## ## #.#.# .. # # # ##.#.# #.# #..#.##.## ...  .#...####  . . .# . # # ##.#.# .   ... ... .=  # ## .  #
## #  . #.#.#.#####.# .#.#.## #.#.#. #  .# #.#.##### # #..... ######.### # ##.##.################## .# .####
#  ### #  #.#  ..  ..#.#.  . .#.# # #  #.# ..#.#  .. # .##.## ... .    .  .        .  .      ... . # .#.# .#
##. =  .# #.#.# ### # .# # ## # #  . # ###.### ######.##.##.# # ####.## # # #=##.#.###.#.# #.# #.# # ##.## #
#  ##.# #.#.# ###.##.#.##.## # .### ##  ... ... .  . .      #.# #  ##..#.#.# #.##.##. # # ## ## #.# .# .. .#
## .# # #  .   . .  . .     ..#   # #  ##.## # #.# ##.##.##.# #  # .#.## .. .  ..   # .... .    .. #.## ##.#
##.# .# # # ##.# #.##.## #.#.#  #.# .#.# .#.#  #.#.#. #.# #.#.#.#..#.... # ## ## # #  # ### ##.#.##...#..#.#
#...##.##.## ## # # ### #.#.#.#.#.# #. .# # .###.#. # # #  .#.#. #.#####.### # ##.#.# #.....#.## #.#.#..#..#
##.#.  =     o........ . . .    # # .#.# ##.#    #.##.#.# #.# #.# ...   ....     .  . ..# # #..  # # ##  #.#
#.   ##.## #.##.# #.##.# # ##.#.##  #. #   . #.#.# #   .#.# # #  # #.###.#.##.#.# #.# #.# #.####. .#..#.#..#
## # #.# ##.# ### ##.##.# ## #   .# ##=####.# # #.# ###.## #..# #.# ## ## #.## #.#.#. # #.#.. .#.## .#  .# #
##. ...   ..   .. .. . .. .  .#.# #..# .  .... .  ..   . . .# #.  .. . . .   . .. . #. . .#.##.#.# #.##.#. #
#..###########.## # #######.# #..##.#. ###.### ### # ######## # ####.### ##.## #.# #..####.##.#.##..  #. # #
## #. .       # #.# ..    . . #.#.   #. . . ..... .  ...  .  .#.#... ...   #=.. #.  #....... .  .  #.#..#..#
##.####### #.##.## ############ ###.##.####.##### ########### #. ## ##.# #. #.#..# # .## ## ### #### .#..# #
# . .  .......  . .. ...    .    .  . .. . .. .... .. .. . .#.# #.### ##.# # #..# # #..#.#..#.. .   .#. #..#
##.###.##.##.##.#.#.#.#.###.##.#.## ##.## # # ## #.# #.#.#.#  # #=. ..   #... #..   # # .##  ##.##.#. #..# #
#..# ##.### # ## # # #.## ## ## # ##.## #.## # #. # #.#...# # # #.## ### #.###. #### . #. #.#. # # # # .## #
##.# ..   ...  .. ....  .  .  ... . .  ..   .#.# #    #.#.# # #  # # . # #   .# #  .#.#  # .# # . .#. # # .#
# #.##########################################.##.#.### ###.#.##.# #### ##.####.## ##.## ## #.######.#  .#.#
#    ... . .    ..   .      ... . ... .. ........      ....  .. .   .... .  .     ...   . ... . .   . #.## #
# ## # ###.### ###.# #.#.#.# # #.#######.##.##.#.# ### ### ############ ## #.# ##.####### # # #.#### # .# .#
# #. .#   .# # # ## #.#. # # .#.#.. ... # #...# # #  ..#.# #  .=  . ..#.#.#.# #.#.#  .. .# # # ..  #  #. #.#
#. # ## #.#. #.#... #.# #....#  # #######.#.## .#.#.## ... # # ###.# # .#.#...# # #.#.##... .# # # # #. #..#
# #.. =.## # # .# #.#... # #  #.# .. .... #.#.# # ### ######.###.## #.### # ###.## # #.#.#####.##.##  #. # #
## ####.. .# #.#.##.# ###  #.# .#.######## .# .. ..  .  . .. .      . .. ..  ... ... ..   .  ..  ... #. ## #
#.  .   ###..# . .   .  .#.#  #.# .. ...  # .##.##.######### ###.###.################## ## ### # #.# .# # .#
# ## ## .  #.#.# ### ##.#  # #. #.## ##.#   #  #..#.  . .  ..#   . # .. . ..  .   . ...#.#. .#.. # # #..##.#
#.#...# #.#. #.#.   # ...#.#  #.#. #.#.#.##..# .#. # # #.#.# .##.##.####################.##### # . # ##. #.#
#..#.#..#  #.# # ####.##.#.# #  # #. #..  #.#  #  #.  #.##.#=# ...    .  .  .  ... .o ....  . . ## #. # #. #
# #   #.#.#..# # # .   ....#..# #  #.# #### ## ## ## #.  ..#.#.#.###.######## #.#.#.# # ##.###.#.# #.#.  # #
##.####  . #.#.#. # #.#.##.# ##.# # .# # .  .=. # .#.## ##.#..# #. # #. .. ..#.. # # . ##.#..# #.#.#..# ##.#
# .  ...###. ##.### ## # # #  . #  # #  #.# ##.#..##  #.#  # #....#.. ####.# # #   .#.#....# #.#.##..#. #  #
##.## # #.##   .......  .#..###.#.# ##.#.# . #..# #..#.  #.# .# # ## #  \# # #.#.#### ###.# .#..   # ##. #.#
#.# ##    ...##.###.##.# #.#..... .  .   .#.#..#.. #..# ## #.#. # .#.# ###.## .# ..  ...#..#.#.### # .# ##.#
# #...#.#.##.# ## .#  #.#. .##.## # ####.# ..#. # # .#. #  #  #.#.#..#       #.##.#.# ##. # .#.# #.# #.   .#
#  .# # #.   # =.#.##.  .# # #.#...#.. .# # #..#...#  #. #.#.#. # ## ##### ###...#.## ..#.## # #.#.#..# #.##
###.#.#.####.#.#.# .. #.#..#.#. #.#. ##.# ...#  # #  # .## # ## #. .  ...     .##. #  #.#..#.# # #  .#..#.##
#.#.#.#... # # ###.## ##.# #.#.# .## # .# #.#..## ##.####.#. .# #### ## ###### # #. #.# #.#..# #. ## .#.#..#
# ..# # # ##. . . .......#.# # ##.....#.#.# .#  . .........#.#     #      .. #.# ..#. ##   #. .#.# #.# .####
### #.# # #. ############. #.#. # #.# # # # #..######.######  #.###. #.##.# #  .##. # . #.#  #  .# #. #..  #
#.# # #.#.## ..  ..  .   #.#.# #.. # ##.# #. #.#  . .#...  . # .. .#.### #.# # # # # #### ##.#.#.#  .## ####
#.# #.# #  # #####.### ##..#.## #.##.#..# # # .#.###.#.## ## .#.## #.   . . .  .. .   ...   .# #.###.# .  .#
# # #.#.#.##..   #.#..## #  ... #  .  # #.#.##.#. ... ....  .## #.#.######################### .....#. # # ##
#.#.##. # # .####  ##.#  #.#####=.#####.# #..  # # ##.##.### .. .. .  .  ..  .....  .  .. ...# #.##..##. #.#
# #  .# # .# ..  #. #  #.#.#  ..#.#... .. . ## ## #.## ### #.##.#######.##.#.# # ###.# #.#.## .#...# # .#. #
# # #.# # #. ##### ## ##.#.####.# # #.## ##...  ....... . .# #.. . ... ...##.  # #..# #.# ## # # # ## # ##.#
#.#.#...#  #..    ...    #... #.#  #.# ...  ######### #.###..###### ##### .  ###.##  . ..    #.#. ..  #  #.#
#.#..## # #..###.# # #.#.# ###..#.#  ## #.# #.. . ...#. . .# ....  ..  .# ##..     .##.##.#.#  # #.# #..# .#
#.  #.# #.##.#=##.# #.# #  .. #.# .# . .  #.######## #######.############ #.###.###.#.##.# # ## #.# #.##.#.#
###.# # ## #. .  .. ... .# #.#. #.## ### #.  ..  ...  ...          ... ..     ...  .   . .  .  . ..  ..  ..#
#   ..  ..  .######### ##..#..# #. .......# # ####.#############.######## #.#.# # ### ### ## # # # ####.#.##
##.#.##### #   ....... ..#..### # ## ##### .#.#..#.#.. .. .   .   .. .... .## .  # ..# .###.#.# #..# .  .# #
# ## .  =# #.##.#.##.##.#  #.. . ...     .#..#.# #.#.######.############ #.#..## # ##. #. ..=.#.#.# #### # #
#..  ## #  #   #.#. # .# # .###.# #.#=# # # #      #  .. .. .. ..  .. .   ..# ...#  .#  ###.#.#. .      .. #
####.#.#.#.# ###. #. #.# #.#  #.# .#.# ## #.# # ## # #######################. ####.## .#...#..#.##.## # ## #
# .. #.#.#.#.  . ## ## # #.#.#. # #.   . .#  # # # #.  . . .. .   .  . .....#.. ... .#.#.#. # #.#.# #.#.#.##
## # # # # # ###.#. . .  . #.=# #.# #.# #.# #....  #.##### ##.# #.##.##.### #.# #.##.#.#.#.#=.# #  .# #  . #
#..# #...# # # #. ### #### # # .#.# # . #.#. ###.# #.#    # #.## # #.# ## # # # # #  # #.#  #.# ..### # ####
### #.## # # #.  #. .#      . #.# #.#####.# ##.#.#.# #.#.# ......  #.#. ..  #.##.#.#.# # #.# .# #.#   #    #
# ...  ..     .#.# #.##### ## # # #.     .#.# .# # #. ## ####.#.##.#..###.# #...   # # #.# .#.#.#.###.# ####
##########.# #.#. ## ..  # #.# # . ######.#. # # # # #...  . .##.## .# =  # # #.##.# #.#.# #..#.#...  #.#  #
#.... . .# #.. #.#.  ## #.  ....# #..  .# # #. #.#.#..#.#####  .   #..# # #.#. # # #.#.# #  #.# .#.##.#  #.#
# ## ## # .#.#..  ## #.  # # ####..# ## #.# .#.###.# # . .  #.##.# #.#.#.#.#  ## #.#.# # # #..# # . #.# ## #
#.#.## #.### ### # # ##### #.... .##.# #. #.#.  .  #..#.#### .#.#.#.   . .  #....# #.# ###.## # .#.## #. . #
#.. ..  ...  . ...  ... . . # # #.#. ...# # .#.#.# #.##    .#.  . .#.## #.#.# ##.#o. #..  ..# #.#  #..#.#.##
###.######################.#.# ##.## #### # # ##.# #.#.#.###.######.## ## ## ##.#.# ## ######.#.#.# ## # # #
# ....   . ... . ... .. .. # . .   . .  .. .  =  .   .. .    ..  .  .  . . .. ....  ..  ..  . .. .. .  ....#
# #.# # ##.## ## ##.##.###. ###.#.#.# # # # ###.################# # # ###.#.# ##.#.# #.## #.####.###########
##.#.#.# ### ## # ##.##= #.##.## #.#.##. ##.#...  . ......... ..  #.#.#.#.##.#.=# #.  ..#.#.#.....  . .  . #
# .... . .  . ......  ..#. #.... . .  . # . ## ## # # # ####.#### ##.## . .   #.#   ## # .## ###############
#### # ##.#######.###.#..#. #.#####.###.# #..# .#.#.#.# #. #.#. # ... . # #.#.  .## # . #. .. . ..      .  #
#  #.# #. #   ....# ###.#. #. .. ....  .#.# ##.#.# # # ## # ## ##.##### ## # ##.# #.#####.#.#.##############
# # ##.## # ##.##.. ... .#  #.### ## ## #.#.# .    . .  . .....   # .. . .... ..    .   ..#.#    ....   .  #
#.  .   #.## ##.# ##### #  # #.. #..# # #=  .# #.#.##.# # ##.# ## #.#.## # #.#.#.## ## ##. .# ## ##.# #.#.##
##.#.# #.   . . #..   #. # # ### ## #.# # # #.#.# ## #.# ## #.##.#.# # ## #.#.# ## ##.##.#.# ## ##.#.# # # #
# # ## ########## #.###.##.   . .    .# #.#     . .    . ..... .. .... ..  ..   . .. ....    . .  .........#
#   ... ..   . .  .. ... ..##########.#.#.#.######.#.#.##.#.### ## #.#.######### #####.# ##.##.# #.### ###.#
# #######.################.#...   .... .# # ..  .#. .## # # # ### #.## ..    ..#  ...# # #.#.#.###  .#...# #
#.. . ..#.#.. ..... .... ....# #.# #.##.#.# # #.#. # .. ..#.#....   . .#.# #.# #.# ##..# # .. . .. #.# #.# #
############################################################################################################
