####################
#o# # #.#. #      .#
# .    .  # ## #####
#.# # # #      . \ #
# # # .o# # # ## ###
# ##.#### ## #     #
#.=. ==        #%# #
# #.#=### #### # # #
# # #o#  o   . # # #
####################
