######################################################
#.........#....#...#.#..#. .#.#...#...#..#...#...#.###
##.#.##.##.##.#..#.#..#.#.#.....#..##.#.#..##..##...##
#...#.#........#.###.## ##.######.#.#.#.##...#...#.#.#
##.##.#.###.#.#............................#.#.###.#.#
#.....#....#.#..##.####.##.##.##.##.##.##.#..#... ...#
##.#.#..#.#...##.#.#...#.#.#.#..#..#.#.#.#.#.#.# #.###
#..##.#..###.#......#.#..#.....#=#.#.#.#.#.###..#.#..#
##....#.#.##.#.#.#.##..#.#.#.#.#.....#.#.#.....#..#.##
#..##.#.#....#.#.#.#..#. #.##...##.##..#.#.#.####.#..#
##..#.#..#.#.#.#.#..#.##.#...#.#.#...#.#...#.#.#.\#.##
#..#..#.#.##.##.#.#.#....#.# #.#.#.#.#.#.#.#.#..#.#..#
##..#.#.......... .#..##.#.#.#... ..##.#.#.#.#.#..#.##
#..##.#.#.###.####..#..#.#.##..##.##...#.#.#.#..#.#.##
##.#..#.#.#..# ..#.##.#..#...#.#.##..#.#.#.#.#.#..#..#
# ..#.#.#.#.#.#.#..#. .###.###.....#.#.#.#.#.#.##.#.##
##.#..#.#........#..#.#... #...####.#..#.#.#.#......o#
#...#.#.#.#.###.#..#...###..##.......#..##.###.#####.#
##.#..#.#.#...#..#..#.#...##.#.####.#..#...........#.#
##.#.#..#..####.##.#...##.## ##....#.#..#.#.##.##.#.##
#...#.#.#.#.....#...#.#.........####.#.#.#.#.#..#.#..#
##.#....#.#.###..#.#...########.#..........#. .#..##.#
#.#.###.##.##.###.#.#.#...........##.# #.#.#.#..#..#.#
#.................. ..#############.#.#.##.#.#.#..#..#
##.##.#####.#.##.####.. ............. .....#.#..#..#.#
#..#.#....#..#...#...####.#####.##.#.###.##..#.#..#..#
##.#..#.##..#.##.#.#.#...#....#.#.#.#....#.#.#..#..#.#
##.#.##.#.#.#....# #.#.##..###..#.#.######.##..##.#..#
#o.#........####.#.#.#...#.#..#.#............#.#...#.#
##.#.###.##....##.##.#.###..# #..##.##.##.#.#=..#.##.#
#..#.#.#..#.#.#...... =....##.#.#...#...#.#..#.#..#..#
##.#.#.. #...##.#.####.#.#.#....###.####.#.##.#.#..#.#
#..#..##..#.#...#.#...#.#..#.##...................##.#
#.#.##.###.#.###.##.###.##.##.#.##.##.##.##.##.###...#
##............................#.#.#.##.##o#.#.##..##.#
#..#.#.#.##.###.#######.#.#.##..#.......#.#.#....#.#.#
##..#.#.#.#.#..........#.#.##.#.######.##.#..###.#.#.#
#..#........#.#.#.#.##........#...........#.#....#...#
##.#########.#.#.#.#.##########.##.##.##.#...#.#.#.#.#
#...............................#.#.##.## #.#.#..#.#.#
#.###.##.#.#.#.##.#.##.#.#.##.###...........#..#.###.#
#...#..##.#..####..#..#..##.#.#...#.#####.#.#.#......#
#.#.#.#....#...#.##.#..#....#.#.#..#....#.#.#..#.##.##
#.#.#..##.#..#.. ...#.#..##.#.##..#..####.#.#.##.#.#.#
#.#.#.#.. .#.#.#####...#.#.##...#..#.#....#........#.#
#.#.#.#.#o#..#......#.#.#.....##..##.#.## #.##.##.#..#
#..##.###.###.#######.#...###.# #.#..#..#.# ..#.##.#.#
#.# ................. .##...#.#.#..#.#.#..#.##. .....#
#..#.#.#.#.#.###.##.#.#...##..#...#..#.##.#.#.#.#.##.#
#.#.# #.#.#.#..# #.#.#=##...#.###..#..#...#.#.#.###.##
#.............#. #........##....#.##.#.###........%..#
#.#.###.###.#..#..#########.#.#=#.........#.#.###=##.#
# #.#... .#.#.#..#..... ......#.#.#.#.##.#...#....#..#
######################################################
