#################################
#.#. .#  # #.  #o ..  .. #. #  ##
#  #.#..#.. ##.. ## # ##   # #  #
##   # # .# .## #.##.   #.#  ..##
## # # . ##.#. o#    # # ..## # #
#. #   ## . # #. # #.## .#= . # #
#.# ##.# #.#= #.# # # ..### #   #
#   #.##  . #  #. #.  #  #  ## ##
## #. .  # ###  # #.# # #. #.   #
##.# ## #   # #. .#..# . #..##=##
#   # . .##..  ##   #. # ## .##.#
#.##= ##. .####  # ## # #. #.   #
## . #.#####  .#  # . #.  #  ##.#
# # #      =.#. #  ##. .#.# #. ##
# ...#.# ##.#.# ##.. #.# #    ###
## #  #   ##  #   ## # . . #.# ##
# # #.  #   #  ##. . #.# #  # ..#
# . # ##.# # # #. ##.\ .# # .# ##
# ## .     #  .  #  # #. .##.   #
#.#. #.# #..# ##.  ## . #  o## ##
#  .#    .# # .  #. . ##.# #   .#
#.#  # # #  ..# #. # ##  . #.# ##
##  #  #. ## #   .#  #  ##   .# #
## #  #  #  #  ##..#.## ### #.  #
#. . #  # #  #  #.#..  . # ######
# # #  #   #  #    ## ##    #  .#
# # .# ## ###.# # # #.   ##.  ###
### ##.   .##  #  #. # #. .# #  #
#o..  ## #.  # ..# .## .# #  . ##
### ##.  .#.# .##.#  . #. # # # #
# #.# .# #   .#  . # ## .# # .  #
# .  .#  # ##.  # #  .. # ...##%#
#################################
