#####################################################################
# . .... . . #....  #.## # # #.. # #.## # .#    .## # #.# ###.  ## ##
#.##.#.### # ## ## #. .  #...# #.. .... # # .# #..  ... .  #  # =.  #
# #  #.   #  .  #. # #.##. #..# ###.###.   #.#.#.## # # ##  #.#.#.# #
#.## .## # #.#### #  #   #.# ## .. ##.# ##.#..#..#   ##. # ##  # ## #
# .#.#. .... .   # #.####.#. #. ##. . # #### # # ## # . #  #. # ...##
#.#. .# # ## #.##.    .... # ## # #####..#  .# .  .  ## ##  # # ##.##
# .#.## #   .#=#  ## ##.# #   .         ## #..## #.##.     #. ##. . #
# #. . . #.# # ## #.# ## # #.# ##.#.#### . # # # # #.#.#### #. . ## #
## ######  ..         o  . ..    .# . .# ###.#. .#.. ...  .  ###.# ##
#. ..   ..### # # # # #.# #.###.##. ##.##.    ## .##.## #.# # . ....#
#.# ### #.# .. #  # #. # ## ...# # #  # #.#.#  ###.## .### .# # ### #
#  ## ###..# # .#.#.#.## #  ###  ..##.#.# ## ##    . #  #.## # #.   #
## . ..   # .# #  #.#. . ##.# #.##.  .... .  .# ## #   #     #=# ####
## ##.###  # # ###. %#### #. .# # .#.#####.# #..#. # ##  # #. .# # .#
#. #  # # ##.    .# #.    .# # # #.... . .# ###.##   ..##.# ## #.#.##
##.# #. # # .### #  ..#.# #  ..\   #.##.#..  ##. #####...    ..#.. ##
#..#  #.# .#.#. .##.#.# #  .# #.# #. . #.### . .#.. . .##### #. ## .#
##..# #. #.# ### .# # .. .# #  #.# # ## .... ###### ## .  . #. #.# ##
# .# ## # .#   .##   ##.# # #.#   .  . .##.##  .# ## #.##.#. #   . .#
##.   . .#..## # . # . ...  #. # #=#.### #.## # .   . ..# # ####.## #
#  ## ##   #. .# ##.#.#####  .## # #   ..      #.### ## .# . # # #.##
#### # # ##.##.   . . #   ..# . .# # ##.## ### .# .#. #.# # #...  . #
#   .   . .  #.## ## # .# ###.##.#... # .# #.# # # #.# ##.#  #.#.## #
#.###### ###.##  #.## ##.#.  .=# . #.#.##..# #.#.. # # . .  # .#.#.##
#.    = #  #   .# .. .   .# ##  .#.. #   #.#. # .#.#  #.#.# ####    #
## ##.#.  ## # # .## # #.## #. #.###=. #..##.# #.#  .# ## ##  .. # ##
#. # # ## .. # .# . # ##  ..#.#. ..  #.#.#  .#   #.#.#. . .# ## #.  #
#.##  . ####.# ## # #.  .## #.######.#.# ### ### ###  ### ##.# ##.# #
# #. ##.. .  #.#. ### # #.#    .   .  .#  ...       .#    #..#. ..#.#
## # # #####..  #  .      .#.#.### ##.# #### ## ## # ####  # # # # ##
#  .    .  #.##.## # # #.##. # #.# #. #  .  #. . # .... # ## . #.. .#
## # ##.#.#  #..   ..#  #  #.     .### ##.# .## # .#.#.## ..####.#.##
#. # .#..  ## # ##.## #.# # #.# ##.  .   .# #.. .#...#. . #.#..  # .#
##.#.## ##.#  . #  #  # # # # ### .#.#####.  # ##.## # #.# ..# # .#.#
##.# #..##  #.#.## .#  .#  . #  .# # #   .##   .. ...# . .#.#   .#  #
# .. .# .. #. #  # ## ### #### ##..# ..## .##.#### #.#.# #  .###### #
## ### ##.## # # . .    .. .     # . # #  #  . ..### #.# .# ##   # ##
#.  =. .# #..=.#.#.##.####### # ## ### .#..#.###.....# # #  #  #  . #
#.# # #  #. ## # #    #   ..#..#.  #  .#..## # ..## ##. ### .# # #=##
#.# #  ## # # ## ## ## .## # .#  #   # ##.  .#.#..#.#  #.##.# ## #..#
#.# #.#  .   ..... ##.#.#. .# ## # ##     # # #. # . #    .  . ...# #
#   #.#.# ###### # .     # # ...   # ## # #.#..#.. #  .### ##.##### #
# ##  #.#.  ...#. # # ##.## # #### #.#.##.##..## #   #.  . .       .#
#.#.# #. #.## #. # ##. .  .. .   . . .. .. .# .  ###.#.# # #.#.#.##.#
#  .# # #..... #.#  .# ### #.####### ### ##.#####  .  #.#.#.#.#.  # #
##.#. # .##.# # .#.###.# # ##     .#  . #.#.  . #.# #   .      ### ##
#.. # # #.### .#. .#  . .# .. # #### ##.#.#=# # #.# # ## #####.  #  #
### # #.     ## .## ## ##.# ##.#. ... ..  . ##### # # ..     #.#.# ##
#.# o ###### #.#      .# .   . #.# ### ####...#  .##.# # #.# ##.# . #
#. ## .. .   . # ##.#.# ###.###.#.##.###... # #.#  .    ## # .. # # #
##   ##.#.## # #= # #  . ..... . . . . . # #  ##o#.# ##   ##.# ##.# #
##.###.#.## # ##.# #.#.###.#.####.## ### ...#. . # .# ### #.. #.    #
#  . ..  . ..  . # . # #  #     ...# # ###.##.##.# ##...  ####. #####
# ### ####### ### .#.#  # .# # #.# ..  ..#   . # #.   ###.  . #  . .#
##.. .# . =  .   #.#.# #.# ..#. # ###.##..## #  . ###  . .# # #.### #
##.# #. #### ## # #.. .#.  #   #.. =. .#.##.# ##.#    ### #. #  #  ##
# . . #     ... #  # ## ###.### # ### #        # .#.# # ##..###..#..#
#.##=## #### ##..# #. . ... .      .#..#.##.# ##.##.   . =#.##. ## ##
#         .# #..# .  # #.#.## # #.# # # #.##  ... . # #.#    .# # .##
## # ###.#.# .#..### # ### #.#.# ##  #  .. ..##.## #.## .#=# ##.## .#
#..#  . .#. .# .##.# . .  .  .  .  .#  #.# #. .. #.=. ..## #..   . ##
## .#### ###..#.  =.# ####.### # ###.### ## # # # #.# ##     ## # # #
##.#.  ..  # # .## #  .. # # ## ..  ..   .  . #.   .   ..# #..# .#. #
#.. ###.##.# ####. #.###.# #..#.########## # #..####.## ## # # =##.##
## ##.#.# ##. . .# # . # #  .# ..o ..  .  #.  #      . #.=  # #.#   #
## .   ..   .# #.# . ###. .## ####.####.# #.## ##### ### #.#  ..## ##
#  #.##.# # #  # . ## .  # # .. ..     .. #   ...  .    #  . ##.  . #
#####################################################################
