####################
#\#  ####  # o# . .#
# #.# ##= # #. =## #
# .=# .  #    #.%# #
# ## #.#.  ### #.#.#
# #  ##. ##    # #.#
#   # ##   o## ##.##
## #.   .### .     #
#o   ## #  o ## #=##
####################
