##############################################################################
##........ . ...##.#.# ##.# ## #.# #.#.#.## # # #..#.# #  .. ..  #.. #.#.#.#.#
#..#.# ##.#.# #.   . .  ..  .. .. ...  .  .....  #..  .  #.#.# #  .#. .....  #
##. .#.  .   ...#.#.#.#.# ### #.##.#.#.#.#.# ## #  # # #.....# # #. .#.##.## #
#..# ..## #.# #.# #.#.### #.#.# ## ##.# ##.# # # # #.# . #.#.   .# #.##.#... #
##   # #.##.#  . . ...........  ... .. .    .. ..  ... #.  ..# # ..#..... # ##
## #.#.    ...#.# #.#####.## ##.###.#.#.#.#.#.#.## ##.## #.# =.. #. .##.# .. #
# .. ..## #.# . ........... ....# #.#  ... .#.  #.  #....#.#.# # #.#.. .#.#.##
## #.#  . ..  # #.# ## #.##.#.#.... . # # #. .#  .#. .##... ....... .## .  ..#
# ##.#.# ## ### ##.## #.# #.#.#.## # # #.#.#.##.# ## # # #.# #.# # # #.#.### #
# ..  . ....... . ... ....... .   ...... .  ..    .. . . .. ..    .....  . ..#
##.##.# ###.##.#.# ##.## #.#.###.##.#.#.#.# #.##.## ## ## # ##.#.# # #.#.#.#.#
# #.#.# #.## # # ##.#   . . ## ##.......#...##.......#.# ##  ..... .. . . ...#
#. .  .... ...o... ..#.# ## . .. .#.# # #.#  ..# #.# ..... .#.#.## # ##.#.##.#
#.#.#.# ###.#.##.##.##.#.## ##.##.#.#  ..   ##.#.  . # #.##.##.#  ... ... ...#
#... ..... .. . ..  ... .. ....... .#.# #.#... #.#.# ..#.##. .. .#.#.#.#.#.#.#
# #.## ##.## ## ##.##.##.## ## ##.#.#.#.#.. ##..  . .# =.. .##.##  ..# #.#  .#
##.#.##.#.## ## ## #.. ...# ##.. . .  . ..#.#..#.#.# # # ##.##.#.# # . ... # #
#  ......  .... ....#.#.# . ...## # # #.#.#. # . ...   # #. . ......#.#.## . #
#.#.#.#.## #.# #.## . .  .#.##.. .#... . ...## #.#.#.# .  #.##.#.#.#.# # #.#.#
#.##.##.##....  .#.##.#.#   . .##. .#.# # #.# .#.#.# #.####.. .     . .. .. .#
#..  .... .#.# #. .  ..  .#.##.  .#... .... .# ..#........  #.##.#.#.## # #.##
#.## #.#.#.   ...## #.# #.. .#.##.# #.#.#.# ##.#.#.#.#.#.##.##.#.# ## # #.# ##
## # # # #.# # #.##..   ..#.# . .  .... . .  . ....  .  .    .. ....... .... #
#.... ...  #.  #. ..#.#.#   .# ## #.#.#.#.#.#.#.## #.## #.# #.## #.##.##.#.# #
# # #.##.#...#...#.#. . #.#.##.# .#.. #. .     .   .. ....#.. .....##.## # . #
#.#  ...  .# # # ..##.#..... ...#...#...#.#.#.# ## # #.##   #.##.#  .....#.#.#
#.. #.#.##... ...#..... # #.##.##.#.#.#..=#..  .#.#.# ##.##... .=  ##.##.    #
#.#..... . #.#.#o .##.## ## ##. . #..# ## . # #. .. . . .   #.##.# ##.#.##.#.#
#.#.#.#.##.#.#.#.## ... =. ..  ##   #   ..#.....## ## #.#.# # ##.#  . . . .#.#
#   ..# .. #...  . .#.# # # ## .#.#..#.##  .#.#  ... .    # .  . . ##.#.##.#.#
#.#.#.##.# ..#.## #..   ... ...#.. .#.#.#.#.#.#.# #.# # #. .#.## # . ..  . #.#
# . .   ...# # ##   # ##.## ##.##.#. .......   .#.#.#.#.# #.  . ## #.#.# #.. #
#.# ## # # .. ....#.  . ......  ..  ##.## #.#.#.   ....... .# #.. .. #.. . #.#
#.#.# #.##.#.##.##.#.#.# ##.# # # ##.# ## # ... ## #.## #.# ##.### #  .# #...#
#.....  ..  ... . . . .  .  . . ....  . .  .#.# ..  ......  .. . ..#.#..  .#.#
#.#.###.##.#.# # # #.##.##.# # ##.#.# #.#.#  .  ## # #.##.# # ##.# . . # #.  #
#.# ..##.#.##.#.#.##.##.##.# # #.##.##.##. .#.#..  .. ..#.# #.#..  #.# ..  # #
# ..#........... . .. ... ........... . . #.#.  ##.# #.#.. ... .##.#.  ###.  #
##.#.##.##.##.# # ##.## #.#.##.#.# #.#.##.. #.#.. . ....#.#.#.#......# #.. # #
#   . . . ... .=.. . .   . .... .  . ..  .# ..# ## #.#.# # . . .## # #  .#.# #
## ##.#.#.# # #.#.## ## #.#.#.#.#.## #.## # #...#.  .    .# #.#.   ..  #. .. #
##.## #. .# #.#   .. ..#. .. #.##.# ##.##   . #..#.#.# # ## # # ## #.# #.#.#.#
#.. . . #.. ....# #.## .#.#.#..  . .. . . #.#.# # . .#.#.#.. . ... ..#.#.# ..#
# # # #.# # # #.#.# #  #  #.## ##.# ##.## #...  ##.#. . . #.##.#.#.# . . ..#.#
#.#.#.#..... ...  . .#. #  ....... ...  . #.#.#......# ## #.##.#.# ..##.## #.#
# . . #.#.# #.#.#.# ##.#..###.## #.# #.##. . .. ##.#.#.......  ..# #... .. #.#
#.# # ........  ...  ...#...#.#.#.#.#.#.# # #.#.# ##.# #.#.#.##.## ## #.#.##.#
#.#  .###.##.# # ## ## #.##. .... ... . .   . .. ....   ....      .  .  .. ..#
#...#... .. ..  ..  . .... .#.#.#.#.## ##.# ## # #.# #.##.#.##.## #.#.# #.# ##
#.#. .##.##.#.# #.#.##.##.#..#.#.#.# # ##  ..  #..# # ## #.#.##.##.#.##   #.##
#   #.#.#.#......  .  . . .#.  ....  .  . # ## ..#... ..  .......  .....#. . #
# # .  .....#.#.#.##.# # # #.##.# # ##.##.##.#.#.# ## #.# ##.# ## # #.# #.# ##
# # #.#.##.##.. .. .. ...  .. . .  ... .  . .   . ...    . .. ... .. .. ..  .#
#. ..  . ...  ## ## ## # ##.#.# # #.# ##.# #.#.##.#.#.#.# #.## ## ##.#.#.# # #
# #.#.## ##.#...##.# # ##.. . .. ...#.#.## #.# #.# . . .  .#.# # . .#.##. .# #
#  .#.##.#    #...    . ..#.#.#.#.#... .   ...  .  #.# #.#. .. . #.#.... # # #
# # ..... # #.# ##.#.#.##..      .### ## # #.#.#.### ...   # #.#   #.#.# #. .#
#.# #.##.##. .. #.... .##.#.###.# ... . .#.  ..= . o #.# # # # # #  ...#...#.#
#=#....# ...#.#.#.##.#... #.. .  .#.##.#...# # # #.#.. .. ...  .. .###...#. .#
# # #.# .##.# #.#.## ..##. .#.#.#   ##...#.  . ..#  .#.# #.#.#.#.#.. . #. .#.#
#. . = # ## .. .#. ..# . .#. . . .#  ..# ..# #.# #.#.# ## ##.#.#.# # ##.## # #
#.# #.##....#.###.##.. ##...#.# #. #.#   # ... .. .......         .. ....  #.#
#..  .. .##.. . .. . #. # # #.... # ##.#.#.# #.#.# #.# ##.## ##.## ### #.# ..#
#.#.#.## #..# #.# ##.  # .....#.#... ...  . ... ........  ..   . .  . .  . #.#
# . . .. .#. ...#.#. #. # #.#.#.#.##.# ##.#.##.#.#.# ##.##.#.#.#.#.# ##.## #.#
#.#.# ## #. #.# #  #...##.  . #.# ## ###.# # #.#.#.#.##.#.## #...#.#..#.#.## #
#.#.#.#. .#.#...  #. # . .#.#....... . .. ...........  .. .. . #....# .....  #
#. ... # # .  #.# ##.##.#.. ..#.#.## #.#.#.#.#.#.## # #.# ##.# . #.##.# ##.# #
# # #.##.## #.#.. .. . .. #.##.#  ##.# #.#.  .#.#... .#   ##.#.#.# ..... ..#.#
# ..   ...  ... #.##.#.##.. . ..#.  .\.....#.#o ..# #...# ....  .  #.##.# #..#
#.#.#.## ## #.# # ##.# .#.#.# ## #.##.## # ## #.#.#.#.#.#.#.#.# ##.## #.# ## #
#... .##..   . . . ... #....... . ... ... ..    ...     .  . .... ..     ... #
#.#.#.. .##.# #.#.## ##.# #.#.##.# #%#.#.##.#.#.# #.##.# #.#.#.##.#.#.##.## ##
#.    ## # . ..    . . .  ..... . .  .. .. ..... ..... . .....  ....  ... .. #
#.# #.#.. # #.# # ##.### #.##.# ## ##.## ##.# #.#.#.##.##.##.#.##.# ## ##.#.##
#. .. .# #..... . . ............ ...  .  . .. .  .. ...    .... ...... .#  ..#
##############################################################################
