##########
#=    . .#
#=###o## #
# #.#   .#
#.#.#.#%##
#. .o #\##
##.##.   #
#=# #o#.##
#=o ..   #
##########
