###############################################################
#..  . .# #.##.#  #   . ..  .  .  .  ...     . ..# #.# ..   ..#
##.#####.. .. . #..##.# #.## #.# ###.#.## ######.#  ...###.####
#   .  .#.######. #..# # ##=# # ## ##.##.#. ...#.#.# #.# # # .#
##.######...  ..#. # ..  .. . . ... ....  #=###...#.## # #.## #
#. ...... ##.## # #..### # #.##.##.# # ###..   # #.... # #. #.#
#########.# # ###.##.#.## #.#.### #.# ##o## #### ###.#.#.#.# .#
# .. ..  .... ..  ..  ...  .. .. . . ..... .. ..  .#.# #.# ## #
##.# #.## #.## #.# ## #.#=####### ##.# ##.#### #.# # #.# #....#
# ## # .# # # #.#.#.#  # #   ...#.#.# # .# . .#.#..#.#.#.#.####
#. . # #  #.#.# #.#.#.#...# ##.##.#.# .#.#.# ##.###.#  #.# #..#
##### #.# #.# #.# #.#.##.#   #.#  #.# # .# #.... .. .# # #..#.#
#.   .... # # # # # # .#. # #  .#.#.#  #.#.#.###.##.#..#.#.#..#
### # ###.#.#.# #.#.###  # .##.#..#.  ##.#.#.# .#.#.## # #  #.#
#..# #  #.# # #.#..   .#..# .#.##..##.#  # #..# #.#  # #.# #. #
#.#  ..## #.# # #.###.## ##.#...# # # ##.##..#..# # # .#.#.## #
# #.## #..#.#.#.#.#.#.#. #.. # #. #.#..#.. #.##.#. ..#.#.# .#%#
#.# #...# # # ..# # . .#=## #.  # #.# #..##   # .## #  #.#.## #
#.## #.##.#.#.#.#. ##.# ..#. #.#. #.# ## #.# ##.#.##.# #  .  .#
#...... . #.# #.#.###  # #..#.. # #.#...     .  .  ..# .### ###
#########.# #.# #.##.##  ##  #.## # ..##### # ###.#.##.#.. ## #
#   . .  .#.#.# .... . # .#.#. #. # # #  . #.#. .# #   o##....#
# #.##.## #.# # #.#####. ## ###.##=##.####.#.# ###.### # #.####
# ##.## #.#.# #.# #  ..# .  .. . ....  ..   ....  .   ... ....#
#. .... #.#.# #.# # ###..#.##### #.##.############### ## ### ##
#.####.##.#  ##.#.# .  #.# #. .#.# #.#. .  .. ..    # .# #.#  #
#.#. . # .#.#...# # #.# .# ###.##.  .# ####### # ### .# ## # ##
#.# ## .#.# ###.  #.# .#.#..  ...# ## .# .....#.. . # #..  ..##
# .# #.#  #.  #.##  ### .# #.# #.#  .#. #.#.#. #.##.# #######.#
# # .#. # #.#.#. .#. . #.#.##.# #  ### # # ##.#.##.##........ #
#. #.# # .# #.#.## .# #  # . ..  # # . .   . .   . . .# # #####
#.#  # .# #.#.#.# # .#.#  ########  # ## ##.## #.# ##. # # .. #
#.##.#.#. #  ##.# #.## # # .   . ..#.# ##.##o## #.# #.#..#.####
#  # #  # # #.. #.# # .# .##.#####.#   .   ..  ...  .  # . .  #
# # .#.#  # .## #....#.# #.#.    #  #.#.####.## ## ## #..######
# ## # ##.# # #  ##.#..# #. .####  #..# . .#  # . # #  # .   .#
#  #.# .#.#. .# # .  #.#  ##.   .# .###.#.#  #  ##..# # .##.###
# ##.### .#.# #.# #.#  #.#...## ##.# . ..#.#..# #.#.#. #.# .#.#
#... ...# # ##  #.#..#.#  ##.#..#. #### #  #.#  #.# #.#. .#   #
#########.#.  #.# #.#..#.#.. .# .#. ..# .#.#..# #...#..# # ####
#  ..   . #.### #.# ##.#. ##.#..#  ## # ##.#.#. .##.#.#. ... .#
#.#.##### #.#. ..##.  .#.#.#..#.##..#.#.   #. # # ..# ##.######
#  ##. .#.#.#.#.#. .## #.#  .#.. # #..#.## # #. ###.# . ..   .#
#.#...##..#.#.#  ##..#.#.#.#..#.#...#.#.#..#  #.  #.#.#########
#  ##.. # #. ##.# #.#. #  #.##.# # #..#. #.#.# .#.# # ..    ..#
#.# #.### #.# ..#.#. #.# # . ... .  ### #..#..#. ##.# ##.#.#.##
# #.  # ..# .##.#.# ## #..## ## ## #. . ###..#. #  .#.#.#.# # #
# .##..## #.# # #. .#..#.##.## #.#.# ##.  .#.##. ## #. .. .  .#
#.# #.#.. # # #.### ## #.#...  ....#. # #.#.. #.#.#.#.#########
#.# #  ##.#.# #. .# .#.# .#.#.#.##.#.# \#. # #    # #...   o..#
# # #.#.# # #.#.##. #  #.# #.#.# ## # ##.## # #####.# ##.###.##
# #.#.#. .# # .  .# ##.# .. ...  .... ..   . .. ....#.# .#.#..#
#.#.#.#.#.#  ##.##.  #.#.## ## # ## ################# .#.#.# ##
#.# # #.#.#.#. .# #.##.#.#..# #. #.#.......  ...  . ..#.## #. #
#   #.#.#.#.#.# # #.#. #..#.. .#.#..#.##.## #.#.# ###.#. ....##
# #.# # # # ###.# # ####.#.#### ## # #.## ## #.#.## ## ###### #
# # # #.# #. .  .      .. . .. . ..  .   . .. ..  ....   . . .#
# ###.##. # ##.# # # ######.## ############## # #.##.## #####.#
#.  ..  # # ..# # .#   .  .#.#.# ......  .  #.# ## #..#  .. # #
#.##.#.#. #.###.###.######## ## ##########.#.#.# # ###.#####.##
# # ##..#.#..   .. .. .. .... . .. .. ..  .....    ..  .. . . #
#.#... #. # # ##.#.#.##.## ## # #.#.#.## # # # #.##.# # #.# #.#
###############################################################
