################################
#.#.#.#.#.#................ . .#
#.. .o. ..=.##.###.##.#### ##.##
#.#.###.###.#. # #=#  #. #.#.. #
##.# ..# .#..#o..#.###..#..#.###
#....# # ##.# .##.....#..#. #=.#
##.#.#.#.# .###.#######.# ##.#.#
#..#.#.#. #............ ... .=.#
##.#.##..#. ##.##.### ###.##.###
#..#...#..#.#.# #.#  #. .#.# ..#
##.# ##. #..#.#...##..## ..#o#.#
#.##.#.#.##.#.####.#.#.#.##.#o##
#..=.%.... ...... ..... .... ..#
###.#######.##.###.#.###.###.###
#. .......#.#\ ..#.#.. # ..#...#
################################
