################################
#  . # .  . .    .    .     .  #
# ##.## #.###\#.## ## ##.## # ##
#  ..  .   . .   ..o  # . # # ##
##.##.# # #### # # ## ### ## # #
# .##  ..  . .    ..     .   . #
##.   # ###### # # #.### ##### #
# o##     .%. .. #  .   ... =.=#
## # #.## ###### ### ## # ## #.#
#.=  .      .  .  . .     # .. #
#### ####.# # ## ###.## # ### ##
# =            . .  .   .  . ..#
## #.## # # # # # ## #.# #.## ##
## # ## ## #  # ##   # # o #.  #
#  #   .    # . o  # #.# #  #.##
################################
