############################################################################################
# ## #.#.# ## #..... ..  . # #   # #. ...#.# # . ## #.#.# #.##.##.# ## # ##.## ##  ..  #.. #
# .= .. ...  .# ############.  #.#.# #.##..#.#.# ....   .  .. .   ..  . . .... . # #.#.# ###
##########.##    .. . ..  . .#. ....  .. #    .#.# #.# ## ## #.## #.# ##.#.###### .#.# #...#
#.  ...  ..   ### # # ## ### .#.##.##.### .# ###. # #.# ##.##.#.##.##. #..#   .. #.#.  ..###
# ##.#####.## # .# ##.#. #.#.#.# #.# ##.## #.#.. #    . .. . .. ...   ## ##.##### . .### # #
##.#.# .. # #.#.#. .  .#.# #.#....  . =.   #.###.### ##.## #.##.## ## #   .   .. #.#.....#.#
## ### ## # # #. #.#### .# # .############.#... .. ....#   #.#.# ##.# ## # ##.# #  # #.# . #
#. .. ...  .  # #.. .. # ..# # ..    .  .  # #.# #### ##.#   #.#. #.#..#.##. # . #..# ##.# #
# ########### #..#.###.#.#.. # # ## #.## # #.##.... ..  . ##.#. .#..#.# ...#.#.# #.# ....#.#
##. .. .    #.#.#.. .# #.# #.#.#.#.#.#.#.#.#.  # #.##.##.#.#.### .# #.## ### # #.#..# ##.  #
##.###.# ##.#.#.## ## # #.##..#.## #.#.# #.#.#. .#.#.   .#  .  # ##.#..#.#. .# #.#.##..# ###
#  ...## # ##=#... .  .  ....#.   .#.#...# #.# #..#.#### #######  ..#.##..##.#.# #.  .#... #
##=##.#.     ..############# #####.#.# #.#.# ## .#.. ..... .     ### =#. #.# # # #.## ## ###
##.##.####### #.  .. .  ...  .. . .  .  .# #.  #. ##############.#.##. #. .#.# # #. # .# #.#
#.  ...  ..... ######.##.# #.### # ##.##.# #.##  #  . ..... ..    =  .#..# . #.#.# #..# .  #
## ###.###.##.#.  .... #.#.#.. .#..# ###.# #...#. ##.#.### ####.#.# #  # .##.# # #..#. # ###
#...   #   .# #.# ##.# #.# #.##..#.# ## .#.# ##  #. ..#. .# .. #.#..# #  #...# #.# # .#. # #
##.### .#.#.#  #.#.# #.# #  .# .#  #.. # # #.#.#..### .# #..###...#.#. #. ## . # # ##.##.#.#
#..# . # ...# #.. . .# ..# # ## .#.#.#.#.# # ..# #. # #...#    #.# .  ##.#   # #.#..#..#=..#
## #.# ####.#. ##### #### ## .#.## #.# #.#.#.##..##.# ##.##.##.# ####.# .#.#..=#.# ##.#..###
# .#.#.. ...# # ..=. . ..    ## # ##.##.## ###.#.  . .... .    . . .#. #  ##.#.#.#.#...#.. #
##.#.# ### #. . # #.## ## ##.  .  .  ... .. .  # # ##.###.#.#.##.#.#. #..#.  .  .. =#.## # #
## ##.## ## #.#.## # # # ##.#.##################.#.#.##..# #.#.#.## # .#. # #.#.## #..#..#.#
#..  .   ....    . .  ... ....... ...   ...  ..... . ...#. ..# ...#.#.#.##.#.#.##...# .#.  #
# #################.################# #.##.# ### # # ##..# #..##.# .# ......  .. # # ###.###
# #. .   . ....  ... . .   . . .   . # #. . # . #.#. #..## #.#  . #.# #.##.###.##    .. ...#
#. ##########################.########.## #.# ### ## .# ...#..## #..#.## # #.#.# # ####.#.##
# #    ... .. .  . ...  ..   ... .. .  ..  .#.# ...# #  ##.# #.  ##.. . .#.# #.# # #  ..#..#
# # # # #.#.## ##o###.#.#.# ## #.# #.##.###.# .##.# #.#.## #. .## # #.##.# #.#.# #.# ##.# ##
#  #.## #.#. . #  #\## #.#.##.# # #.# # #.#.#.# ...     .    #..... . .#.#.# ### #.. #  #. #
# # .  . #.# ## # ...  ... . ..... ... . .# # .#.#### #.#.##.###.####.# .# #. ..   ## ##.# #
#..#.## # . .   . ###.##.#.## # ## # # # # .#.#. #..# # #  #   . #..#..#.#..# #.##    .  ..#
#.#.#.##.######.###.##.##.#.## ##.#.#.#.#.# # ### # ##.#.### #### #.# # ##.# #.# #.##.##.#.#
# #    . . ... .  .......     . . .. ....   ... ....    ... .   .. ...  ........ #.#  # #.##
#..## # #.#### # # # ##.##.##.##.#.### #.#.## ## ########### ##.##.##.#########.#...###  . #
#.# ##.##.#.. #.#.#.#. #  #.. #.#.# .#.# # #..#..#.  . .  .  #.#= #.#.# ..  ... .#.# .. #.##
#.#  ... ..# #. .....# ## ###.#.#. #.##.#   #. #.  # # #.###.# . #.   .# ## #.# #  ####.## #
#..##.#.#.# .###### # .  . . ..   # . = .#.#. #. # #. # # .# # #.#.## #..#..##...#..    ...#
# # #.#.# ## .. ..#. # ##.###.###. #.#.##.. #..#.# #.# ..=#  #=#.#.#.. ##.#...#.# .######.##
#.#. .# #... ##.##..#.  .#. .#..#.#..#...# #. ##...#   ##.##.#.#.# ## # ..  ##   #.#   ....#
# #.##.#.### #.##.# ####.##.##.##.## #.#.# ##.# .##. #...    #.# ...#.######.###.# #.#.# # #
#.#. . . . .. .... ..    ... .. .   . . . ..# .#...#..### ##.# # #.#. . .........# # ##.#..#
#..#.# #.## #.##.## #.##.#.#.#############.## ## #...# .#.#. #..=..## ##.### ###   #.....#.#
# #.#.#.#.## ## ##.#.#  #.#.#. . .   .. .# #..#.. ####.# # #.###.# .# #..# # #.#.#.#######.#
#.# #.   ..  ..      .#.# #  # #####.#.#.#.##. # #. ... . .....# #.#. .# #   #.. #  .... ..#
#.#.# ##.##.###.## #.#  #.#.#.# .  ..#.#.#. #.# .# # ##.# ##.#.#.#  # #..#.#..##.#.## ######
#.#.#.# ##.##.### #.#.# #.#.# ###.#.# ## #.#...# ..###.#.#.# #.#.###   #.#...#..    # #  . #
# # . ...  .   .  ... . .. .  ....   .... . # ##.#... ... .#   #. ..# # . ## #.#.#.#..#.## #
#..##.##.#.##.#.#.##=# # # #.# # # #.#.# #.#..#  #.#.#.# #...##..##.# ## ## .# #.#  #.#..# #
# # ## ## # ## # # # ##.# # # #.# #.# #.# # # # # #.# #.#.####.# #.##  #...# #.#.# #  ..#. #
#.# .. .=.  .. .... . ..    ...   .. .....  . . ...     . ... . . ....#. #.#..... . #.# .#.#
# #.#.#.####.# ##.#.####.##.##.#.######.## #.## ##.# ##.#.##.#########.##.##.###.# #.##.##.#
#.##.#  # ..  #.#. # .. .#. #.#.#...  .#. # # #..#.##.##.# #.# . .. . .. . .  .... ... .. .#
#  .. #.# #.# . #.#..### #.## # # #.####.#..#.. #.   .   #.#..#####=# ##.# #.#####.# #######
#.####.#.##.# ## #.#...# # .  # # .    ...#o#.##.# # ### #.#.#.... .#..#. #.#... #.#...   .#
#.........  ..    .# ##..#.###  ..##.###.#. ..... .### #.# # ### ###..#  #  .# # #.##.#.##.#
#.# #.#.#.#.##.###..  .#.#.. .#.#.#. #....#.#.## #.   . = ..  .. ...#.##.##.#.## ##.# ##.###
# ## #.# ## #.##.### # ### #### #.###.## ##.##.##. # ##.##.# #.# ###... .  . ........ .   .#
#. .. .  .  ........%   ..  .    . ...  .    ....# #  # #  ..  #.  .#.###.#.#.#.#.##.##.##.#
#.#.##.##.##.## ##.#.#########.#####.####.#.#.#.#..#.#.  # #.#. .# #..#.# # #.# ##..##.# ###
# # ...# #. #. .#.# .#...... .. .. #.#   .#.#..  # #..# #..# .## # ##.#.#  .. # ..#.#. ....#
# # ##.# ## #.# #..#..# #.#### #.### # ###  #.# #=.#.#  ## # #.#.##.#.# #####.# ###..# # # #
#. ##.##. # # ..# #..#. #.#  . .... .#.. .# # #. #.#..# .# #..  . ..# #.  . ... .. .#  # #.#
#.#..  . # .  #.# ###.##.# ##.# ###### ### ..##.# .#.## #.#.### ####.. ##.# # ##.## ##.#.#.#
# #### #.##.#...#. .... .    .  .. ...   .#.#. ..#.# .. .   ...  . .# # ..#.#.# . #..#.#   #
#.. .# #  # ### # ###.## # ###.####### ## #.#.#.#. . ## ########.###..####  ##.#.# .#..#####
#.# #  # #.  ...#..  .#.##.#.#.... .... #.#..##.## ## #.#.  .  ..#..#. .  #. ..#. # .# .. .#
# #  # #..###.#.#.# #.#  ..# ..#.#.# ## .. .#. . #.#.... .## ### #.#..#.#.# # ## # .#..# #.#
#.###.=#.##.## ## ##.#.###.#### #.#.# ##.##.  #.# ..### ## ##..# # .#. # # # ##.#.# .# # ###
#... #.#.#  .. ....    ..  .. .. . . .  .   # # .#.#... #. ...##.# #..#..........  .#      #
#.#.# ...# # #.#.## ###.###################.# . #.  ###.#.# # #  #.##.# #.##.## #.# .# # # #
#.#.####  #.#.#.#.# ..  .  .   ... o . ...  .##  # #. #.#.###.##.#..#. .# # .#.# #..##.#.###
#.#    . #... ......###.# # ##.#.#.# # # ## ##  # ..#.# #... ..#.# #  #.#.##.#.# ##.#..#. .#
# .## ## .### #.#.#. .  ##.#.##.#.# #.# #. .  #. # # ...# ### #. # ##.# #... ..  .#  #.# # #
# # #. #.##.##.# #.# ##... .  .......  . .# # # #..# ##  ##.#.##.#. # ## .###### # .##.## ##
#.# ####.#  ..=.    .  .####=# # ########## #... # ##.#.#. . . ..# # . .#.#....#. # ....  .#
# #  ...  # # ##.##.### #....# # # .    .. .#.# #.... #.# ##.#.# #  #.##   .# ##.#  ## ## ##
#.###### # ## #.# ### ##.#### #.# #.## ###.#.#.#.######.### #.##.# ##.#.## ## #.# #.##.#.# #
# ..... ..... .......  . .  .. ... ..=..    ...  .. .....      .   .   .. .  .   . .. .   .#
# # #.########### #.### #.# # #.#####.##.## #######.###.# ##.# ##.## #.# # # #.##.#.# ####.#
#.#. # . ... =..  #...#.#=# ##.#.  . ##.##..# ..   .# .#.## #.##.## #.#.#.#.#.##.#.##.#. ###
# .#  #### # ####...### # #  . # #### ....#..##=#.# #.#.. ..      . . ... #. .. . ..  .#...#
#.#..#..  .# .    #.#    .# ##.#  . # # # # #o##.##.#..####.########.#### #############..# #
#=##.######.# ###.#.###### ##.## ## # ## #. #.. .. .#.#  .. . .... .#.    .   . .... ..# # #
# . .  . .     ... ..........  .  .  .  . # ## ####.#.#.# #.# # #.#.. ## ###.#.# ### ##... #
#.##.## ### ###.#### # ##.###.#############..#  . #.#.##.# #.#.#.# ## ## # ###.### ###.#.###
# # #.#.# # #..# .  .###..# #.....  .... ...# .## #. .. ....  .... . . . .. .    . . .. .. #
#.#.. ... #..#.###.#    # #.#.### #########  #  #.# ############.#########.#.####.#.## # #.#
#.##### # # #.   . . #.#..# #.# # . .  .... # ##.##.# ... . . ...# ... .. ..... ..#.# #.#.##
#  .  #.#    ##.# ## #. # #. .#   # #.#.#.#..  . ....#.#.# #.#.#  #.##.# #.# #.##.# ....   #
############################################################################################
