########################################
#     . # \. # .  . . ##.## #   #. # ..#
##.#.##  #.# .#.#.# # . .  .  #. #  ##.#
### .#..#. .#. ..##  #.#.##.##..# # #  #
####  # ..#.  ## # #. ...  #. ##  # ..##
### .## # #.###    .# ## # .#  . #=.#. #
## ##    # . .. # # # # ###. #.##. #  ##
# .#  # #..### # .#      #.#  .#. ###. #
# #  ### .#. #. ##..##.#.. . # .#  # # #
# # ### .### ..# ..#. .# # ##.#  # ..# #
#... #.#.## .#. =#  ##..#.# ..# #. ##. #
## #. ..# . #..#. #  ##   .##. .. # = ##
#  #.##..# #  #. # #..# ###.. # #. .#. #
#.#   .# #   ##=#  # # .. #.# .##.# .###
##  #.#  .## #. .#..#  ##   .# . ##.# .#
#.# .#. #  #.  #   ### ..#.# . #...### #
#  #.#.#  #=.##.# # ##.#..##.#. .#  #..#
# ###. .##  #   ##..  ### #  #.## #   ##
#  ####. ..#  ##  ###  ### .#..   #.#  #
##  #. # # ..### #  ##  #. #..# ##   # #
#.#  #.  ..#. #.  #..# #  # .# .  #=#  #
#. # ## # ### . ##.#   ..# # .## #. ..##
# #    #.#.###.#..  #.#.# . # . #.# ## #
#   # #    .# ### #..# .# #  ###    #..#
## # # #.# #.. #   # . #. ##.    #.###.#
#. #  o# .#  #   #  # ###   #.#.## .# %#
#.##.##. # .#.#o#.# .# # #.# o #   #  ##
#.     # ..##  ##  #.    #   #  .#  #.##
# ###.#  #   #..  #.# ##  ##.#.# ## .. #
# #..   #.##   ##.  # #.##. #. # .  # ##
#   # # ..# .# # .##..#  . #  ### ## .##
# ##  .#.##.# .  # . # # #. #..## .##  #
#.   #.. .  #.##.  #...   #  .# .#..##.#
# ##   #.# ## .  # # ##.# .##...#.# .###
# #. #.= # # # ## ..# o#. #  .##....# .#
#  ##. #. # .. #  ##  #. ##.#... # ### #
##..# #=#. .# #  #  .#.#  . .# # #..## #
###.  ..# ## ##.## ##    # #   #.## .  #
#### ##.  #   ..  ..  ##  . # # ...#.# #
########################################
