########################################
#   . . .. . # # #.# #     # #     # #.#
#.#.# ## ### #.    ..#.### #. #.#.#. # #
##.# # #.#.   # ####.# #.# # # ..# # . #
# . .  ..# #.# .#  . # # ###. # ## # # #
######### ## ## ####.#..... .#.    # # #
#   .  .. . . #.\ .#  ######  # ###. #.#
# ##.## # ### ####.# #.  .   #.%#. # # #
#  # #. #.#.#.  ..#. .######.##. # # ###
# #  .#.# #.  ### .# # . . = .  ## #.  #
#. #.## # # # #o  #..# # # ## # #..# ###
### ## #.# ##.####.# # # #..# #.## #  .#
#.... . .   . .     =##.#.##.#  . .# ###
######### #.# # ##.# .    .   # ## # # #
#...   .. #.# .# # # # ##.#### .# .# #.#
###.#.### ##..#. # # #.#.#   .#..###.# #
# .# #   .  #  # # # # #...##.# # .  . #
# ## #### # # #  #.#.#  ## #. #.#.##.###
#   .. . .# # ## ## .#.#..  # #  # #.# #
### ## ##.# #    . # #. ## #..#.#.. .#.#
# #.#.# # #.# ### #. # #   ###  .###.# #
# . # #   ##  #. #.#.#.###  . #.#  ..#.#
# #.#. ##  .#  # # #.#.  #.###   #.# # #
# #.# #  .## .# .#o# # #.#. = # #.#  # #
# #.#  ##   #. #.# #.#.###.###.  o.#...#
### # # # #.# #=.# #.#..  ..  # ###  ###
#   ....# ##  .# # # # # #.#.#... .# # #
#.# #####.  # #  #o# ## #.#.# # #### # #
#.# # .. .##  .# # #. ..    .= .. .  ..#
# #  ##.# ..#.##.# ###.############### #
## ### # ####.. .   .#. ... ..     . # #
#. ... .. = . # ### # .## ##.##.# # # .#
## ## #.#.# #.##.. #.#.# # # #.# #.  #.#
#.# ## # #.## . # # . .#.#.# .    #.#.##
#   . ..    . ### ######.# #.# # #.....#
####.######## #.  ...  .  . ..# #.#.##.#
#  .        # =## #.## ###.#.#      #. #
# ## ##.### # # # #.#..# # #= # # #..# #
#. # #    #.#. .#.#  #.  #.#.#  # #.#. #
########################################
