############################
#  #..# \#.# # . .#%=   .  #
##.## # #  # #### #######.##
#  .  .  #         .  .....#
## #######.### ## ## # # # #
#       .  # # #   # # ##.##
### ###### #....###.##  . =#
#        # #.# #   . . ## ##
###.# ## #.# # #.## ##  #  #
# #  #.### #.# #  # #  #o ##
# # #  o  ..##  ## # #  #  #
#  .# ## # #  .#.     o#  ##
# # #. # #o# # =#.##.#= #  #
############################
