#########################
#.. . .. %. . . . .  .  #
#.# # ## # #.#o#.# #.## #
# ..  .. # # #.#...   . #
# # #.##.#.. ... #.##.# #
# .  . ..# # # # .  ..#.#
#.#.# ## .. .# # # ##. =#
#.#.#.   # #    ...  =# #
# .. .##o....#.# # ## #.#
# ##.#.# #.# #.# #.##.. #
#.... .   ....  ......#.#
# ## #.#.##.## # # ##.#.#
#  #.   . # ##  .#...   #
#.#..#.#.#.....#. .## #.#
#.##.#.#.## ##.#.#  ..#.#
# ....    ....... .##.. #
# #.## ## # # ## #o##.#.#
# . . ..... ..    .. . .#
#.# ## # ## # ## ##.## ##
# o.# ....   .   .. .. .#
#.# .#.#.##.## #.# # #.##
#.#.#.  .. . . ....... \#
#.. ##.#.##.##.##.#.##.##
#=#.  . =   . .=   .....#
#########################
