##################
### #   .. # # #.#
##   o###.# .   =#
#. ##\# # ## # # #
##         o # # #
#  ##.# ##.#  #  #
##  # .#   # ##.##
#  #..##.#      .#
## .#    # # # # #
###   ## # #  #. #
##.## # .# #.# # #
#  .#  #.    =  ##
# # # # ## ## #. #
# #      # # o# ##
#   # #.#  =#o =.#
# ###%##.# # #####
#   .    .       #
##################
