########################################################
# #. # # ## # #.#. ..... .       #. ...  . . #  #.# . .#
# .#.   .. .#.  ##.# # ##.## ###  # ## ###.# # ##.## ###
# #.#### # ## ##=##.# #.## # # # #  .#.  .# ## .     ..#
#   ...   #..    . .  . .   #..=. #.## ##.# ...## ##.#.#
## ###=# #  ##.##.####### #.# #.### #. #. # ## # ##.##.#
#  . . #=.# #....#  .     # # .#     # .# # #. #.. ....#
#.#.## # #  .###.#.# # #.#. #.## ####.# ### #.#.###### #
# #. # # .# # .... #  #.#.#.#.  .. .        .. ..  . # #
#.# #  # #  ####.##  # . . #  ##### # #.#.##.## ##.# # #
# .##.## .# .. #.#.# #### # #.#.. ###.##.#.## # #.#. #.#
# #.  # .#  ## #.#  .    .#   #.#    .  .. ...# ...#.#.#
#.#### # ##.# # # ### ## #.##. #.# ## # # ###.# # #. # #
#.   =. ...    . .. .##.##  ..## ## ###.##  #..#.# # #.#
#.#.## # ### #.#####.... .#.# #  ..      . #  #    # # #
# #  # #.#  ## #.   ## # #  #. #####.#.###. # .#.##% # #
## ### # ##.# #.# ### #.#.# #.#...  # ## #.# # #  .#.#.#
#.... .#     ...     . .# #.# # ###      #o#.# # #.# ###
# # ##.#.# # ##.# # # #  .. #.#=# # ####.# #.#.#.#.#.. #
##  # .#.#  #.#.# ## #.#### #.# #.# # ..#  #.# # ##..###
### .#  # .#..# #.        # # # . # # #.## # ..# ..# #.#
##.### # ##.#.# ##########..#.#.## .# #. #.# # # ###.# #
#... ..  ..   #.. .. .   .#..## #.###.#.#  #.#..  .  #.#
## # #.### ##   #.##.##.#.#.# . .  .. # ## ##.### # ## #
# # .###..# .## #  #  #.# # .# # ## ##  .. . .. #.#  . #
#  #     #.# #  #.#  #..# #.# # ## ## #.#.# ### # #.#.##
# #.## ##.   ## #. #. ### #o    .    .# .# #  #.. #.# ##
#.   #.##.##  #.# #. #    # ## #.##### #.. # ##.##  #. #
##.#.# .   o #. # ##. #.###.####.#  .  #.#.# #..#.#..# #
#.#.  .#.# #.##.#..# #.  . ..#.  #.###.#... ..# #  .#. #
# #.##.# #....# ### # ##### #  # # #..  #.##.##. ##.## #
#.. . ##.#.# ## ..   .  . # ###.  # ## #  #  #..# #..#.#
#.#.#..  #.# #.###.# ####.# . .#.#  .. .#.##.#.# .  #.o#
### #.### # ##.#. #.#. .  # #.# .#.#.### # #.# #.## ##.#
#.. #.      .  .#.# .##.#  # #.## . ## ..    # #. #  # #
#### .#.## #.#.#. .# #  #.#  . . # # .#.#.## #.#.#  #. #
#   #   # #.# # # #   #. .# #.# #...#.##.#   ##.# ## # #
#.##. # .... .#    # #. # # # ##.#.#   . #.#   ..    . #
# #.##.######.###.##.#### .#  ....  #.##.#.#.##.##.#.#.#
#. . ...   .           . .### #=#.# #.# ##.## ## # #.# #
#.## #.#.# # ######.## #.# #  ## .##  #   .   .#.  ##\ #
# ### #. #  # .  .#.#.. . = # . #.. #.## ### #.###. .# #
#  # .# # # # #.##. ##.####. ##.# ##   #.#.# # .. # # .#
##  # # #..#. #. .#..# #..# # ### # # ##   # #.### # # #
#. #. .# # ## #.# # #..## #.#     .. .  .#   #  .     .#
##  # ## # .#.# #.# .#... #.##.#### #####.###.##.## ## #
#..# . .  #.# #.##.#.# # #   .#   .#  .. ..  .   #  .#.#
##.# ##.# . #  #.    # #  # # # ##. ## ########## ####.#
# . # ### ###=# ####.### ##.# # # ### # . ......   . . #
##.#...  .  .  . .=  ...#..#.## #.. .. .# ## ##.###.####
#  #.## ## # ##.#.#.# #..# .. .. .#.#.# .#.# # #   ....#
## #..#...# #.#..#.#.# .# ######## #.##.## #.# ..## ##.#
#  # #  #     .###.# .#.     . ..   .  ..  .#  # #  # ##
## # ## # # ##   ..#.#.## #.## ############.#.#. .#..  #
#..# . .#.#.#  # # ...  #.# #.           .# . .#.# .## #
########################################################
