##########
##.#\.o. #
#. ..# #.#
##.# #o .#
#      # #
## ###.# #
#o .... .#
#.#%# ##.#
#o  .====#
##########
