######################
#  .. .# # # # #.#.# #
##=# # .            .#
#== . .#.# #\#o# ## ##
##### # #.#.# # # # ##
#.  o    .   . .     #
## ### ## ### ##### ##
#    #o# ##.#  .     #
## # # #  .   ## ##.##
#.=# #% # # #o#. # . #
######################
