##################################################################
#.# \  #.# #. .  .  . .#. .  ..#. .# #.#....   ..   . #   ....  ##
#  .## # #.# #.### ### .#.# ####.#  . .. #.#### # #.#.#.#.#.# #. #
# #  #. ...  .. .#.  # #.    ... .# ####   #..#   ##..#.# #   # ##
# # ## # # ## #.#.####.#.#.# ### ### . # # ## #.#    #..   .###.##
#   ..  ..       .  ... ..     #..#..#.#.#    # ## #.## #.#...  .#
#.###.#####.# #.##.#.#.### #.##  # # . ..# ##. .  #.     .#.# #.##
#  ... .   .. # ....   #.#   ..# #.# ###..# # #.#. # ## #. .#.#..#
# ##### ###.#o#.###.## .  ##.# # .. ..%  # ...  # #.   .. # #...##
#  .  .   ..   . . .   ## ## #.# #.##.##.# ##.#. .## ## # ..# #..#
#.# ## ##.# # ###.#### #   .  .#.##.#..#.#.#. #.# ..   ..# # .. ##
#.  . # . ..# .    . . .#.# ####..  ..#..# .# # # ## #.#. #.# #  #
# # # # # # #.### #### #. #.    .#### .#.# #.... # # #.# #  ..# ##
# #.#.# .. .#      ..#. #. #.### .  # #  ## #.# # . .#.  .# ###..#
# # . #.###  .## # # . #  #.  ...# ##  #  ... #..# # . ##    . .##
# # # ##... ### #  ..#  # #### #.#.# .##.##.#.# #.  .#. ..#.###..#
# # # .. ##.... ### # .#  .... .   .#.#    .. #..# # ##.# # #.# ##
# . ..##  ..# #..  ..#.##.###.## ###.  #.# ##   ## # ...    .....#
# ### .# ## #.# #####.....   ..#.#.##.# ... . #.. .#.# ##.# # # ##
#.# # #  # ..  ..   .#.# ###.#... .    # ##.##  ## # # ##.# # # .#
#. ..  # # ###.# # # #o# #   #.# # ## ## # .#.#.#  ..     . #.#.##
##### #.   # #. .  # ..# # # ..#.#... #.. #  .# # ## ##### ##.#.##
#.....## #...  ## ##.# . ....# . ..##. # #  #. .#. #.#. .. .. . .#
##.##  ..# #.#.#.  ..# #.#.# # #.#  ..#. .# # #.#.#  # ### # ##.##
#.#.# ##.# # # ##.##.# #.# # #.# # ##. # #...  .# .#... . #. . ..#
#.. . . .#    ..##.# # # #.#..  .#.# .#.  # # # . #..# ##.# ### ##
#.#.# ##   #.##  . .#..# # #.# # # .#  #.## ## .##.#....#.   .#.##
# #.# #. # ..   ###. # # #.###.  # #  #  .  . #   .. # ## #.#   o#
# # #  # # #.##. .#.#. # . ..  # #  #  # ## #.. ##.#.#.#  #   #.##
#.  #.# .# #.# # # ..# #.# ###.#=# # #.#.# . .#..#.#  .## ###.#  #
# #.#..# ... . # ##.## .    ..  . .#   . #.#.# .#.#  #......# #.##
# # #.## # #.# #  # ..##.# ## # ## # #.#.#..#.# #..# ###.# ##   ##
#.# .....  #..   #  ### # #.## # #.#.#.# #.# .#.#.#  .. .... .#..#
#.  #.##.# ##.##. #   ..  ... .      . # # ##.# #.##.#.#.# #.# .##
# #   ##. ..  ...# .##.# #.# #.# #.### #.#. . #.... .#.  ...  ## #
#.#.# . #.##.#.# ##..#.## .# #.. # .   ..# ## # #### .# ## ## ...#
#.. . #  . .# ...  .#..   #..  #.#.# #.# #. . . . . .#   #.. #.#.#
##.## ### # .# #.##. #.##.##.#.# . ###. .# #.## #### ### . # # # #
#     . . # #  . ## ##.#. ...# . # .. .# #.##.   .. .  . # .  .#.#
# #.# # # # .# #   .    # # ##.#.#.#.# #= .   # #.## ### #.###.# #
## # ##.#.#.#.#.#.# #.#.#... ...  .#.# #.#.##.  ..     . .. .. # #
# .  .   .. .. .   . .   #.###.# # ..#.#.# # # ####=### # # # #  #
# ##.#.##### ### ##.##.#        ...#...# #.. .   .. .  .# .    #.#
#.     # ..  .  # # #   ## ###.###..##.# ..# ####.# # # . #.###. #
#.## # # ####.#  .#.#.#.#.  .. . =.# ..# #   . ..#... # # ......##
#  #.### #.. . .# #.#.#. .# #.##.#...# #.#.#.#####.#.##.# ###.# .#
# # . .    # ## # # # ..#.### ##.#.# ..#     . . . ..  ..       ##
# ##.### # ## #.#...# # #.  .     .# # #.##.# ### ##.##.## # ##..#
#  ..#.#. .. .   .# #....#.## ##.# #. ...#.# .. . .   . .. #  # ##
##.# # ..##.###.# # ..#.#  . ..#.#.###.#.# #.# ##.### #.##.### .##
#..#.### # ## # # ..# #.# # ##.#   .. .#...  #. .    ... . .. #  #
##.# . #       .. # .  .  .   .  #.## #. #.#   ###.#.#.###.### ###
#  . #  .#.# # ##.. # # # # # ##.  # # # ..  #.. ..  #  .# . . ..#
##.###.# # ## ##.## #. . .#.# # .#. .... #####.#### #.##.##### # #
# .    ... .. ...  .# ##.#. #. #.# # # # # . .   ..  ..  . .    .#
# # #.## ## # #.# # .  .  #. .#. #  . .#  #.##.# #.# ########.#.##
# .. . . .. # # #.#.######.### # # #.#.#.# ##..# # #. .. ..   # .#
#.#.# ## #.# .#.  #  .. ... ..   #...#    ..  #. ... ##.##.# #. ##
#.# . ## ## ##  #.  #.#.# #.##.##  #.  # # ### #.## ##.# ### ## ##
#. #.#   .. . #  .#.# # . # #.#. # #.# # ...    .. . . . . .... .#
#.#  .# #.##.#. #.# #.. #. . . #.#  .#.# ###.## ##.# ## ####.### #
#. #.#o# #.# ##.#. . .###.#.## #.  #  .#......   ..#...  . . #   #
# #.  . . .  . ..## #...... # # ## #.#.. ##### #### #.## ### # # #
# #.## ####.##.#..#.#.#.#.# . . ... .#.# #..   ...  .. .    .##.##
#. . ..   . .#.. # .. .  ...# # ## # .   #.#.# #.##.# #.#.##.... #
##################################################################
