###################################################################################################################################################################
#............#.##.##.##.#.#.#.#.###.#.#.###.#.#.#.#.####.#.#.##.#.##.#.............#.........#...##.##. #.#.#.#.#.#.#.##.##.##.##.##.#.#.#.#.##.##.#.##..... .....#
##.#.#.##.##........... ...............................................#.##.#.#.##..#.##.#.#...#.......#.. ...................... ......................#.#.#.#.#.#
##......# ##.##.#.#.#.#.#.#.#.#.#.###.#.##.##.#.###.#.#.##.##.#.#.#.##.#.##.# ##.#.##. ......#...##.##..#.#.#.#.#.#.#.##.##.##.#.##.##.#.#.#.##.##.#.##...........#
##.#.#.#........................ .............................................. ......##.#.#.. #.......#... ................. . ........................#.#.##.##.#
##.#.#.##.##.##.#.#.#.#.#.#.# ##.#.#.##.#.##.#.#.##.#.#.#.##.#.#.#.#.#.# ##.#.##.##.#.##.#.#.#.#.#.#.#.##.#.#.#.#.#.##.#.##.##.#.#.#.#.#.##.#.#.#.#.#.# #.........#
#.... ......................................................................... ........................ ..............#.##......... ........ ............#.#.#.#.#
##.#.#.##.##.##.##.#.#.##.#.##.#.#.##.#.#.##.#.#.##.#.#.#.#.#.##.#.#.#.#.##.#.#.#.#.#.##.#.#.# #.#.#.#.##.#.#.#.#.##.#......## #.#.#.##.##.##.#.#.#.#.#.# ........#
#....................................#.##.##.#.#.##.#.#.#.#.#.#..#................... .................................# ## ##.....#.##.## ##.#...#.....#.#.###.#.#
#.#.## ##.##.##.#.##.#.#.#.#.#.##.##...........................#...##.#.#.#.#.##.##.#.##.#.#.#.##.#.#.#.#.#.#.#.#.##.#.........#.#..............#=..#.#...........#
#.#.#.#.#.##.##.#. ...............##.#.##.##.#.#.##.#.#.#.#.#.#..#............................................. .......#.##.##.....#.## ##.#.##...#.....#.#.#.#.#.#
#........ ........##.#.#.# #.#.##.........#............ ....# ##.#.##.##.##.##.#.##.#.##.#.#.#.#.##.##.##.#.#.#.#.#.##.#.......#.#.#.##.##.#.##.#.#.#.#...#.......#
#.#.#.#.#.##.##.#.##.#............##.# ##..#.#.#.##.#.#.# #............ ......... ..........................#.#.#.#.##...##.##..................#.......#..#.#.##.#
#.. ...................#.#.#.#.##.........#..#......#.#.#.#.#.##.#.#.##.#.#.##.#.# ##.##.#.#.#.##.#.##.##.#.......... .#.......#.#.# ##.##.#.##...#.#.#.#.# ...##.#
#.#.##.##.##.##.#.#.##......... ..##.#.##..#...##.#........... . ...... ..................................#.#.##.#.#.#.#.##.##.#...........#.##.#.#........# #....#
#......................#.#.#.#.##.... .##.##.#.#..#.##.##.#.#.##.#.#.##.#.#.##.#.##.##.##.#.##.##.# ##.##............#..... .....#.#.##.##..........#.#.#.#..#.##.#
#.#.#.#.#.##.##.#.#.##.#.#.#.#....##.#.....=.....#...................##.#.#.##.#.##.##.##.#.#.....#.##....#.#.##.#.#...#.##.##.#.#.## #.#.#.#.#.#.#.#.#.#.#.##.##.#
#........ . ...................##......##.##.#.#.##.##.##.#.#.## #.#..... ....................#.#......##...#........#.#...................... ...................#
#.#.# #.##.#.##.#.# ##.#.# #.#....##.#.. ...........#..#... .....#...##.#.#.#.## ##.#.#.#.#.# #.##.#.#.##.#...##.#.#.#...#.#.#.#.##.#.#.#.#.#.#.#.#.#.#.#.#.#.#.#.#
#..........#.##.#.#.##.#.#.#...##.  ...##.##=#.#.##..#..#.#.#.##...#...... ......................... .......#..........#.....#.#.##..............##....... .......#
#.#.#.#.# #..................#.##.##.#..............#..#.........#.#.##.#.# # ##.#.#.##.#.#.##.##.##.#.##.#.#.##.#.#.#.#.#.# .......#.#.#.#.#.##... #.#=#.#.##.##.#
#.#........#.## ##.#.##=#.##.. ...#.##.##.##.#.#.##..#..#.#.#.##.............................#.##.##.#.##....................#.#.##.... .........##.#.#...........#
#...#.#.#.#...........=.=..#.#.##........ .....#..#.##.#.... ....#.#.#.##.#.#.##.#.#.# #.#.# ..... .......##.##.#.##.#.#.#.#....=...#.#.#.#.##.#........#.#.##.##.#
#.#........#.##.#.#.#.#.#.#.......##.#.##.##.#...#......#.#.#.##......... ...........#.#.# #.#.#.#.#.#.##....................#.##.#.#.#.#.##.#...##.#.#...........#
#.#.#.#.#.##.## #.##.#.##.#.##.##.##.#.#. ##...#..#.##.#.........#.#.#.##.#.#.##.#.#.........#.#.#.#.. .#.##.##.#.##.#.#.#.#................. .#....#.#.# #.#.#.#.#
#.... ...... ...........................#....#.#.##.... .##.##.#.....................#.#.#.#.........#.#................... .#.#.#.#.#.##.##.#...##.........#.###.#
#.#.#.#.#.##.##.##.#.#.##.#.#.##.#.#.#.##.##.#.... .##.#.........#.#.#.##.#.#.##.#.#.........#.#.#.#....#.#.#.#.#.##.#.#.#.#.....#.#.#.........#....#.#.#.#.......#
#.=## .......#........ ..... ........ .........#.##.##.##.#.##.# ..... ... ........#.#.#.#.#.#.#.#.#.#.##.#.#.#...##.#.#.#...#.#.......##.##.#.#.##.#.#.....#.#.#.#
##....#.##.#..#.#.#.##.##.#.##.#.#.#.#.##.##.#............. .... #.#.#.##.#.#.##.#.. ..#..................... ..#..........#.#.##.##.#............ ... .#.#.#.#.#.#
##.##......#.#..... ...............#... .......##.#.##.#.#.#.#.#.#.#...##.#...##...#.#...#.#.#.#.#.#.#.##.#.#.#.#.##.#.# #.#..... ... .##.##.#.#.##.#.#...........#
#.....#.##.....##.#.#.#.#.#.#.##.#...#.##.##.#....... ...............#.... .#....#.....#................ ........ ...........##.#.##.#..............#.# #.#.#.###.#
##.##.#.##.#.#............ ....#.#.#.#..#.##.#.#.##.##.#.#.#.#.#.#.#.#.##.#.#.##.#.#.#.#.#.#.#.#.#.#.#.##.#.#.#.#.#.#.##.#.#.##.#.##.#.##.##.#.#.##...............#
##...... ......##.#.##.#.##.#.#........#................ #.#.#...... ..... .................... ............. ...........................=..........#.#.## #.#.##.#
#..##.#.#.##.#.##.#.##...#.....#.#.#.#.#.#.#.#.##.#.##.#.... ..#.#.#.#.#.##.#.#.#.##.#.#.#.#.#.#.#.#.#.##.#.#.#.#.##.#.#.#.#.#.##.#.#.#.#.## #.#.##.#.#.##.#.#.##.#
##.. ..................#..#.#.#. ....................#.#.#.#.#.................. .......................................................... =.....................#
##.#.##.##.# #.##.#.##.#.##.#.##.#.#.#.#.##.##.##.#.#..........#.#.#.##.#.#.#.#.#.##.#.##.#.#.#.#.#.##.##.#.#.##.## ##.#=#.#.##.#.#.#.#.#.##.#.#.##.#.#.#.#.#.#.#.#
#................ ...................................#.#.#.#.#.#.#.#.#..#... ....... ..................... ...##.##.##.#.#.#..#.#.#.# #.##.#.#....%.....#.....#.#.#
#.#.#.#.##.#.##.#.#.#.#.#.#.#.# ##.##.#.###.#.# #.#.#..#..............#...#.#.#.#.##.##.##.##.#.#.#.##.##.#.#  ..............#........... .....##.#.#.#...##.##.#.#
#.............. ........................#.#.#.#.#....#...#.#.#.#.#.#.##.#.................................#.#.#.#.#.##.#.#.#.#.#.##.#.#.##.#.#........#.#...... ..#
#.#.#.#.##.#.#.#.#.#.##.#.#.# #.##.##.#...........#.#..#....... ........##.##.#.#.##.##.#.#.#.#.#.#.##.##....................................#.##.#.#.....##.#.##.#
# ........ ..... .......................#.#.#.#.#.#..#...#.# #.#.#.#.##...................................#.##.##.#.##.#.#.##.#.#.#.#.#.##.#..........#.# ##......#
#.#.#.#.##.#.#.#.#.#.##.#.#.#.#.#.#.#.##.##.#.#.#...##.#.#.##.##.#.#....#.#.##.#.#.#.#.#.#.#.##.#.##.#.##.##.#.##.#.#.##........#.#......... #.##.#.#........#.#.##
#........ ..... .. ...#...........................#..................##.##.##.#.##.#.#.#.#.##.#.#.##.#.##................#.#.##.. ..#.##.#.#.#.#.##...#.#.##......#
#.##.#.#.# #.#.##.##.#..##.##.#.##.##.##.##.#.#.#...##.#.#.#.#.#.#.#...................... ...............##.#.#.##.#.##...=....#.#.................#.#.#....#.#.##
#.##.#.#.#.#.#.##.##.##.## ##.#.##.##.#.#.#.#.#=#.#.##.#.#.#.#.#.#.#.#.#.##.#.#.##.#.#.##.#.#.#.#.#.#.#.#.###.##.##.#.##.##.##.##.#.##.#.#.#.#.#.##.......##......#
#.............. .. .................................... ........................................... ................................................#.#.#.##.##.#.#
#.#.#.#.##.#.#.##.#.# #.##.##.##.##.#.#.#.#.#.#.#.#.#.##.#.#.##.#.#.#.#.#.#.#.#.##.#.#.#.##.#.#.#.##.##.#.##.#.##.#.#.#.#.## #.#.##.#.##.#.#.#.# ##.#........ ....#
#.#.#.#.##...#.##.....#.##.##.....#.#.......... ....#.................................. ...................................................#..........##.#.#.#.##.#
#..........#......#.#......  .##.#....#.#.#.#.#.#.#..#.#.#.#.##.#.#.##.##.#.#.#.##.#.##.#.#.#.#.#.##.#.#.#.#.#.##.##.#.#.#.#.#.#.##.##.#.#...#.##.# #.............#
#.#.#.#.##.#.#.##.#.#.#.##.##.....#.#...............#............. .............##.#.##.#.... ...............#.##.#......#.#.#.#.##........#..........#.##.#.#.##.#
#.............................##.#....##.##.#.## ##..#.#.#.#.#.##.#.#.#.#.#.#.#...........#.#.#.#.#.#.#.## #.......#.#.#......=.....##.#.#...#.#.##.#.. . ....... #
#.#.#.#.##.#.#.#.#.##.#.##.##..#.##.#.##.##..#...##.##.#.#...#.##.#.#.......#.# #.##.##.#.#.#.#.#.##.##.##.#.#.#.#.#.#.#.###.#.#.##......#.#.#.#.##.#.##.#.#.#.##.#
#.#................#..#.##.##.#.............#..#...........#..........#.#.#....... ......... ......................... .............##.#..........................#
#...#.#.#.##.#.#.#..#..........#.##.#.##.##.##.#.##.##.#.#. .#.##.#=#.......#.#.##.#.#.##.#.#.#.#.#.### ##.#.# #.#.#.#.#.#.#.## #.#......#.#.#.#.##.#.##.#.#.#.##.#
#.#..........=.....#..#.#.#.#.##.#..#.........=............#.... .....#.#.#.....## ..#.##.#.. ....#.#.#.##.#.........#.##.##.##.#.#.##.#.#.#.#.#.##.#... ....... .#
#.#.#.#.#.##.# #.#.##.......... ..#...##.#.#.#.#.##.##.#.#...#.##.#.#.......#.#....# .......##.##............#.#.#.# ...................... ..........##.#.#.#.##.#
#............. .......#.#.#.#.##.##.#.##.#...#.# ##.##.##.##.#.##.#.#.#.#.#.#.#.##...#.##.#.......##.#.#.#.#.... ....#.##.##.##.#.#.##.#.#.#.#.#.##.#.#..#.....##.#
#.#.#.#.#.#.##.#.#.##.......#....#. .......#............. ......................##.#.#.#....##.#.###.#.#.#.#.# #.#.#......... #.#.#........#.#.#.##.#..#...#.#....#
# .................##.#.#.#.. ##..#.#.#.##.#.#.#.##.##.#.#.#.#.#.#.#.##.##.##.#.........#.#....................... ..#.##.##.#......##.#.#. ..........##.#.....##.#
#.#.#.#.#.##.#.#.#..........#....#........... ... .................#............##.#.#.##...#.#.#.# #.#.##.#.#.#.#.#..........#.#.#........#.#.#.##.#......#.#....#
#.....#.#....#...##.#.#.#.#.#.##.##.#.#.##.#.#.#.##.##.#.#.#.#=#.#...##.#.#.#.#.##.#......#............ ...#.#.#.#.#.#.##.##.##.# #.##.#.#...#.#.##.#.##.#.#.#.##.#
#.#.#.....##...#.............................................#. .#.#........ ........#.##...#.##.#.#.#.##.#....................  ... ....#.#...... ...............#
#.....#.#....#...#.##.#.#.#.#.##.## ##.##.#.##.##.#.##.#.#.#...#.....#.#.#.#.##.##.#... ..#................# #.#.#.#.#.##.##.#.##.#.#.#.#..##.##.##.#.#.#.##.# #.##
#.#.#.#.#.##.#.# #.#.##.#.#.#.##..................=.##.#.##.#.#.##.# #.#.#.#.## ##.#.#.##.#.##.#.#.#.#.##.##.#.#.#.#...##.. .#.## #.#.#.##............#.#.##.#....#
#.#..............................##.#.#.#.#.##.##.#.... ... .....................................#.#...#.............#....##...............#.#.#.##.#..........#.##
#...#.#.#.##.#.#.##.#.#=#.#.#.##......#......# .#.#.##.#.#.##.# #.##.#.#.#.#.##.#.##.#.## #.##.# ....#..#.##.#.#.#.#.#.##.##.##.#.# ##.#.#.#.#. .##...#.#.#.##....#
#.#.#... .##....... ....#.#......##.#...#.# #..#.........o...........#..   .. ...................#.#...##..#.. # ..............................#....#..........#.##
#.....#.#....#.#.##.# #.....#.##....#.#.#.#.##.##.#.##.#.#.##.#.#.##...#.#.#.##.#.#.##.#.##.#.##.#.#.#.##.#. # ..#.#.#.##.##.##.#.##.#.#.#.#.#.#.##.#.#.#.#.##.#.##
#.#.#.#.#.##............#.#......##....................#.#.##.#.#.##.#............#.##...##.#.##....... ...#.#.#.#.#.............. ............. .................#
#............#.#.##.#.#.....#.##.##.#.#.#.#.##.#.##.##......... .......#.#.#.##.#......#.... ....#.#.#.##.#.. .......#.##.##.#.##.##.#.#.#.##.#.#.#.#.#.##.#.#.#.##
#.#.#.#.#.##.#.#.#.##.#.#.#.........#.#.#.#.##.#.##.##.#.#.##.##.##.#.##.#.#.##.#.#.#.##.##.##.#.#.#.#.##.##.#.#.#.#.#.##.##.#.##.#.##.#.#.##.#.#.#.#.#.## #.#.# ##
#................... .......#.##.##..................... ........................................................................................................ #
#.#.#.#.#.##.#.#.#.##.# #.#...#...#.#.#.#.#.##.#=##.##.#.#.##.##.#.##.#.##.#.#.##.##.##.##.#.##.##.#.#.#.#.#.# #.#.#.#.##.##.# #.#.#.#.#.#.##.##.##.#.##.##.##.#.##
#.......#.#.##.#.#.##.#.#.#.#..#.#.... ................#.#.##.##.#.#.##.#....#....##.##.......#.##...............#........................................# #.## ##
#.#.#.#.......................##.##.#.#.#.#.##.##.#.##...=.............. .##..# #.......##.##......#.#.#.# #.#.#...#.#.##.##.#.#.##.##.#.#.##.#.#.#.##.##.........#
#.#.#.#.#.#.##.##.##.##.#.#.#..... . .......##.##.#.#..#.#.#.#.#.#.#.##.#....#..#.##.##. ... .#.##.............  #..........=... .............. ........#.#.#.#.#.#
#.............................##.##.#.#.#.#..........#.# #...#.#...... ...##.#.##.#.#.#.#.#.#......#.#.#.#.#.#.#...#.#.##.#.#.# #.#.##.#.#.##.#.#.#.##.#..........#
#.#.#.#.#.#.#.# ##.#.## #.#.#.##.#..# #.#.#.##.##.#.##. ...# ....#.#.##.#.....................#.##.#.......#.#...#.#.#.## .................. ...........#.#.#.#.#.#
# ...................... ... .....#....................#.# .#.##..........#.#.#.#.#.#.#.#.#.#........#.#.#... .#..........#.#.#.#.#.##.#.#.##.#.#.#.##.#..... ....#
#.#.#.#.#.#.#.#.#.##.##.#.#.#.#.#.#.#.#.#.#.#.#.#.# ## #.#.##.##.#.#.##.#.##.#.##.#.#.#.#.#.#.#.##.#.......#.#.#.#.#.#.##................#....#..... .. #.#.#.#.#.#
#..................... ... ....................................................................... ..#.#.#.#............#.#.#.#.#.#.##.#...##...#.#.##.##.#.#...#.#
#.##.##.##.##.#.#.##.##.#.#.#.##.##.##.#.##.#.#.#.#.##.#.#.#.#.##.#.# #.#.##.#.##.##.##.##.##.#.#.##.#.......#.#.#.#.#.#. ...........# #.#....#.#.............#...#
#..................................................... .............#.#.#........... ............ .....#.#.#  ..........#.#.#.#.#.#.#......##.#...#.##.##.#.#.#.#.#
#.##.##.#.#.#.##.#.#.##.#.#.#.#.#.#.##.#.##.#.#.#.#.##.#.#.#.#.##.#.......##.#.#.#.#.##.#.##.#.#.#.#.#...#.#.#.#.#.#.#.#.##.#.#.#.#.#.#.##.#... #.... ............#
#....................................... ............#...#.#.##.#.#.#.# #...............#.##.##.##.#...#............................. ......#.#.#.#.##.#.#.#.#.##.#
#.##.#.#.#.##.#.#.#.#.#.#.#.#.#.#.#.##.#.#.##.#.#.#.#..#..................#.##.#.#.#.##........... ..#.#.#.#.#.##.# ##.##.#.#.#.# #.#.#.#.#.............. ...#.##.#
#.##.#.#.#.##.#.#.#..... ........... .............#..#...#.#.##.#.#.#.#.#.#....... .....# ##.#.# #.#.....#.#.#....#.......#.#.#.......#.#.#.#.##.##.##.# #.#.#.##.#
#...... ............#.#.#.#.#.#.#.#.##.##.#.#.#.#...#..#...##.#.#.#.#.......##.#.#.#.#.##.##.#.#.#.#.#.#. .....##...##.##.......#.#.#.........#...................#
##.#.#.##.##.##.#.#.##.#.##.# ............... ....#.##.#.#........ ...#.#.#..............................#.#.#....#....##.#.#.#.#.#.#.#.#.#.#..#.##.##.#.#.#.##.#.#
##.#.#................... ....#.#.#.#.#.#.#.#.#.#..........##.#.#.#.#.......##.#.##.#.###.#.##.#.#.#.#.#.....#.##.#.##....................#.#.#..##.##... ........#
##.. #.##.##.## #.#.##.#.##.#.#.#.#.#.##.#.##.#.#.#.##.#.#.##.#.#.#.#.#.#.##.#.#.##.#................... #.#....#......##.#.#.#.# #.#.#.#......#.......#.##.# ###.#
#..#...#...=..........................................................................#.#.#.#.#.##.#.#.#.#.#.#.#..##.#..................#.#.#.##.##.##......##.##.#
##.#.#.##.##.##.#.#.##.#.##.#.#.#.#.#.##.#.##.#.#.#.##.#.#.##.#.#.#.#.#.#.##.#.#.##.#.#.#.##.##.##.#............#.##.#.##.#.#.#.#.#.#.#................#.##..... .#
#......... .... .... ... ........ #.............#.#.##.#.#...........................................#.#.#.#.#.#........................#.#.#.##.##.##.=.##.#.#.#.#
##.#.#.# #.#.##.#.##.#.#.##.#.#.#...#.##.#.##.#............#.##.#.#.#.#.#.#.##.#.#.#.#.#.#.#.##.#.##.#.#.#.#.#.##.##.#.##.#.#.#.#.#.#.#...#......##.##.#..........#
##.#.# #.#.#.##.#.##.#.##.#.#.##.##.#.##.#.##.#.#.#.##.#.#.# ##.#.#.#...#.#....#.##...... ............. ....... ....................... #...#.##.........##.#.#.#.#
#....... .... .......... ..... .................... .... .............#.....##......#.#.##.#.##.#.## #.#.#.#.#.#.#.#.#.##.#.#.#.##.##.#...#......##.## #.##.......#
##.#.##.#.#.# #.#.##.##.#.#.##.#.##.##.##.#.#.# #.#.##.#.#.##.#.#.#.#...#.#.##.#.##.#.#.#.#..##...#..#.#... .........#.#....#.#.........#...#.##....=.......#.#.#.#
##.#.#.#.##...#.........##.# #............. #.... . #...............#.#....................#....#..#.....#.#.# #.#.#....#.#.....##.##.# #.# #.##.##.##.#.##.......#
#...........#...#.##.##........#.##.##.##.#...#.#.#..#.#.#.##.#.#.#... .#.#.##.#.##.#.#.#.##.##.#.##.#.#.#.#.#.#.# #.#.##...#.#...........#..........#.#.#.#.##.#.#
##.#.#.#.##...#.........####.# #.#.....##.#.#.#.#...#..#.#.##.#.#.#.#.#.#.................. ............... ..............#...#.##.##.#.#...#.#.#.#.#.......... ..#
#......#.#..#.#.#.##.##...........#.##............#..# ...................##.#.#.##.##.#.#.#.##.#.##.#.#.#.#.##.## #.#.##.#.# ..##.##.#.#=#.#.#.#.#.##.#.#.##.#.#.#
##.# #....#.............#.#.##.#.#.. ..#.#.##.#.#...#..#.#.##.##.#.##.#.#.##...............#.##..........# ...................#... ..................... .........#
##.....#.##.#.#.# ##.##.###.##.#.##.##.#.#.##.##.##.##.#......... .......... #.##.#.#.##.#......#.##.#.#.. #.##.## #.#.##.#.#...#.#.#.#.#.#.#.##.##.##.#.##.#.#.#.#
#..#.#.#.#............=.......... ..... .................#.##.##.#.##.#.# ##.#.##.#.#.##.#.#.##.#.## ....#.#.##.##.#.#.##.#.#.#.#.#.#.#.#.# #.#.. ............... #
##........#.#.#.#.##.#.# ##.##.#.##.##.#.##.#.#.#.#.##.#.#............. .............................#.#............... ..................... ..###.#.#.#.#.#.#.#.#
#..#.#.#.#....#............. ....##.#......................##.##.#.##.#.#.##.#.##.#.#.#.#.#.# # #.##.#.#.##.##.#.#.#.#.#.##.#.##.#.##.#.#.#.#.##. ..........#.#...#
##.#.#.#.##.#...#.#.##.#.##.#.##... ..##.##.#.#.#.#.## #.#..=.......................................................................... .........##.#.#.#.#.....#.#
#.............#.......... ..... .##.#............... ......## #.##.##.#.#.##.#.##.##.#.#.#.##.#.#.##.#.##.#.##.# #.#.# #.#.##.##.#.#.##.#.#.#.##... ... ....#.#...#
#.#.##.#.##.#.#.#.#.##.#.##.##.#.##.#.##.##.#.#.#.#.##.#.#.##.#.##.##.#.#.##.#........ .......#.#.## #.## #............##.##.#.#.#.#.##.#.#.#.##.##.##.##.#.#.#.#.#
#............. ............... ........................................ ......#.##.##.##.##.#. .............##.#.#.#.#. .............................. ....... ...#
##.#.#.##.#.#.#.#.#.# #.##.#.#.#.##.##.#.#.#.#.#.#.##.#.#.##.###.#.##.#.#.##.#............... #.#.##.#.##.#............##.#.##.#.#.#.#.##.#.#.##.##.##.#.##.#.#.#.#
#.#.........#.#.#.#.#.##.....#.#.##.... ....................... ....#. ....#.##.##.##.##.#.##.#.#.##.#.##.#.#.#.#.##.#...............................#..........#.#
#...##.##.#....... ......#.# .... ..#.##.#.#.#.# #.#.#.#.##.#.##.##...#.#.#........................ ...................#.##.##.#.#.##.#.#.#.#.## ##.#..#.##.##.#..#
#.#.##.##.#.# #.#.#.##.#.#.#.#.#.##....................#.##.#.##.## #.#....#.##.#.##.##=#.# #.#.#.##.#.##.#.#.#.# ##.#.##.#.# #.## ##.#.#.#.#.#.#.#.#.##.#.#.#.#.##
#............................. .....#.#.##.#.#.#.#.#.#....... ..........#.#.#.#.#.##.......... .........#.................... ............o......... .............#
#.#.##.#.#.##.#.#.#.##.#.#.#.#.#.##. ..................# ##.#.##.##.#.#..............##.##.##.#.##.#.#.#..#.##.##.#.##.#.#.#.##.#.#.#.#.##.##.#.#.##.#.#.##.##.##.#
#.. ............#.#.... .#.#.#.#.##.#.#.##.#.#.#.#.#.#.#.##.#.##.##.. ..#.#.#.#.##.# . .........#.......#................... .......... ..........................#
#.#.##.#.#.##.#.....##.#............#...............................#.#..............#.#.#.##.# .#.#.#.##.#.#.#.#.#.#.##.#.#.#.#.##.#.#.##.##.##.##.##.#.##.##.#.##
#... ...........#.#.##.#.#.#.#.#.##...#.#.##.#.##.##.#.##.##.#.#.##.#.#.#.#.#.#.##.#............#......................... ..................................#....#
#.#.##.#.#.## #...................#.#.#.#..# #.##.##.... ............... .#...#.##.#.##.#.#.#.#.##.#.#.##.#.#.#.#.#.##.#.# #.#.#.#.##.#.#.#.#.##.##.##.#.##.# .#.##
#...............#.#.##.#.#.## ##.#........#.. .......##.#.#.#.#.#.#.#.#.#...#........................... ................# #.#.#.#.##.#.#.#..................# ...#
#.#.##.#.##.#.#.#.#.##.#.#........#.#.#.#..#.##.#.##....... ..............#...#.##.#.##.#.#.#.#.##.##.#.#.#.#.#.#.#.#.##....................#.##.#.#.#.#.##.##.##.#
#..........................##.#.#.#.#.#.#.##.##.#.##.##.#.##.##.#.#.#.#.#...#............................................#.#.#.#.# #.#.#.##...............#.#... .#
#.#.#.#.#.#.#.#.#.#.##.#.#... ......................... ..... ..... ......#.# #.#.##.#.##.##.##.##.#.##.#.#.#.#.#.#.#.##.#.#.##.##.##.#.##.##.##.#.#.#.#.#..##.##.#
#...#.#.........#......#...#.#.##.#.#.#.##.#.##.#.#.#.#.#.#.#.##.#.##.#.#......=...... .............................................. ......#.............#..#.##.#
#.# ....##.##.#...#.##...#.#........#.#......##.#.#.#.... ................##.# #.##.#.#.#.#.#.#.# #.#.#.#.#.#.#.##.#.#.#.#.#.#.#=##.#.#.##.#..##.##.##.#.##.##....#
#.#.#.#.... ..#.#...##.#.....#.##.#.....##.#..........#.#.#.#.##.#.##.#.#.#.##.#.##.#.#.#.#.#.#.##.##.#.#.#...#.................#.#.#.#.##.## ##.#.#.#....... .##.#
#. .....##.##.....#......#.#........#.#......##.#.#.#................................ ....... ..............#...##.#.#.#.##.#.#........................#.##.##.#..#
#.#.#.#.##.##.#.#.#.#.## #.#.##.#.#.#.##.#.#.#.#.##.#.#.#.#.##.#.#.##.#=#.##.#.#.##.##.##.#.#.#=#.#.##.##.#.#.#.##.#.#.#.##.#.##.##.#.#.##.##.##.#.#.#.#.##..# .#.#
#.......=...........#.##............................ .................#.#.#......##o##.##.. ..............#........ .............................=..........#..##.#
#.#.# #.##.##.#.#.#. ....#.#.#.##.#.#.##.#.## ##.##.#.#.##.#.#.#.#.##.......##.#..........#.#.#.#.##.#.#.#..#.##.#.#.#.##.#.#.#.#.# # #.##.##.##.#.#.# #.##.##.##.#
#.#.......  ...... .#.##................................ \.#.#.#.#.##.#.#.##.#.#.##.#.#.#.........##.#.#.##.#. ........ .............. ............#.....#........#
#...# #.#.#.#.# #.#.#....#.##.#.#.#.#.##.#.#.#.#.##.#.#.##.......................##.......#.#.#.#...... ......#.#.#.##.#.##.#.#.#.##.#.#.#.##.##.#...#.#..#.##.## #
#.#...................##........ ..........................#.#.#.#.##.#.#.#.##.#....# #.#.#.......#.#.#.##.##.#.#.........#.. ...... .... .........#.....# .##.##.#
#.=.##.##.#.#.#.#.#.#....#.#.##.#.#.##.#.#.#.#.#.##.#.#.##..... .....=...... ....##.....#...#.#.#.#.#.##.#.##.... #.##.#.#..#.#.#.##.#.#.#.##.##.#.#.#.#..#.......#
#.#.##.##.#.#.#...#..#.#...#.##.#.#.#......# ...... ..#....#.#.#.#.##.#.#.## #.#....#.#...#...................#.#.#.##....#.#.#...##............... .....#..##.#.##
#...............#...#....#...........#.#.#...#.#.#.##...##.........##..........#.## ... #...#.#.#.#.#.##.##.#..........#.#......#....#.#.#.##.##.#.#.#.#.##.......#
#.#.##.##.##.##.#.#...##...#.#.#.##.##.#.#.#..........#....#.#.#.#....#.#.##.#.... .#.#.#.#.#.#...#.#.###.#.#.#.#.#.##.#.#.##.#...##.#.#.............. .....##.#.##
# ... ..............##.#.#....... .. ........#.#.#.##...##.........##....... ..#.##...... ......#.................. ............#........#.##.##.#.##.##.##....#.##
#.#.##.#.##.#.#.#.#........# #.#.##.##.#.#.#.#.#.#.##.#.##.#.#.#.# ##.#.#.##.#.#.##.#.#.#.#.#.#.#.#.#.## # ##.#.#.##.#.#.#.#.#.##.##.#.#.#.##.............#.##....#
#.#....#.##.........##.#.#.##.##.#..... ................... ......................... ............................................ ...........##.#.## ##.#.....#.##
#...##.... .#.#.#.#...............#.##.#.#.#.#.#.#.#.#.#.#.#.##.#.#.##.#.##.##.##.#.#.#.#.##.#.##.#.#.##.#.#.#.##.##.#.#.#.#.#.##.#.##.#.#.##.##.#.##.# #.#.##.##.#
#.#.##.#.##.#.#.#.#.##.#.#.##.#.#...##.#.#.#.#...#...#.# # #.##.#.#.##.#.#.#.#.##.##.##.#.##.#.........................................#.#................ .......#
#.. ....... ...... . . ...........#............#...#............................... ...........##.#.#.##.#.#.#.##.##.#.#.# #.#.##.##.#.....##.##.#.##.#.#.#.#.#.###
#.#.#.#.#.#.#.#.#.#.##.#.#.#.##.#.#.#.#.##.#.#...#...#.#.#.#.#.##.#.##.#.#.#.#.##.#.#.#.#.##.#. ............ #.##.  .##..#.............#.#.##.##......  ... ......#
#.#.#.#.#.#.#.#.#.#.##.#...................#.#.#.#.#.#............... ..o. ....................##.#.# #.#.##.. ...##....# .#.#.##.##.#...#.......#.##.#.#.#.#.#.#.#
#...................... .#.#.##.# #.#.##.#.....#.. ....#.#.#.##.#.#.#.##.#.#.#.##.#.#.#.#.##.#......#.....##.#.##.#..## ##.#.#.##.##.#.#...##.##.#............=...#
#.#.#.#.#.##.#.#.##.##.#.#.#.##.#.#.#.##.#.#.#...#.#.#.#.......#.##.................#.#.# .....##.#...#.#..........#............... .....# ....#...##.##.##.##.#.##
#......... . ....#.......... ..................#.#.......#.#.#......##.#.#.#.#.#.##.......##.#.. ...#.#.#.##.#.#.#.##.#.##.# #.##.##.#.#...##.#..#.##.##.##.##.#.##
#.#.#.#.#.##.#.# .#.##.#.#.#.##.# #.#.#.##.#.#.....#.#.#.......#.##........... .....#.# #......##.#................. .............=....#.#.....#... ............. #
#................#............  #.....#.##.#.#.#.#.......#.#.#.#.##.#.##.#.#.#.#.##.......##.##.#.#.#.#.#.##.##.##.##.##.#.#.#.#.#.#.#.....##.##.#.##.#.###.##.##.#
#.#.#.#.#.##.#.#.##.##.#.#.#.## ..#.# .. ..........#.#.#............................## ##.............#.#.##.##.## #.#.##.##.#.#.#.#.#.#.#.#.......... . .........#
#. ............... .............#... .#.##.#.#.#.#.#...#.#.#.##.##.#.# #.#.#.#.#.##... ...##.##.#.#.#.................. ......... ..........#.##.#.##.##.#.##.#.#.#
#.#.#.#.##.#.#.#.#.#.#.#.#.##.#...# #...... .........#...... .......................#.#.#.............#.#.##.#.#.#.#.#.##.#.##.# ##.##.#.#.#......................#
#.#.....................##.##.#.#...#.#.##.#.#.#.#.#.#.#.#.##.#.##.#.#.##.#.##.#.#.## #.#.##.##.#.#.#.#.#.#.#.#.# ##.#.#.#.#.##.#.#.##.##.#.#.#.#.##.##.##.#.#.##.#
#.#.#.#.##.#.#.#.##.#.#...........# ..............  ....... ...................................... .....................................=.........................#
#..... .................##.##.#.#...#.#.#.#.##.#.#.#.##.#.##.#.#.#.#.#.#.#.#.#.#.##.#.#.#.#.#.#.#.#.#.#.#.#.#.# #.##.#.#.##.#.#.##.#.#.##.#.#.##.##.#.##.#.##.#.#.#
#.#.#.# ##.#.#.#.##.#.#.##.##.#.#.#..............#.#.#.##.##...#.... .....................#...#.# #.#...#.......#............ ...#.#... ......##.##.#.##.......   #
#.#.#.#.............................##.##.#.#.##.............#...#.#.#.#.#.#.#.##.##.#.##...#.. ......#...#.#.#...##.#.#.##.#.#.#....#.##.#.# .. . ......#.##.#.#.#
#.#.#.#.##.#.#.#.#.#.##.##.##.#.#.#.##.##.#.#.#..#.#.#.#.#.#.###.#.....#..........##.#.#..#...#.#.#.#.#.#.......#.##.#.#.##.#.#.##.#.#.##.#.#.##.##.##.#..........#
#..................... ........................#................. .#.#...#.#.#.##.......#...#........... #.#.##.. .......................................#.##.#.#.#
###################################################################################################################################################################
