########################################################
#..#.#.#.......... ........................ ...........#
##.#.#.#######.#########################################
#........................ ........................ ....#
#########.##.#.####.##.##.#### ###.#.#.## ##.####.##.###
#.......##.##..#...#..#.#.#....#.## #...##.#.....#..##.#
##.##.#..  ..#..##.#.##.##.###.#...  #.#.....### #.#...#
#..#.#..##.##..#.............#.#.###.#.#.#.#.#...#.#.#.#
##....# #..#.#.# #.### ##o#.#..#.#.## #.#.#.#.####.###.#
#=.####.####.#..##.# .#.#.#..#.#.. ....................#
##.#........ ..#...##.#.#.#.#..#.####.###.###.##########
#. #.##.###.##..##. ..#.#.#..#.#.#..#.#.#.#..#... .....#
##.#.#.## ##.#.# #.####.##.##..#..#.#.#.#.#.#..#########
#.##. .......#........ ......#.#.#....#.#.#.##.........#
#....#####.# #.##############..#..###...#......#.#.###.#
##.#.#...#.#.#..... ........ #.#.##.#.###.###.#.#.##.#.#
#.#..##.#..#.#.# ##.##=# #.#.#.#.#..#.#... =#.#..  ....#
# .#..#.##.#.# .#.##.#..#.#.#..#..#.#..##.##.#.####.##.#
#.##.#....=#.#.#.....#.#.. .##.#.#..#.# #... ......#.#.#
#.#...#####.##..####.#. ###....#..#.#.#...####.#.# #.#.#
#.##.#.........#.......#....##.#.#. .. ##.#..#.#.#.. #.#
#.. ..########..#.#.##..###.#..#..#.#.#...#.#.#.##.###.#
####.#.= ......# #.#.#.#..#..#.#.#.#..# #.#........# ..#
#.. . #.###.##.#.#.#.#.#.#..#..#.#..#.#.#.#.#.##.#.#.#.#
####.# #...#.#.#.#...#....#..#.#.# ##.#.#.#.#.#.#...##.#
#..#...#.##  ..#.###.#.###..#..#.#....#.#..# ....#.#..=#
## #.###.# ###.#.....#....#..#.#.#.###.#..#.#.###. .##.#
##.#.#...#.#.#.#.##.#..#.#. #..#.#.#.#.## #.#....#.#...#
#..#.###.#.#.#.#..#..#.#..# .#.#.#.#.#..#.#...##.#.#####
##.#. .#.#...#.#.#..#..# ##.#..#.#.#.#.##..##..#.#.....#
#... ##..#.##..#..#..#.#.#...#.#.#o#.#....#.###.##.###.#
#.##.#.#.#.#.#.#=#..#..#.##.#..#.#.#. ###.# .......#.###
#.#..#.#.#.#...#..#..#.#..#.## #..##.##%#..###.#.#.....#
#..#.#.#.#.###.#.#  #...###..#.#.#........#....#.#.###.#
#.#..#.#.#...#.#..#..#.#....# .#. #.##.#.# #.#.#.#. .#.#
##.#.....#.#.#.#.#.##.#.####.###.#.#.##.## ##.# #.###\##
#... #.##..#.#.............. ..........................#
#.##.##..#.#.#.#.#######.#########################.#####
##.##.#.##.#.#.#.#............ ................ .#.#...#
#....... ...##.#..######.###################.#.##..#.#.#
###.######.#...#.#.......#..... .............#...#.#.###
#...# .....# #.#..##.###..############.#####.#.##..#...#
#.#.#.####..##..##.##..#.#.............#.....#.#.#.#.###
#.#.#....#.#o..#....#.#..# ###.#.#.##.#.#.##.#.#.#.# ..#
#.#.#.# #...##.#.#.#...#..## ##.##.#..#....#.#.#...#.###
#.#=#.##.#.#...#.###.###.#.... .....##.##.#..#..##.#.#.#
##. #....#.#.#.#..........#.##.# #.#.......#.#.#...#...#
#.#.#.####.# #. #.##.###.#.##.#.#.#.#######.#.#.##.#.###
#...#.#....###.#..#.#. #........o................#.#...#
###.#.#.##.....##.# #.#..##.#.#.##.##.#.##.##.###. #.###
#...#.##.#.#.##.#.#.#.##.#.#..#..#...#.#..#.#.#..#.#.#.#
#.#.#....#.#.#....... .#.#..#.#.#.####.##.#.## #.#.#.#.#
#.#.#.##.#.#.#.##.##.##..#.##.#.#..................#...#
#.#.#.#.#..#..#.#..#...#.#....#.#.#.####.######.##.#.###
#.#.#....#.#.#  ..#..#.#..#.#.#.#.#.#.........#..#.....#
########################################################
