#############################################################
# .  ## #       . .. .   .    .  .   .  =   #  .   .   #.## #
# ##  .. # #.#.#.##### # ##.####.# ## ## ## .# # # # # #    #
#    # ##.# #.#.#.. .# #   # .    #.# . . # # # # #.## ##.#.#
##.# # #.   #.# # ## # ## #  ##.#   ####.#        .. . =  # #
## # #  # ### #.#..#.#.=# .# ...# # .  #  # ## ####### ###  #
#  #.# #      # # #  . # .##.## # #.##.. ## #  .  ..      # #
## # # #.##.# # #  # #. #.   =  . # # ## #  ####.# #.# ## # #
#    #  # #o# # # ## # #.#.## # #.#.   # ##   .#   ## #. .# #
#.## # ## ###.# #    # # ## ##.## # ###.# # # # ##  .   #.# #
## #.#.    .      ## #  .       . .  .   .#.#..   ### ## .# #
## # # # ### ##### # # # ##################. ## ### #   #.# #
#  . # #... .#   #.# # #.           . . .   # # # ..  ##  # #
#### # # ## # ## #.# #..## # ## #### # #### # # ##### # #.#.#
#    #     ..  . .  .  #     #.  . # .#.. #  .      . .    .#
# ## # #.# ## ##.#.# #   # # #.# #   #..##  ####.###.## ### #
#  # .# #.# #.#. #.   ## #    #..#.#.##.#.#  . #.#.## #.    #
# #  #...     .#  ## # ## # #  #o# # ...  # ###.. .  .#.### #
#. #.  # ## ###  #   = = .  # #.     ## # # # ## ## ##.  .# #
# ## ##.## ##.### ## ### ###.# ##.##        #    # #.###### #
#   .            . #..    . =   .  # #### # ####    .   ..  #
#### # # ### # ### ######### ## # #  #.   #   .  ## # #######
#. ### #   # # # #.      . ..  ## .# # ## # # ## #  #..    .#
## ..  ## #  # # ###### ###### # ## # # # . #.## ## ## ######
#  # #     #.#   ..      .   .  ..    ..  #     .   ..      #
## ### # #.#  # ###.#### # #.###.##### ###  # ##.###### # ###
#.  . #  # #.# ## #.   #.   .        #  ..#    # #  .  .. # #
### #   #  #    .. .# ## ## #####.## # ##   # #    ## # # . #
# #.# #  #.#.# #.#.## .     . .   .  #.  ## # ####.# #..# #.#
#.  # # #  #    # ##.### # # ##.# # #  #. #   .  #.   # #.  #
#.#.# # ## #.# #    .     # # % # #. #.#.#  #.## # # #. .# ##
# #.# #  # # ## ########.#.  ##  # ## ##  # ## ## .#  #.#  .#
# ##.##.#  #   ..    .    # #   # . .. .\#      .# ###  # ###
#.      ##. # ## #.##.###   .## # # ####  #.### #.    #.  o #
# #.# # .# ## . ## #. . . # # # # # #  . # .#    # # #  #####
#. # ## # .#  # #  ## ## #  # #.# # # ##  # #.# #.  # # #.. #
# #     .#. ##.  #= # .   #.  # # # #  # #  # #. # ## # #.###
## #### ## #. # ## #..##### ## #.##.####.## # . #. . .# #   #
#  . .   . # #      #  . ..  ..        .    #### # ###  #.###
#.# # # ## # ## ## #  #.## #.##.# # ### # # .    # #..# .   #
## #.## #  #  # #   # # .###.  # #.##.## #  # #### # #..#.###
#    .   # #.## # ##  ##     # #  .       # #    . #. #  .  #
# # ##.#=#...     . #  # #.##  #.####### #   # # #.# #  # ###
# ## #. .# ## # ## #. ## #.# # # # ..   #.# ## ### # ## # # #
#  # . ### # #.##.# # #   #. #  .# ####        ..       #   #
# #  # .  .# ...   .# ### ##.# # #    #.### ############# ###
#  # ######  # # ## #  .. ... . .  # #  #              .  . #
# #        #.## #.# # ## # # #### # # #.### ### # # # # ## ##
### # # # #  .  # # #.#  ### #  .       . # #  #. # # # # # #
#   # # #  # ## # # ## #.    ##### #.## #   .#  # #.# #   # #
#.#.##.## ##  # #. .     ### .      #.# # # #  #    # #.# # #
# #   ...  . #    ###### # # #.# ####.# ### .#.##.#.#       #
#  ## ## # #.# # ##  .   # # ## #..   . .   #. .###   # # # #
# # ## ### # # # # ### ## .  .  . ## ### ##  # #   .#  #  # #
#  .    .    ###.# # #.##.#.## ## # .  #  # #  # # #  # # # #
# ###### # #  .     .    .# # # #  ## ## ##  #.# ## # . #.# #
##  =.   #.# # #.# ## #.# #     #.# ###  #. #.. .     #.# . #
#  ## #.#  #.    # # # ## # # ###  ..  #  # #### ######.# #.#
## # #o# # . # # # #      # # #   # #### ##        .    # # #
#   .    . # # #.# # ## # # # # # #      #  ## ## # # ##. # #
#############################################################
