###############################################################
#.#....#......#.##... .#.#.#..#...#.# ##.##...# ...#..##...#. #
#..#.#.## ##.#... .# #.#...=.#..#..........##.##.#.=# ..#.##.##
##.#.#..#..#.#.### #.# #.#.#o##.#######.##..#...##.#..#.. ....#
# ....#.#.#........#.####.##.. .... ......##.##.#.. #.###.#####
##.#.#.##.#.#.#.##.#...##.#.###.## ### ##.......##.#...  .... #
#..#.# .......#..#.###   ......#.#........#.####  ...#####.#.##
##.#.###### #.#.# .....#.##.#.#..#.##=###.#.... .##.# ....#.# #
#. ...... .#.## .#.###...##.#.#.#..###. #.#.#.##.#.##.#.#.....#
#.#####.#.#.....#  .. .#..... #.##. ##.##.#.#.o#.#.....#.###.##
#. .. .##.# #.# .#.#####.##.# #.. #.. .#..#.###  .# ##.#...# .#
#.##.#...... #.#.#..........#..#.##.#.###.#... .## .#..###..#.#
#...#.###.## #.#...####.#.#.#.# ... ##.#...#####.##.#.#... ##.#
#.#.... ..#.# .#.#.#.. ..##.#.##.##.....## # ... ...#...##.#.##
##.##.###.....#. #.#.##.#...#.. ##.#####.#.#.###.##...##...#..#
#.. ..#..###.# #.#.##.#..###.###... .......#.... .#.##.#####.##
######.#...#.#.# ......#..=. . . #########..######..... .... .#
#. .....#.## ...## #.#.#.####.##...... ..#.#.......#.##.#.###.#
#.#.###.#.#o.#.#.#.#.#.#.#.....#.###.#.##%...#.#.#.##.# #....##
# #.# #.#..#.#...#...# #.#.#.#...#.#.#.#.####.#.#.... .   #.#.#
#.#=#...#.##.#.##..##..##.#.#.##.....#.# .. .....#.##.#.# . ..#
#...### . ...# #.#.. #......#..#.#.##...###.#.#.#..##.### #.#.#
#.#. ..##.##.##..#.###.#.##. .#.#....#.#..## ##..#.. .=...#...#
#. ##.#.#.#.....#. . .=#.#..#.. ..#.## .#.. .  .# .######..#.##
##..# ....##.#.#.#.###.#..#.#.# #.#.#..#.#.#.###.#... .. .#...#
#..#..##.# #.#.#.#.# #.####..# #.# ...#..........##.##.## ## ##
###.#. .#..........#.....  .#.....#.# .#.# #.####...#...#.....#
#..  .##. ####.# #. #.#.#.#.#.### # #.##..###  .###.#.#.#.##.##
#.###...#.#...# .#### ##..#.....#.#.#.#.#.###.#....#..# #.#.###
#. ...#.#.#.#..#........#..##.#.#..#.......#...### .#.......=##
# #.#. .....#.##########.##.##.##.#..#.###.#.##....######### .#
# ..#.#.#.#....#.....  .....  .....##..... #...#.####........##
####.#...#..##.# ##.#.#.# #.#.#.#.#.######.####....#..##.#.##.#
#... ..##.##...#.## ##.#.#.#.# # ##... ..#......##.##...##....#
###.# #.. ..###..... .... .... ..#.##.###..#####.#..# #.#.###.#
# . #.#.###.#..#.##.#.###.#####.#.....#.##.  .. ..## # .. ..#.#
#.#.#..#.....# #.#.#.#..#.#....#.##.#.... ###.###.#.. .# ## .##
#..#..#.#.# ##.#.#.#.#.###..##.#. .#.##.#.#...#. ..# #.#.# .# #
#.#.#....##..=.. #...#.##.#..#.##.##.# ##.#####.#.#.# ##..# # #
#.#. ##.# .#.###.#.#.#......# . ... ................o....#..#.#
##.#.#. # #.# .#.#.#.# ##.##.#.##.###.###.###.##.#.# ###..#.# #
#....##.#.... #....#.. ###...#.#.##.#.#.#... #..#. ###.#.#..#.#
##.# ... .##.#.#.##.##. #..##.. ....#.. . #.##.##.#......####.#
#..# #.##=......  ...#.#.#.# #.#.#.#..###. #...#. # ##.#......#
## ..# #.#.#=##.##.##..#.# # #.#.###.#...##..#.##...#...# #####
#..#.#.#.#..####. .#.#.#... .. #.... ..#.#.#......#.#.#..#....#
###.#.##.#.#.##.##.#.#.#######..######... . .#.##.## #.#.#.####
#  ......#.# . ..#.. .........#........#.#.#.#...........#.#  #
##.###.##. #.##.####.# ###.###.#.###.#.##.#..#.#.##.# ### .##.#
#........#.#.#.#.#..#..#.#.#.. ..#.. .#. ..#.#.##.#.###.## ...#
##.#.##.#. #. . ..=#..#. ..#.# ##.##.##.##.##....\ ........##.#
##... #..#...##.###..#####. #.# ..... ..#....#.## ## ##.##..#.#
# .###..#..#.......#..#... #....###.###.#####.#.##.#.##..##...#
#.#...#. # #.#.##.#..#..##..#####.##.... ... ...... ...#....###
###.#...##.... .#..#.##.##.# .... .. ### #.# #.#.#.#.#...###..#
#...###...#.#.# .#.# ..... #.###.##.##.###.#.#...#...#.# . .#.#
#.#.....##.##.#.#.##.#.##.##.# #.#.........#...# .#.#. .#.###=#
##.##.#......... ....#...#... ...#.#.##.##.#.#.#.#.#.# ##.....#
#. ....##.#.#### #.######.#.# ##.#..### #.#..#.#.#.#.#. ..#.#.#
#.#.##.# ..... ..#.#.#......#.#.##.#.#  #.##.#.#.# #.#.##.#...#
#.#. #.# ##.#.#.#. . ..#.##........ ..#..........#.#.#.#..# #.#
#..#..#.. ....#..#.#.#......#.##.# #.#..## # #.##.......#.  ..#
###############################################################
