###################
#=.# #.#.#o# #=##=#
##. . .  #. =  . .#
# ## ##.#  ## ### #
#.# ..#..# #.#..# #
# .# #. #..#   ## #
#.## .#  # # # #. #
# #. # ###.### ####
#  #. o. .     . .#
## # ##.### ## # ##
#  #.#\.#  .# .# ##
## # # # ##  # #  #
# .# #.# .  ##.#.##
## # #.# ## #  #o##
## # #. #.#% #.# .#
# .  #o#. . ## # ##
# ##.# .##### ##  #
# # .# #  .    . ##
###################
