#####################################################################################################################################
#.#..#   .## ##.##.##  .. ...... .. .  ..#.##.#.##.#.# #.##.#.##.#.#.#.# # ##=# ##.#.#.#.# ##.# # ## ##.# ##.#.# # # # ## # # #.# #.#
# ##..# #.. .... ... .# #.##.##.#.##.#.#...... .. .. . ..  ......   ...... .... ..... .  ..  .........     ... ...... . .. . .... ..#
#..  #. .#.# # ##.#.#..... ...# ..## ....#.##.#.# #.##.## # ##.#.#.#.#.#.#.## #.# ## #.# #.##.# #.#.# ## # # #.#.##.#.#.#.# #.#.#.#.#
## # ## ## #.#.#.# #.## # #.#...#... #.#.# . .=... .#.#.# #........#   . .... ..   . . . .  # #.#....  .....    .... . ..    ...  ..#
# . ... . ...............  .. # #.##.. .. .# ## # #  ... ...#.## #...#.#.#.## # #.# #.#.## #   . .###.##.##.#.## ## # ##.#.##.#.#.#.#
# ##.#.##.## #.#.#.#.##.# #.#.  # ##.#.# # #.. ....#.##.# #...##...#...  . .   . ........# # # ##..  .  .... ..=#.  ... # ##.## #.# #
#. #.#.##.  ... .  . .. .   ..#...... .#.# ..##.# ##.##.# . #  . #...#.###.#.##.## ##.##..  ..  ..##.##.#.#.#.# ..#.# #...... ....#.#
##   .....## ##.# ##.## #.# #.# #.##.#  ...#.#.##=   .    #.#.##. .#.o...#.#.#.##.# ##.#.# #.##.#. #.##. ...#.# #.#.. . #.#.#.# # ..#
## # #.##=  ....... . .... ...... #  . #.#. ... ..#.# # #.#...   #=# #.#... .... .. .. . #.. .. #.# .. .#.# ......  #.# ... # . #.# #
#.... . ..# #.#.#.## ##.#.#.# # #..# #.... ####.# #.........#.## #.  . #.#.#.# #.##.## #.  #.## = ## ## #.# #.#.#.#.# # # #.  #...#.#
## ## #.#.. .  . ...... #.# #.#.#.##.#.#.# . . ..  .# #.#.#.#.#  ..#.#  .... ..  ....... # ..  ## .  # ..  . =.  .... . # . # #.#...#
#........ #.#.# # ## ## . . .. . . ... . #.##.# #.#.. .. ......#.#. .##.# #.##.# ## ## #.# #.#... ##. #.#.#.#.#.#.#.# #. .# . ....#.#
#.#.##.##.##.##.#...#.  ##.#.##.# #.##.#.#.#.## #.# ##.# #.###... .#  ...... ... ..  .  .. #.# ##=#..#.  ...#  .#.# #.# #...#.###.#.#
#.## . .. ..   ...# ..#. .   .  # ##....  . . ......  . .  .  .#.#.#.#.###.##.##.# # ##.##  ..#.# .#..# #.# ..#.  ...  .# # # ......#
#    # # #.## # #.. ##..# ##.##.. ...# #.# #.#.#.#.#.##.## # #.  ......   ..  . .. .  ... .# # . .#. ## # #.#.. #\#.#.#.......#.# #.#
## # . ....  .   .# ..#...  ..# #.##.#.. ..   ......  . .   ..#.##.#.# #.# #.#.#.#.# ##.##.# ##.#.##.# ...  # # #.#.#   # #.# #.#.# #
#. ..#.#.#.##.# #.#.# #.#.# #.. .. .  .# #.# #.##.# #.##.#.#.#.. . . .........#. . .. ...  . ..  . ... ##.#  .....  ..# .... .. .. .#
##.#...#. ... . . .. .   ...#.# #.##.#.. .. .  .....  ..  . .  # #.#.# # ## # ## ##.#.# #.##.# ##.##.#....#.##.## # # # ## ##.#.#.#.#
#.  .#.  #.##.#.#.# # #.# #...  .......# ##=#.#.####.##.##.#.#  .............. .. .  . .#.#  .  ..# .##.#. ..   ..# # #.#.# # #.# # #
##.#.. #.#.   . ...... .....# # #.## #...##.# #.  .. .. ##.#.#.#.#.# # ##.# #.## #.#.##. ..#.##.#  #..#.#.# # # ##. ....  . ........#
##.## ## ## #.# #.# #.#.#.## ## # ## ###..  ... # ##.##   ..... .  #.. .. ..#.##.##.#...# #.. .. .#..#. .. .#.#... #.# ##.#.##.## # #
#  ... . ..... . . . ..  .   ..  ...    .## # #.##    . # ## # #.#  .#.## #..... . ...#....# # ##=.#..#.#.# ..# ##.#..  .   .  #....#
#.#.###.##.#.#.# #.#.#.##.#.##.##.# # ##  .........#.##... #.#.# #.#..     .#.#.### #.#.#.##   .. #..# ##...# . . .. ## # # ## ..##.#
#. .. .. ..#.... ..#.#. #.#.##.#.##.# ##.#.##.#.#.#..#. ## .. .... ..##.#.### #... ...#.... .# ## .#. .   #.#.#.##.#.....  ..  # ...#
#.# ##.#.#   # # # . ..#.... ...  . .   .... .  . .# .# ##.# #.# #.#   ........ ###.# ..## #   .#.#..##.#.. ..#... # ## #.#.##.#.## #
#.. .  . # #  .#. .#.#..#.#.##.## #.#.## ##.# #.##.#.# . . ..... ... # #.#.## #... .. #.. ...## .. #.  .  #.#. .# #.  .. ... ..#. # #
# # ## #.#.#.# ..# # #.# ..  .. ....#  ...#.# #..... .#.#.## ##.#.##  . ....  . # #.#. .## #   .#.#.#.# # #.# # #.##.#.##.##.#.. #..#
#  . . .  ...### #. #  ..#.#.## #.#  .##.#... ..#.## #. #..   #.##.# #.#.#.## #.### #.#  ..#.##.  ... . ........# ... .#. .. . #.##.#
# #.##.#.##.#. ...#..# #.#.#.=  # .## #...#.#.# ... ..#..#.#.#......  ..   . . ..   .. .##. .. .#.#.#.# ##.#.##.# ##.#. #.## #...  .#
#.#=  ... ..# ## # .#..  ...#.#..#. . .#.##.#.#.##.# ## #.##.#.# # #.# #.# ##.#.#.#.#.#.. .#.##.#.## ##.## #..#    ..#.##   ...#.## #
#.# # # ##.## ## ##.##.#.# ##.#.##.##.# .#. .. .. .# ..=..      .. ....   ....#=. ..#.#.## #.##. .. ..  ..  .#. ##.#. ....## # #.##.#
#=.. . .#    ..  . ...  ...... . .. .. # ..##.#.# # .## ## # #.##.##.##.#.#.#...# #.. ..   .   .#.## ##.# ## ## ## # #.##.## #. .. .#
#.#.#.# .#.# #.#.##.#.# ## ##.# #.##.# #.#.##.#.#.## ...##.# #.##.. .... .. ..# . . # # ##.#.##.. . .   .. ......  .  . #... ..#.## #
#.=.#.#.##.#.#.#... #.  .   .. ... ...  .... . .   ..## ..... ...# #.# #.## #.#.# # ..#..#.# .  ##.#.## #.# #.#.## ## #...##.#.# .#.#
# #  ...  .  . ..##...# # # #.# ##.# #.#.# #.# ##.## . .##.#.# #   .  ....  ... ....#.. #....##....... . .  .. ....= . .#  . . ..#..#
# # #.# #.#.## ## #.#.#.##.# #.# #.#.# # ## # ##.# #.##.## # #.#.#.#.#.##.#.#.#.#.#.#.# ##.#....# ##.#.#.# ##.#.##.# #.##.#.#.#.# #.#
#.....  . ... ...      . .... . .....=.   ... .    .  ..  .. . . ...  .  .........   .. .... ## #.  .  ..  ... ...  ..  ... .  .....#
#.#.## #.#.# # #.# # # #.##.#.#.#.# ## ##.#.#.#.# # ##.# #.#.##.#.#.#.# # # # #.## #.#.#.# #.## ..##.#.#.#.##.#.# #.#.# ## #.##.# #.#
# #.  . .   .. .#.#.#.# #.# # ## #. .#.# ## # ## # ## #.## #.#.# # #.#.# ..    .#.##.## #...... # .. ..   .  ......  ... ....#.#.##.#
#.. #.##.#.#.#.#.  = .= . .. ..    #.... . .  ...  . ...... ... .. ......##.#.#......... # #.##.#.##.#.#.#.# ##.#.#.# ## #=# . ...  #
#.#.#   . ....#.#.#.#.#.#.# # #.#.##.#.#.# ##.# #.#.#.# ## # ## ##.#.#.#.#.. .. ## #.##.#   ...  .# .#.## # #.#   #.. ...#.## #.#.#.#
# .. #.## #.#.  ..##.# #.#. #.. . . .....#..  #..   .. ... #.    . . # # . # ##.... .  .## #.##.#..#... .... .  #...# ##. ... .. . .#
#.#.# . #.#.#.#.# .... . .#.. #.##.#.# # . ## .#.#.## # ##.  ## ## #.....#.. .. #.#.# #.. . .##.#.#..#.#.## # #.#.#.#.##.# ## #.# #.#
#.#.## # ..  .... #.# ##.#. # ... . .  ##.# # ## # ## # ## # ##.## #.#.# # ##.#. .  #.#.##.#....#.## # ## #. .#. ..... . # .    ..  #
#   .. . #.##.#.#   #.##.## #.##.# # #..   ..... . .. ......... .. ......  ...#.##.#... ...#.##.#  .. ......#.. #.#.#.##   #.## #.#.#
# #.##.###.##.#...# .. .. . . ....   # ## # ## ##.##.#.# #.#.# ## ##.#.# # ##. .##.##.#.##..  #.. ## ##.#.#.# #. . ..... #..  .. ...#
#.#..  ..  ... .# . #.##.##.# ## #.#. .## #.## #.##.#.#.#.## #.# #.##.##.#.# ## .   . ..# .# #.=#  ....    . .#.#.# # ## . #.#.#.##.#
#. .# #.#.# #.#.#.# .  #. ..#. .  . .# .....   . . .  .......   .  .. ..  . ....## # ##  #.... ##.##.#.#.##.#.  .   .....#. ....... #
#.#. .=.......  ..#.##. .## ..##.# #. .#.##.# # ## # # # ## ##.#.#.# #.#.##.#.#.## ##.# # ## #..  .. . ..  .. # ## ## ##.# #.#.#.##.#
#.#.## #.##.# #.# ..  .#. ..#........#. ....  ...  ... . ....    .. .. ...............  . = .. ##.##.# #.##.#... .. . .  ....  ..  .#
#.  # .#.##.#. .  #.##.#.## #.## # # # ##.#.##.# #.# # # #.# #.#.# # ##.#.# #.#.#.#.# #.#.##.#.......#..  . . # # #.#.# ##.## #.# # #
# #. #. ..... #.# #.# ##.... ...... .   ..    ... ... .....  ...  .. . ..  .....  .. .. .   .. ##.##...# ##.#... ....  . .... .  ...#
# #.##.# #.#.# ##.. ..  .## # #.#.# #.#.#.# #.# #.#.##=##.#.# ##.#.# ## ## #.#.#.#.## #.## #.#. .. . #.  . ...#.# # # #.# ##.#.##.#.#
# .... ... .   .. ##.# #.#....#.# ##..#..  .... . .. # ..... ...    . ........ ##.##.##.#.#....# # #.#.## # #.#.#.. .   . ...  . . .#
#.#.# # ## # #.##=. . .   # #.  . ...#..#.#.##.# # #.# # #.#.#.#.## ## ## ## #. ...  ..  ..#.#.#.#.#. .... ..  . .##.##.# # # # # # #
#  .#.#.# #.#.#.# ##.# #.## =.# #.##. #. ..=.  .   ... #.# # #....  =  #.##.#.##.# ## ##.#.....  ... #.##.#.# # #     ..... #.. #  .#
# #    .......... .. ... . .# # ## #.## # #.# ###.##.#  .  ..  # # #.#... .  .. .... ....# #.# # #.#.##.# # #.# # #.##.##.#. .# ..# #
#.#.# ## #.##.# #o##.## #.#  . ..  . ........   .   .  #.# #.#.#. . ...#.##.##.#.#.#.# #.....#.#.#  .. ....  . ... ... . ...#.  #.. #
#.. .... .. .  . ..#. . #.# #.# #.#.##.#.## # # # # ##.#.#.#.#.. #.#.#       . . . ..... #.#. .. ..#.#.## # # #.#.##.##.#.#.#.#.#.#.#
# #.## #.#.## # ##. .## .   # #. # #. . ...    . .... .. ......#. . .# # # #.#.#.## #.## # . # #.# ... ....  .  .  . .   .. ........#
#.#.#  .. . . ... .#... #.#....#   .#.#.#.#.##.##.#.##.#.# #.# ..#.#.... ...... =.  #. . #.# .. .. # ##.## ## # #.#.# #.#.## #.## #.#
# .  .##.##.#.##.# #.## #.#.#.## #### # # #.##.##.##.# #.#.# # #.## ##.#.##.##.# #.##.##.#.# #.##.##..#.  ... # .. .....#.......  . #
# # #.## ##.##=#.#.#........ . . . . ... ..  .....  ...  .....  . . ... . ..... .. ......  . .... ...#..## ##...#.#.# #..=##.##.##.##
#.#. ...  .. .  . ..# ## #.# #.# ##.## #.# # ##.#.## # #.#.## ##.#.# #.#.# ## # ## #.## ##.#.# #.#.#.##.##..#.#.   .... #.##.# #.#.##
#. .##.#.#.#.# #.# #  .. #..... .# #.=.#  .. .  .. .........#. .  .# #.#...##.## # #. ..   #=.......   . ..#.. .#.##.## . ...     ..#
# # .. ..#.#.#.# #.##.## .# ##.#  ...#.. ###.##.#.##.#.#.#.#..## #.  . ..#.... . . ..#.# #. .# #.### #.#.#  #.#.. ..   .# ##.#.#.# ##
#. .##.#......=.... ..##.#. ## ..# # . # . ... ....   . ... #. ..#.#.# #.  ## # #.##.#..   #. #.## # . ....##.  # ####.#.# # #.# # .#
#.#.##...# #.#.# #.##.  .#.#.  #.. . ## ## ## # ##.#.#.# # ##.## . . ..# #..   ... ....#.#.. #. ..  .#.# # # .#.#  ...   ...   .  .##
#.# . .#.. .  ... . ..## ....#. .#.#  .. . .... .  ..#  .......#.# #.#.. . #.##.# ## #.#.#.# ##.##.#... ....# #.#.###.##.#.#.##.## ##
#...## ..# #.#.#.#.## ## #.#.#.# #...#.# #.# #.##.#.#..#.#.# #.  ..#  .#.##.#.. #.#. #. . ... . ... .##.##.#     . ... .. .. .    ..#
# #.## #.# #.##.##.  .  . ..   #. .#.#.#.#.## # #.#.## ##.# #.## #...#... . ..#.. .# ..# #.# # #.#.#.....# ##.# ##.##.## ##.# #.##.##
# .  .. . . ..   ..##.##.#.# #  .#.... . .. . ..  ..... .  .   ..# #.#.#.#.# ##.#.##.# ##.# =....# #.## # ..  ..... ..... #.#.# .. ##
#.#.#.# ## # #.#.# #. ##. . .#.#.. ##.##.##.## #.#.##.#.#.#.## # . .... .#  .. ......  .   #.# #.. ... ...#.#.# ## # #.# #...  .##  #
# ... .# #.. #. ..  # . .# #...  #. =...   ..  .. . .  . .  .....# # #.# .# # #.# ##.##.#.#    . #.# ##.#.# #.#.# ... .   # # # .#.##
# # ##.. ..# . # #.##.##.... #.#.#.#.## # ## # # ## ## #.# #.#.#.....# # #. .... .#   #.   # #.#.#.#. . ..... . ..## #.#.#......#..##
# . ...# #...#..  . ...#.# # ......# .. ...  .... .. .  .. . ..  #.#.. ..  #.##.#. # # .# #... ......##.#.# #.#.#.. . .   #.#.#..#..#
#.# #.#..# # #.#.#.##=## . #.# #.#...#.##.##.#.##.#.## ##.##.#.#=. . #.#.#  .  .. #...#   .#.##.#.##...  ...... #.#.## #.##.#.#.## ##
#..... #...  .. ....  # .# ....   .#...  .....    .....#...  ... #.# ..#. .# ##.# .#.##.# ##.## #.##.#.#.# ##.# ..  ... ..... ..=...#
#.#.# #..# ##.##.# ##  #  .#.# # #  .## # #.##.## ## #..# ## #.#.#  .#...#...#..#.##.#   . ........ .. #.... .# ###.#.#.# #.#.# ##.##
#. .   #.#. ..... ....## # # # #.#.# .# =  . o... .... ## # # ## ..#. .#.# #..# .. ...#.##.# # #.#.#.#.  #.##...... .. ...# # . ##..#
#.# # # . .##.##.#.##.. . ... .  =  #  .#.#.##.## # ##.... .... .#...#. . .# ## #.##.#.....   .. ..... #...  .#.####.#.##.#  .#....##
#.  ...#.#.#.  ..  .  ## #.##.#.#.#.  # ..#... . ... ..## #.## #.#.# #.# #.. #....#.  #.#.##.##.## # #...#.##.#   ......  ..#.. ## .#
#.# # #.. . # # ## ##..# #.#. .#.   #.#.# . ##.## ## #.. .## # ... ......#.#..# #  # #..  ...... . ..#.#..  .. .# ##.#.# ##   #..# ##
#... ..# #.#. #  . .# #. ..# # . ##.#. .# # #..#..## ## #..... #.#.# #.#....# #.##... # #.##.# # #.# ..# # ## #. .  .#.. . .#  .# ..#
#.#.##.. #. #  .##.#.. #.#.#.#.#.  .. #. .   #..#   .... .## #=..# ## .#.##. . . #.# #.  .##.    . #.# .   .#. .##.#.# #.##. .#.## ##
#.# ## # . ## #.   ##.#.....  . .## #.##.##.##.## #.# # #  .= .#. .. .#.... #.#.#.....#.#.   # #.#.....# # ##.# .....  .. ..# ... . #
# ...  ..#..... ##. ..##.#.#.#.#.... . ...    ...   ...  .##.#.# #.##.##.##. .... ##.#   .## .  . .#.#  . ....  #.##.#.# ## .#.# # ##
# # ## #.#.##.#....##=.# # ..#..# #.#.##.# ## # ## # ##.# ....   ...# .  ##.#.#.#   .## #.   ## ##.#.#.#.#.##.# .. ........ # . . ..#
# .. #.# ...#.#### #..#...=#. #  .# #.. #.#  ##.. . .   ..#.# ##.#.# .## .. .. .#.##..# # ##..#.  ... ..  ......## #.# #.# # #.#.# ##
# # # ...# # ..... .#.##.#. .## # ....# ...#. . # ##.##.## #...#.  ##.##.##.#.#.  .# #... .. #. ## # # # # ## #. . ... ............ #
#. . # # .. #.# ## ##. ..#.# . ...#.# #.## # ##  .   # . .   # . #.......##.#.#.# #.  #.# ##..# ##.# #.   .. .# # # ##.##.#.#.##.# ##
#.#.#..#.#.##.     #  ##.# # #.##..  .    . ....#.##  # #.#.#  #.#.## ##....  ..  .#.#.  =.# #....   ..#.#.## ...  . . .   .  . ... #
# . .# #.#  ..#.## .#.#... #.. .. #.#.# # ##.## # ...#. .... #........  .##.#.# #.#  .#.## ..  #.#.# #... ....#.#.#.#.# #.#.##.#.#.##
# #.##.....##.# ...#.. .##.  ##.#. ..... . #... ..## # # # #.# #.#.#.# #.#. #.....##.## ## # # #.... ..#.#.##.. #........ .. . .    #
#.. # .#.#  .  .##. # #.##.# ## #.#.#.## #.#=#.##.... .  ...  .. ..  . . .# ###.# ...   . .. .. .#.#.#. ......#...#.#.# # #.#.#.# # #
# # .# #.. ##.##.# #.  ... #...   .  ....  . . ...#.#.##.##.#.## #.#.# #.#..   .  ##.# ## ## # # #. .## ## #.##.#...  ... ...... .# #
#.  #....#.. .. ....#.#.## # #.##.#.#.## # #.##.#.##.##.#.#  ..  .. .... #.## ##.#.# . ...##.. ....#..   ..... .. #.##.#.##.# #.#. .#
# #.## #...## # ## #    ... ...##  .  . =#.  .   ......  ...#.##.#.#.#.#.. ... . .. .#.##.  .# ## ## ## # ###.#.#.#.#...  ...   ..#.#
#..   . .#..# ..##.## ##.#.# #. . #.#.##.# #.#.# #.# #.## #.. ...   ..  .#.# #.#.#.#.#. . ##   ....  .#. . .....    . #.# #.#.#.#.#.#
#.# ##.#.. #. # . ..#..= ..# ..#.##.# ..# ..  ..... .# ... #.#.#.#.#.#.# . #.#.#.#.# . ##.#..#.## ## #. #.# # #.# # # #.#.# #.#.#.. #
#.#.##. .#.##.#.##.#..#.##.. #  .. .. #  #.#.##.##.#.##.#.# .#...... #  .#..... . ...# #. .# .. .  ..##.##.## . ........  . ..#...#.#
#  . ..#. ....#.##. # ..##.#...#.##.#.#.##   . ..#.#. .  ..#.  #.#.# ..#.# #.#.# #.# #..#.##.#.##.##  ...  . .#.# #.#.# # #.#...# . #
#.#.##.. #.## #....#..# .. . #......  .... # ## #... #.##.#..#.. ... #. ... . ...# #.#.#. ........ ..##.### #  . .....#  ...# # #.#.#
#.#.##.#.#. . . ##.##.# ##.#.#.# ##.#.# ## #.# #.# #.##.# #.##.#=#.#.# # #.#.#.# # ###.##.##.# ##.## .... .  .# #.# #.. # #... . .. #
#.... ..   ## #  # ......   ... . ... ..    ......  .  .     .    .  ....  ....  . . ......... .... .##.##.##.#.... #.#.# # #.#.# # #
#.#.# ## #  .. .#. ##.#.##.# #.## #.###.# ##.# #.#.##.#.#.# ## # #.#.# # # # # #.# #.#.# # #.#.#.#.#..  #.......# #.#...   . .#...  #
#...... .#.##.##.#... .  #.# # ##.# #.#.# .....# .    = . ... . .. ......# #.# #.#..# .    #.# # .## ##. #.## #. .....##.## #...# #.#
# # #.##  . #.... .##.# # .. .. ........ #.#.#.. #.## #.#.##.#.## # # ## .  ...#.# ## # ##.# .  #.. ..  #.. .. .#.#.# ..... # # .#. #
# # = ...#.#..##.#.#. #  .#.#.#.#.#.#.#.#.##...# . .....#.  .#.  .  .    ## # ##.... .#.#..  #.##.##.##..# ## #.#  .#.##.#.##.#.#..##
#.. #.##... # #.## .#.. #.  #.#.# #...  ...  #.. # ##.#...##  .##.# #.##.#... ...# ##... #.# ... .##.#..##.##.#. .#.   .  ......##. #
# #......# #..     #..# #.#....... .#.#.##.#.. #....# #.# ##.# # ##.# ##. #.#.##.  .. # # .#.#.##....  # ..     #.#.#.#.#.#.#.# .# ##
# # ##.#. ..#.#.##.#.# ## . #.# # #.#....  ..#. .#.#... ...... ...    ...#. ..#  ##=#.  ## .. ....##.## #.# #.#. ...#..   ...  .# ..#
# . . . .# #...  .=.......#. .. .. .. #.## #  .# ... #.#.# #.# ##.##.# #..#.#..#.  .  #.  .# # ## . .... .. ... # #  .# # #.#.# ## ##
#.#.# ##...#.##.#.##.##.# . #.# #.# #.... .  #...# # ... ... .. .. . . . #... #..##.#..#.#. . . #.##.#.##.#.#.#... .#.# #.#.#.  ....#
#.#.#.# .#  .. . ........ # # ..  . # #.##.#. .#.... ## ##.#.#.#.# ## # # .##. # . .  #..  #.#.#.. ..  .... .. .#.#.#..= .  ..#.##.##
#..  ..#..#.# #.#.##.#.## #...#.#.#.... ...# #.#.#.## #.#.#.##.#.#.#.. ..#....#. # ## ##.#.# #.# # #.# #.# #.##.#.#.#.#.# #.#=......#
#.#.##...#....... #.... . . #   . .=#.#.## ..# ..#... . . . .......# ##.##.## .# .... .  . ..#.##.## .....    #     ..#.# # #.#.##.##
# #.## # # ##.#.#.### #.###.#.# #.#=#.# .. #...#.. #.##.# #.# ## #.. =. .... .# .# ## #.## #. .... ..## # # #. .#.# # . ........  ..#
#.... .   .... ...  .... . ...... .  ...##.#.#...# . . . . . .... .#.## ##.#.# ##.#.#.# ## ##.# ##.## ## #.#.##.....#.#.#.###.# ## ##
#.## ##.## ## ## ## #.## ###.###.##.#=# .  ....# #.##.#.## ##.# ##  ..  .... ...  . ... ....# #= .  ... ... . . #.# .. ..  ...... . #
#.... .# #..  ...... ..  . ....... .....## #.#. . ......##.#. ..   # ##.#.#.#.# # # # ##.# #  ..##.###.## #=#.#. . .#.##.#.##=# #.# #
## # # ..#.##.##.##.# #.#.##.# #.##.# # ##.#.#.### ## #. .. #.# ##. ...  ........  . .##....# #..... ... #.##.#.# #.## #.#.#. #. .. #
# .# #.# # .  .. ... ...   . . . .  ....... ...   .= . # #.#. ... .# ##.#.#.# # # #.#.. .# #..#.## #.# #........ ...... ..  #. .#.#.#
## #  .#. #.#.#.##.#.#.##.##.# ##.#.##.### # # # #.## ##.##.#.#.##  .##.#  .. ..   .. ####.##....=. . ...# ##.# # ## # # #.## #.#.#.#
#....# . #......  ..... .      .... .... . .  . ... .. .... ..... .#.    .#.# #.#.#.#..... .# #.##.#.##.##.##.#.#.  ...... #.   . ..#
##.#.. #=.#.#.#.## # ##.##.#.#.##.#.#.##.#.#.##.##.## #.##.# # # # .# #.#.  .   ... # ##.# #..#..    .   .....# .#.#.#.#.#. # #.## ##
#.. .# # #.   .  . . . . .. .  .... #.## #..# #.## # .#.##.##.#%#.#.#.o.# #.# #.##.#..#.##  #.. ## #.#.# #.# #  ##.....# # #.... ...#
## #....  # #.# # #.###.# #.# # #.#......  #    ... #.#.   .    .  ...#  .  ... ... #. ... ##.#  #..  ........#.   #.# .. ..#.#.##.##
#... # # #.. . ..=.  .. . .....     # ##.#.# ##.##.#.  #.#.##.##.## #...##.##.##.##.. ##.#.... .## # #.#.#.# #  ## #.# # # #...   ..#
#.##. ... #.# #.#.# # # ###.#.## ## #.##.# ..#. .#.##.##.#.##.#.##.##.# ## #.# #.##.# ##. .#.##..  .. ..   ..## .# . . ....## #.## ##
#  . # # # .#...# .............#      .  ..#  #.# . .. . ... ....  . .   ......  ... ... #  ....##.##.##.#.# ...#. #.##.##... ..... #
#####################################################################################################################################
