################
### ##.#. # #. #
##     . #    ##
# ##.# #  # #  #
# o### # ## # ##
# #     . .\#% #
#=# #.## ##   ##
# . .     .##  #
# #.##o### #.o##
#  ## ## #.##o##
##=  .     .   #
#=## ### # # # #
# .. . . # # # #
## # # # ##  ###
#    = ... #   #
################
