############################
## . .#   .   #  =.    .#. #
#  # ##### # # ###.#.# # .##
## #.##   ## #  .  #  # .#.#
#  .#   # .   ##.# # ### # #
###  # #.# #.#    #  .#.   #
# # # #    # # # #  # # ####
#   .  #### .#. ###.#.# #. #
####o#    # # .#.# ## #   ##
# o   ###    =#    #. ## # #
##.## #  .###.# # #=#    #.#
#   #  ### .# # .# . ## #  #
### # #   #   ##  # #\  # ##
# # # # # # ##  # # . ### ##
#.#.# # #.#    #  .# #     #
#  # #   ##.#.#. #  ## # # #
# #. ###   . # # ## #. # # #
# .#     ## ##   . # #  ## #
## .# ### .o#  # #     #  ##
# .#  #  .# .#.# # ## ## # #
##  ## .# %### #.# #     # #
###   ### #   ## # .## #=  #
## ##.  . . #o . # #  #  ###
#   .# ### #=# # .#  # #   #
##.# ##  # # #.# ## #  . # #
##.#.  #.  . .#..   #####  #
#.  ##  .## #  # #.#.. .. ##
############################
