########################################################################
#      #      # #  .##  # # ##  .  .  . .    #  ## #  #   .  #.# ## #. #
# #.#### ## #  .  #   #        # ## ### # ##.# #.  . # .# ## #.     # ##
##    .    #.#.# #..## #.# # # ##      #  #  . . # ##  #. .  ##.## ## ##
#. # ### # # # # ## .  #  #  #   # ### ### # #### # ##  ### #  . #   . #
#.#### # #   # .. . ## # ## # ##.#        .#      . .  #      #.# # # ##
## #     # ##.# # #           .  # ##.#####  # #### ## ### # #     ## ##
# ...# # . #  # # # ## ### ### # # # .    # #. #.  ##=#   .  #.# #  .  #
## #.# # # . # #  #. #o#     # # # ## # #  . # ###.#  # # # ## ## # ## #
#.  ###. # # #   #  # ..# ##   # #.  # #.## #.   # # # #  #       # ## #
## # #. #.##  ###.##.## # # ###  # # # #  #.# ## #       #  ##.# #    ##
## #.##.     #.      .# # #  .  # .# #   #  #  #  ## ### # # # ## # #  #
#  # .# ## ##  ### # #  #  #.## # #   ## ##.# ## # . #.  #  .       # ##
###  ## ## # #    #   #   # .# # # ##         #    ## # # # ##### # # ##
#   #  #.  #   ##.### ##.# ##.       ##.##### # # # #   .   #      # . #
## #  #  ## ###        ..     # ## #  # # .   # #     # #.#  ## ### ## #
## # ## #   .  # ## # # ## # #=     ##   .# #  #. ### # ##.##   # ...  #
#        # # # #   # # ## # . # ###.#  # #  # # #   #  #. .   #.  ## # #
#######=# ## #  .# # .    # ### #  .# # # #   # #### # # ## #  ### . #.#
#         .. #.# #.  # ### #      #. # .#   ##       ##. #  # #    #. ##
#.## #########  . # ##     . ####   # # #.# #. # # # .  # # ... ##  ## #
#  # #      . ## #.   ## # #     # ## # ###  # #  # ## #   # ##.# # .  #
#.# .## ### # .#   ####   #  ## # # .       #  # #  #   ##          ## #
#  #    .  ## # ##      # # #  .# .# # ## #   ## ## ##.# . ## #.## # # #
# #  # ###  .  .  #### ###    # # #.  # ###.#  .       . ## # ## ##  # #
#  #      ## # ##     # #.### # #.## #   .    ## # #.## ##          #  #
#=#  # ## # .# .# ## #   .  # # #    #.###### #   .   # #  ##.#### #####
#  # #= .  #  .#     # # # # #    # #.      ..#.# ## ## ### # #   #.#  #
# ## # ##.## ## ## #    # #   # # #  # ## # # # #.       =   # # #. . ##
#.# # # # #   . .#.# ##.   ## #.## ##    # #  #  # # ## # ## #    # # .#
# #   ..#   # # #  # # # # ## #       ####.## ####.# # #.# # ###.#.  # #
#.  #.# # # # # ### .  # #     #.# ## #   .        #    .  #   #.## ####
### ## .. #  ##    #.##  #.# #  #   . # ## ## ## # # # # # # # #     # #
# #.  ####  #  #.# #. .# # ## ## .## # . ##.##   # # # ##  #  #  ### . #
# ###.   # ## # ## # #.  . .# #  # .  # # .o = ## ## ..  # # # ### # # #
# .  #.###   .    #  ## # #.#  #  # # # # ##### # #.# # #. .       #  .#
# # ## #   ##.# ## #  . # # # ## # ## #       .    .  ## ###.# ## #  #.#
# #   ## # . # .    ## #  # #  .    .#  # ## # # ## #  .   #= # # ## # #
#  .#    # # # # ##  #  # #  # #.# # .# # ## .#  ## # # # #  #  .#     #
## # ## #  ## #  #  # #.  #.#  ###   #      ## #    #   #  #   #   #####
###  .#..# .  # # # # # # #  ##   ## #### # #    ### # #  #### # ##    #
## ## # # #.#  #        # # #   #        ##. # #   # #. #.##   # ## # ##
#  .. #  . # # #.# # ## .#. ### .### # ##   ###  #.# # ##    #         #
## ## #.## # ### ## #   # # .   #      #  #### #  ## . .  ##. ### # # ##
#    ##  #  ..    ..  # # # ##### # ##  # #.#  ##  . ## #    #   # #. ##
##.#.  # .### ## ##### ##...#     # ## #  # .# .  # #   # # #  # # .#. #
#.   ### #  . .#          ### ## # # .  # # #  ###.  ## # ## ##  # ## ##
## #    .  # # # ## ### ##.  #  ## . # #     ##  ## ##.       ##.#.    #
#   #### # .   #. #  .#    #. #   ##.#. #.###  #  #..  # ## #    # #.# #
###   ..#  # ## #   #  #.#. # # ##   # #.     # # #.## # # ##=## # ## ##
#   ###  #.      ##.# ## .## #     # #  # ####. #   #  #    . .# #     #
### # # ## ## ### # # #. ##    ## ## # ##      # ##  #.# # ## ##   ###.#
# .     #  # . .  # #  # # # # # ##=      # # # ..  # # . ## #  ###  # #
# ## ## ## # # ## # # #   .# #     # ### #.## #.# ##   #.#     #    #  #
#    #.   .  #.  .# #   ## # # # ###    #      # .#.##.  ..#.# ## ## ###
# #####.#### # ##   # ## .   #.# #.  ##.# ## #. # # ## # ## .       . .#
#    #  # .# # .# ### # # ## #.#   #  ### .# ### #          # ##.## ####
### ### ## # # #  #          #   # # #  . #.#     # # ## ###    . ##   #
#.   # #     #  #   ### ## ## ##%# # ####.  #.### #   ##  . ##.# # . # #
## #   .## #  ### #   ### ##   #    #     #.#  .#  # #. ## #       # # #
#    ## #    #  .   #  ..   ##   # #. ###     # #.#  # # ..# ### ##    #
####. # ##.#### ### # ###.# # ##.## #     # ##  .  .#  # #.    #.  # ###
#  # #       #.# . #.##.  .    #    # ## # .  # ### ## #. .# #   # #. o#
# ##.## ### ## # #     # ## ## # # #    # ##=# ## #   ..#.# ## ##.   # #
#   . # # # \   # # ## ..# #  ## #.# # #    #  ..  #.##  #     # #.# #.#
##.# # .  ###.#    .## # .. #    .  # # #o##. # # # # .#  #### #.# # ###
# #  ## #   #.### #   #  # ## #### #     . .##.## # #.## ##. # #    .  #
#  #   #..##    #  ##  #   #.  .     # # ##  .      .      # #.#### ## #
## # ## #   # #.  #   # # #.#### # # .#    # # # ### ###.###.#.  .  #  #
#    .    ##.## #. # #  ##          # ###### #.# # . . #       # ##   ##
# # # # # # .  . #     #  .# ##.# # #.      #  #  # ## # # ## #  #. #  #
########################################################################
