###########################
#       ## . o   #.##   # #
# ##o## ...## ##..   .# o #
# ## .  # #  .   #.#.## # #
#  .# #..# .# ## . #  .#. #
#.# #.  #  #.  .#.#..# .#%#
# . .# # #  # #.#   #  #.##
## #   . . ###. ..#..#    #
#   # # #.# ## # # #. # #.#
#.#.  .  .. .# # # . # . .#
# . ## ## ## . .   ## # #.#
##.##  .   # # #.#    .   #
#. #. ## #  .. .. .# ## ###
# #  # .#..## # ## #   .# #
##  ###.## #.  #=    #.#  #
# .####.#   ##  # #\#   #.#
#.#.##  .## .# ## #  # # .#
#o     #  .#   # . # . .#.#
# ## #  #.##.#.  #  .# #  #
# .   #  .    .#  # #. # ##
# ##=#. # # # #  #  ##  . #
#.##   ## #.# ##.=.### ##.#
#  .=# ...   .  .#. #.### #
### # # # # # # ###    # .#
#. .    ##    .# ### # ..##
##.##=#.   # #.    . . #  #
###########################
