########################################################################
#...... . .. .=.  #.#..# .. .# .#.#. .#.#.#  #.#.#. # .. . ..  ... ...##
##.####.#.#.#.###.# .# ## ##.## #.# # .. .=#......#.###.##### ### ####.#
#..# .#.# .## #...#.#. .#.#.... .. #.##.#.#..#.##.# ...# .. # #. .#....#
## #.# .#.#. ..##.#..#.# . #.#.#.##..#.## ##.## ###.##. ##.#..#.# ##.# #
##.#..#.#.###.#.#.#.## #####.## #o##.#..  ......   .#.##.# ## ##.#.###.#
#..#.#..#...#.#. .# ......  .. ..  ..##.########.##.. .. .....  ..... .#
##.#. #=#.## ..##..## #.# # #.#.## ##.#.# .  ..# #..##.#.#.###.#.#.##.##
##.#.#. #.  #.#.. #..#.#.#.#.#.#.#.##.## #####.## #.#.# #.##.##.# ##.#.#
#..#.##.#.##.. ## .#..  .. .  .# #....  ..  ......... .... .. .... .. .#
##.#. #.#...# #.# #..##.#.#.#.#..# ##.#.#### ################### #.#.# #
#..#.# .# ###.#.# ##..##.#.#..##.#   #.# o # #..... .......  =.#.##.# .#
##.#. #.#.#.. # #... #.   ..#. #.#.#.#..#.## ####.#.## ###.### # .#.##.#
#..# ##.#..## # #.###.#.##.#.##..# # #.#. ......#..##.#..#.#...#.#.. ..#
##.#.=  #.#...#.. #. .#.#.=....#.# # #..##.#.# #..#  .. #.# ##.# =##.# #
#. #####..#.#. ## # ##..## ####. #.#.#.# ## .#..#..#.##.... .#.#.#.##.##
## .. ..#.#.# ###.#.#.# .# . . #.#.# #. ...#.### ## # # ######.#...  ..#
##.##### #.#.#.#.##.# #### #####.##.##.##.##... . .. ... .  .. #.#.##.##
#. . .. ........ . . ....... . . . ....#..#.## # #.###.## #.#.## .#.#  #
###### ##.# #.# ## #.##.## # #.### ###.##.# ..###.##.#.#.# # ##..#.  .##
#  . .  ##.#.#.#.###.#..#.# #.## #.#... #..## ##..#....#... ...#..#.#.##
#.####.#......... . ..#..   ... .#.#.# ##.#. .. #. ###.#.#####.#.# ##. #
#. ..#.#.#######.#.#.#. #.##.##=#..#.#.#. # #.##. #. ..#.# .. .#.#.#..##
#.###..#.. .... #.#. ##.#. #.#.#.#..##. # .##.#.#.#### #  ###### ...# .#
#.#..#.#.#######. .#. #.# #..#.. #.#...## #.. ...... . # # .   ..####.##
#.#.#..#.#.. .. # ##.##.#..## .## . ##.#..## ##.####.## .# ##.##.#... .#
# #..#.#.######.#.# .#..#.#.##.#.#.#.   #. #...#.   #..# #.#  #..#.## ##
#.# #...#.......#.##. # #.#........#.# #..##.##.#.##..##.#..#..# #..#. #
#.#.##.#.###.##.#. #.#  #..# ##.##.#.#  #.#. ...# #.# #. #.#..##.#.##.##
#....#.#... #.# # ##..## ##.##.#.##.##.#.  #.## #.# #..#.#..#.#  # #. .#
# #.#.. ## #...  .. .#  ..   ...........#.## #..#.  #.# ..#.#..#.# ##.##
#.## #o#.#.########## ################.# .#.#.### ###.## #.##.#...#.  ##
#....#.#.#......  . ... ....  ... ...#  #.# ..... .......#.#...#=#.###.#
#.##.# #.#.##.#.#.##.# #.#.#.##.##.## .#...###### #.#.##.#..#.#...  .. #
# .# #.#. ..## #.## #.# #.# #.#..#.#.#. #.#......#.#.#...#.# # #.##.#.##
#.#..#.# #.# ... ...#.  #.#...#.##.# #.#...#.#.#.#.#. ##.#. .....#.#.# #
#. #.#.#.#.##.###.#  ##.#.#.#.#.#... #.## #.# #..#.# # .  ## # #.. ....#
#.#..# ###..#=#. .#.#.#.. ..##.#.##### .# ... .#.#.#.###.#..# ..##.#####
#..#.# ....#...#### #.#.####..   ... . #..## #.#.. .   # .#. #.#.   ...#
### #.#####.### ......  .. .## ###.#.# .#. #.#.#.###### .##.##. ##.###.#
#...... ...... #.# #.#.##.# # #....#.# #. #..#.#.#.....#.#. ...#...#.#.#
##############.##.#.#.#.# ###.#####.##.###.##.##.#####.#.######.## # ###
#... . .  .. ......... .... .. ..... .. ......... ... ... ... . .. . . #
###.##.################.#.###.# ## # # ## ######## #.#### # ## ##.#.#.##
#..#.#.#. . ..  .  .....### #.##  #. #.#. #...  ..# # ..#.#.#.#.##.#.# #
#.##.# .#.#.##.##.#.#.# ....#...#  # #..#. ######.#.#.#.# # .. .. . .. #
#. . #.###. #..#...# #..#####.###.## #.##.#...  ..# ###.#.#.##.#.#######
#### # .##.# #.## ##..#.#.. ..#. . . #.#...###### #.....#.#.#.## #..  o#
#...  ## ..#.. .#.# .#.  # ##..#.### # .#.#....... #.##.# #.#.#. # #.# #
##### # ###.##.# . #..#.#..#..#. #.#.#.#...######.#.#.#.##..#. #.###.###
# . . #.... .#..#.#..#..##..#  #...#.#. #.# ......#...# ..#.#.#...... .#
#.###.#.###### # .## ##..#.#..#.####.# ##..#.#.##.#.#.#.#.#.#.## #.##.##
# ..#..........##.. . #.# ..#.#......#.#..##. #.#.###.#.##..#  ..#.# #.#
####.########## ######.#.###.#.######.#.# #..#..# . ......#.#.##.#.. ..#
#... . ...........  . ......... ....... ..## .#.#.#.##.##.#.#..#.#######
### # #.#.#.### ######## ### #####.# ##.#..# #. . #.. #.#.#.#.#... ..  #
#.#.#.#.#..## ##.......#.#. .#.. .#...# #.#.#.### #.## .#.#.##.#.#.#.#.#
#...#=#.#.# .. #.##.##.#. ##..###..#.#..#.. . ... #...# # #\...#.#.# # #
# ## #.##.# ###.  #.# #..#. .#....#. .#.#.## # ##..####.#.#.###.# #.#=##
## .. .. .  ...#.#. ...#.###.####.##.##.#.#. # #..#..  ...#............#
## ## ###.#.####. # ###.. .#...... .##.# ..#.# ##.#.##.##.# #.##########
#. .#...#.#.#. ..#.....#.#.#.##.##.#    #.##.#..#..# ##.#.#..#..... ...#
##.#.###.#.#.###.#######..##..#..#.#.#.#..#..#.#. #. .....# #..#.#######
#. #....... . .. ..= . ..#.  #. #..#.#..# .#.# .# .#.##.# #.##.# ... ..#
##..# #.# ########.#.###..##.##..#.#.# ##.#.#.##..# #.#.#.#..#.#.#.##=##
#  # ## #.#  ... .=#...#.#... #.#  #.#.# %. .. .#.#.# #.#.#.# .# #.#.#.#
##.#....#.## #.### # ##. #####.# ### ##.#.#######.#.  ..#.# .#. ## # # #
#..#.## # .#.## ...#.# #.... ..  .......#.#..  ...#####.#.# ##.##.##.#.#
## #..#.#.# . .#.#.#.#.# ############### .##.#.#.#  ..#.#.#. . ....... #
#..#.##.#..####.##.#.#.#......  . ... ..#..#..#.## ####.#.#.##### #.####
## #.#..# #. .. ...#.#.  # #.##.#.#.##.#..#. # ..   ....#.# #.   .#.   #
########################################################################
