###########
#==#== ..##
##.# ###o.#
#..#o#  ###
##   .#.# #
## ## # #.#
#o.  ## # #
## # o  % #
#  #.# ##.#
## #.#  #\#
###########
