##############################
#.#.#.#............##.#.#..#.#
#.#.#..##.#.##.###........#..#
#...#.#.....#..o.#.#######.#.#
#.###=.###.#.#####.......... #
#.....#.........\..#.###.#.###
###.#.#.#.#.##.#.#...#.#..#..#
#.###.#.#.##.##.#..##..#.##.##
#....o#.#........#...#.......#
#.#.#.#...#######..#.#.####.##
#.#.....#..... ..#...........#
#.#.#.##..##.##.#..##.#.##.#.#
#.#.#.#.##.##.#.##.#.#...#.#.#
#..=#..............#..#.#..#.#
#.#.#.#.#.##.##.##.#.#...#.#.#
#.#.#.#.#..#.#.#.#.#.##.##.#.#
###.#...##.#...#.#.#.......#.#
#...#.#..#..%#.#.#.#.##.##.#.#
###.#.#.##.#.#.#.#..##.#.#.#.#
#.#.#.#..........#.#.........#
#.....#.#########..#.#######.#
##.##.#..........#.#.......#.#
#.....#o#####.#.#..#.######..#
##.##.#.#.....##.#o#.......#.#
#.....#.##.##....#.#.##.###..#
####.##..#..#.#.#.=#.......#.#
#......=#..#.....#.#.##.####.#
####.##.##..#.#.#..#..#......#
#.=........#..#..#.#.#..#.##.#
##############################
