############
# ##=%  .  #
#   ## #####
#.# # o .  #
# # o#.## ##
### # . #  #
#   ##.#.###
## # . =..=#
##o..### ###
#.o###.# #.#
## \..=#  .#
############
