##############################
## # ## ## # #           #.# #
#.    .     . #### # # # #.  #
# ######## ## #  .. # #. #.# #
#.# ..o  . # # ###.#.  #.# ###
#   ######    .  #  # ##.#  .#
#.# o      #.#.# #.#    .# # #
#  # #####.## # #  ### #     #
#.#  .. .# .   . #. .# # # #.#
#.## # # #.## ###  ## ## ##.##
#  # # # #  #.#  #.  .  . .= #
# # # # ## ## # #  # ####.## #
# #=    .  #    .#.# ... # # #
## ####### ## #.## ## # ## #.#
#   ..     .# # #   ###   .# #
## ## ## # ## # ## # . .#### #
# #. .# #. #  #   . # # # .. #
#o# # .  # .# # ## #  #..# # #
# #.# #.# .#.#.#.# #### #.# \#
# #.# .#.#.  o.% ..     .. #.#
#. . .##  # #.# ##.##.# ## # #
## ## #  # #   ..#  #. #.###.#
# # # ## # ##### # #  #      #
# # ..    .      # ##.##=#.#.#
#.# # ## # ##.# #.  #   # # .#
# # # # # # # #  # #. #    #.#
#     # . =     #   # # #### #
### # .## ##### ##.#.. .   ..#
#   # #.    .    #.. # # # # #
##############################
