##########################################################################################################################
#.#.#.#.# #...#.#........ ..#.#.#.##.#.#...#..#.. .  ....##.# #.##.#... .# ...........#.###...##.#...#....... ...........#
#......... .#.....#.#.## #.#.............#..#...#.##.#.# ............#.# ..####.#.#.##.. ...#......#.##.#.#.#.##.##.#.##.#
#.#.#.#.#.#.##.##.#...##.#.##.#.#.##.#.#...##.#.#.##.#.#.##.#.#.##.#... .#.#.. .... ...#.##...#.##.#.##.# #.#.##.##.#.##.#
#.#.#.#.#.. ...... .#....................#......................#....#.#.....##.#.#.##.#.##.#............................#
#. . .....#.##.##.#.#.##.#.#=#.##.##.#.#.#.##.#.#.#.##.#.##.#.#..#.#.#.. #.#...... ...........# #.#.##.#.#.##.#.#.#.#.#.##
#.#.#.#.#................. .=........... ...... ..........#.#.#.#..... #...#.##.# #.##.#.##.#.......... ...= .#.#.#.#.#.##
#.#.#.#.# # ##.##.#.#.##.#.#.#.## ##.#.#o#.#.##.#.#.#.#.#.......##.#.#.. #...#.##.#.#.........# #.#.##.#.#.##... .. .....#
#....... .......# #.#.... ....... #.......................#.#.#......#.#.#.#.........#.#.##.#.#...............#.#.#.#.#.##
#.#.#.#.#.#.##.#......##.#.#.#.##..#.#.#.#.##.##.##.#.#.#..... .##.#....  ...#.##.##............#.##.###.#.##...........##
#.#.#.#.#...##..# #.#.. ..........#...  .#.##... .........#.#.#.##...#.#.#.#.#.....#.#.#.##.##.#............. #.#.#.#.#..#
#.........#....#..#.# ##.#.#.#.##..#.#.#..... #.#.#.##.##.#........#......... .##.#.............#.#.#.##.#.##.....# #.#.##
#.#.#.#.#. .##.##........ ........##.#.#.#.##.....#.## .....##.#.#.#.#.#.#.#.#..#.#.#.##.##.##.##.#.#.## .....#.#... ...##
#.#.#.#.#.#.##.##.#.#.##.#.#.#.##....... .....#.#......##.#..... ..... ........#.  .......... ...........#.##.....#.#.#..#
#.. ..............................##.#.#.#.##.....##.#.##.#.# #.##.#.#.#.#.# #.##.#.#.##.##.##.##.##.#.#......#.#.# # ##.#
#.#.#.#.#.#.##.#.#.##.##.#.#.#.##.##.#.#.#.#.##.##........  ............. ...#...........................#.##............#
#..... ......... .... ............ ............... ##.#.#.#.## #.#.#.##.#.## ..##.#.#.##.#.#.#.##.##.##.#..##.#.#.#.#.#.##
##.##.#.#.#.#.#.#.#.#.##.#.#.#.##.##.#.#.#.##.#.##.# ##.#.# ##.#.##.##.#.#.#.#.##.........=.......#..##.##........#.#.#.##
##.##...#.#.# #.#.#.#.## #.#.#.##.##.#.#.#.##........  ... . .....................#.#.##.#.##.#.#..#.......##.#.#........#
#.  ..#........ ................. ........... #.##.#.##.##.#.#.##.##.#.#.##.##.#.#.##.##.#.##.#.#.##.##.##.##.#.#.#.#.#.##
##.#.##.#.##.#.##.#.# ##.#.#.#.##.##.#.#.#.## ..................#................. ............. .... . . ...............#
#.. ....................... ..o............##.##.#.##.##.#.##.#...#.## #.##.##.#.#.# #.#.##.#.#.#.#.#.# ##.##.#.# #.# #.##
##.##.#.#.#.#.#.##.#.# #.#.#.#.## ##.#.#.#... ........##.#.#.##.#.#..#.#.##.#... .....  . ........... ................#.##
#................. ........................##.##.#.##.......... ....#........#.#.#.##.## #.#.##.#.#.#.#.##.##.#.#.#.#....#
## ##.##.##.# ##.##.##.#.# #.#.##.##.#.#.#.##.. .... .##.#.#.#.##.#.##.#.## ##................... ............ ...# ..#.##
#..................... . ..............#.... .##.#.##................. ........#.#.#.#.#.#.#.##.# #.#.#.##.##.#.#..#.#...#
##.###.#.##.#.#.#.#.##.#.#.#.#.#.#.#.#...#.## ........#.##.#.## #.# ##.#.#.#.#.............#.##.#.#.#.. ........#.##.##.##
##.##.#.#.#.#.#.#.##.........#.........#.#.##.## # #.##........  ....... ....#.#.#.#.#.# #.. .........#.##.##.#.... .....#
#.........  .........#.#.#.#...##.##.#.#................##.##.#.#.#.##.#.#.#...#.#.#.#.##.##.##.##.##......#..#.#.##.#.#.#
##.##.#.#.#.#.#.#.##.........#..... .....##.#.#.## #.##.##.#..#.#.#.##.#.....#......................#.#.##..#..........#.#
# ..... ........#.##.#.#.#.# #.##.##.##.#.. ............. ...#.... ......##.##.##.#.#.#.##.#.#.#.##........#..#.#.##.#...#
##.#.#.#.#.##.#...........................#.#.##.##.#.#.##.#.#.##.#.##.#. ......#.#............#.##.#.#.##..#..........#.#
#........#.##.#.#.##.#.#.#.#.#.##.#.#.#.#.. .....##.#.# ##.... ..........##.##.#....#.#.##.#.#.............#..##.#.#.#...#
##.#.#.#........... ....................#.#.#.##...........#.#.## #.## #.##....##.#.#.#.##.#.#.#.##.#.#.##..#..........#.#
# .#.#.#.#.##.#.#.##.#.#.#.#.#.##.#.#.#..........##.#.#.#.#..=..............##.......... ... .........##.#.##.##.#.# #...#
##.......#.#.. .... ....................#.#.#.##...........#.# ##.#.##.#.##....##.#.# #.##.#.#.#.##.#. ..........#.# #.#.#
#. #.#.#....#.##.#.#.##.## #.#.##.#.#.#.#.. . ...##.#.#.##.#.#.#.##.##..... ##.  .......##............##.#.#.#.#..... ...#
##...  ..#.##.##.#.#.##.....=.............#.#.##..... ........ ........#.##....##.#.#.#....#.#.#.##.#............#.#.##.##
#..#.#.#................##.#.##.#.#.##.##.#...##.##=#.#.# ##.#.#.#.###.# ...##.##...#...##............#.##.##.##.#.## ..##
##.......#.##.#.#.##.##........ ...... .....#.........#...... ......... .##.......#...#....#.#.#.#.##.................#..#
#..#.#.#....#...#.##.#.#.#.##.# # ##.#.##.#...##.##.#...# #.#.#.# #.##.#.##.##.##...#...##.#.# #.#.## #.##.##.##.# ##.#.##
##.....#.##...# ........................#.#.# ...#.##.#...........................#...# .................................#
#..#.#.. ...#...#.#.#.## #.##.#.# ##.#.#...##.##........#.#.#.# #.#.##.#.##.##.##.#.#...##.# ##.##.#.#.#.#.#.# #.#.#.##.##
##.#.#.#.##...#.#........................#...... ##.#.#.#.#............  ##.##.#......#.##.... .. .......... ......... ..#
#...........#.....#.#.#.##.#.## #.##.#.#...#.#.#............#.#.#.#.##.#........# #.#......##.##.# #.#.##.#.#.##.#.# ##.##
##.#.#.##.#...#.#........... ............#.#.#.#.# #.##.#.# #.......... .##.##.#..#.#.#.##.........#.#.##.##.#.#.#.#.#.###
#.........#.#.# #.##.##.#.## ##.#.##.#.# .......... ..........##.#.#.#.#........#.... ..##.#.#.#.#.......................#
## #.#.##..o..................... .......#.#.#.#.#.#.##.#.#.#.##.#.#.#.#.##.##.##.#.#.#.. .........#.#.#.#.#.###.#.##.#.##
#........ #.#.#.#.#.#.#.#.#.#.#.#.#.##.#... ..........#.#.#.............. ....  ....#.#.##.#.#.#.#.......................#
##.# #.##... .#.#.#.#.#.# ##.##.#.#.##.#.#.#.#.#.#.#.#......#.#.##.#.#.#.##.##.###.#....## #.#.....#.#.#.#.##.##.#.##.##.#
##.....##.#.#......... ...............................#.#.#........ ............ ...#.#........#.#.. #.#.#.##.##.#.#.###.#
#. #.#........#.##.##.#.#.##.##.#.#.##.# #.#.#.#.#.#.##.#.#.#.#.##.##.#.#.#.##.##.#.#.#.##.#.#.#.. #................. ...#
## ... ##.#.#.#.##....#..... .....# ##.#...#.#........... . .................. .....   ........ .#...#.# #.##.# #.##.#.#.#
#..##.#. ..........#.#..##.#.##.#........#... .#.# #.##.#.#.#.#.##.#.##.#.#.#.#.#.##.##.## # #.#.#.#........... #.## ###.#
##......#.#.#.#.## ...#..... .....##.#.#...##.#... .... ......#.##.......  ...#.##.#.#.#.............#.##.#.# #..........#
##.##.#.# ## #.#.#.#.##.##.# ## #....#.#.#.##.##.#.#.##.#.#.#......# #.##.#.#............#.#.#.#.#.#............#.##.#.# #
#...... ................ .........##...............#.##.. .. .# ## #.#....#...#.##.#.###..... .....#.#.##.#.#.#..........#
##.#.#.##.##.#.#.##.##.##.#.#.#.#.##.#.#.#.##.##.#......#.#.#.#.  .....##...#............#%#.#.#.#. ...... . .#.#.## #.#.#
#......##.##.#.## #.##............... ... .........# ##.#.......##.#.#.##.#...#.##.##.##......  .# #.#.##.#.#............#
#.## #............... .##.#.#.#.##.#.#.#.#.##.#.#.#.#.#...#.#.# ........... #...##.##.#.##.#.#.#..............#.#.#.#.##.#
#... . #=#.#.#.##.#.##...... ....#.......# .#.#.#.......#.....#.##.##.#.#.#.#.#..............#.#.#.#.#.##.#.#.##.#.##.##.#
##.#.#.#.#..... ....##.##.#.#.#.#..#.# # ..#. ....#.#.#.#.#.#..... ...#.#.#.....##.##.#.##.##........#...................#
#.. ..... .#.#.##.#......##.#.# ##.......#.##.#.#...........#.#.##.##... .. #.#.#.#.#.........##.#.#...##.#.#.##.#.##.##.#
##.#.#.#.#.#.#.#....##.#... .......#.#.#. . .... .#.#.#.#.#...........#.#.#...........#.##.##....... #.##.#.#.##.#.##.##.#
##.#.#..........#.#.##.# ##.#.##.#.#.#.#.#.#.##.#.#.........#.#.##.##.#.#.#.#.#.#.#.#.........##.#.#................ ....#
#.....#.###.#.#.  ..................................#.#.#.#......... .......#.#.#.#.#.##.#.##.#..#.##.#.#.#.# ##.#.##.##.#
##.#.##.##.##.#.#.#.#.##.##.#.##.#.#.##.##.#.##.#.#.#.#.#.#.#.#.#.#.#.## ##................ ...#.........................#
#....#..............# ##.##.#.##.#.#.## ##.#.##.#.  ........#.#.....#....##.#.##.#.##.##.#.#.#...#.##.#.#.#.##.#.#.#.#.#.#
##.#.. #.#.#.#.##.#......................... .....#.##.##.#.....# #...##............ ......#.#.#............##...........#
#..#.##.##.#.#.##.#.#.##.##.#.##.#.#.##.#.#.#.#.#....#.##.#.#.#.#.# # ...##.##.#.#.#.# #.#...... #.## #.#.#.. .#.#.#.#.#.#
##................ ........... ............... ...#.#...... ..#.......##.##.##.#.#.#.#.#.# #.#.#............##..... .....#
#..#.#.#.#.##.#.## ##.##.#.##.## ##.#.#.#.#.#.#.#....#.##.#.#...#.#.#................. ..........#.##.#.#.#.##.#.#.#.#.#.#
##.#.#.............. .... ............ ....##.#.#.#.##.##.#.#.#.###.#.##.##.#.##.##.##.#.##.##.#.#.#. .. ........... ..=.#
#.... .##.#.#.#.#.#.#.##.#.##.#.#.#.#.##.#.  ..... ........  .................##.##.#............ .. #.##.#.##.#.#.#.#.#.#
##.#.#.##.#.#.# #.#...##..................#.#.#.#.#.#.##.#.#.#.##.#.#.##.##.#........#.#.#.#.#.#.#.#.#.##.#..............#
#...................#. ..##.# #.#.#.## #.#..#.#.#.#.#..................... .#.##.##.##.. ......# .... ......##.#.#.# #.#.#
##.#.# #.##.#.##.##. .##.#.#.#.#.## ##.#.## ..........#.##.#.#.##.#.#.##.##........ ##.##.##.#...#.# #.#.##..............#
#........##.#.##..#.#............ . .......\#.#.#.#.#............... .. ....#.##.##....##.##.#.#............#.#.##.#.#.#.#
#.#.##.#. ...... #....#.#.##.#.#.##.##.#.##.#. .......##.#.#.#.##.# #.##.# #.....##.##. .........#.## ##.##.#.#......#.#.#
#.#.##.#.##.#.##.##.#.#.#.# #.#......#........#.#.#.#..#.#.#.#.#. ....... ..#.##.......#.#.#.#.#.#..............##.#.....#
#............. .......... ......#.#.#..#.##.#.#...#.#.#..... ...#.#o#.##.#.# ....##.##.##....#.#..#.#.##.## #.#.##.#.#.#.#
#.##.#.##.#.#.##.##.#.#.#.#.#.#.#=#.## ##...... #.......##.#.#.#......##.#.##.##.# .. ....##. ...# . ........... ....# #.#
#.#.#.............. . . ............. ....#.#.#.#.#.#.#.....  ..#.#.#..... .......#.##.##....#.#...##.#.##.#.##.##.# ....#
#.....#.#.##.##.#.#.#.#.#.#.#.#.#.#.#.#.#...............##.# ##.#... .##.#.## ##.##.##.##.##.#.#.#.##.#.##.#.......#.#.#.#
#.#.#.. . ............................. . #.#.#.# #.#.#....#.##...#.#.##........ .... .... ..... ............##.##.......#
#.#.#.#.##.# #.##.#.#.#.##.##.#.# # #.# #.#... ....  ...##......#........##.#.##.#.#.#.##.#.#.##.#.##.#.##.#. ...#.#.#.# #
#...... .......................... . .......#.#.#.#.#.#.##.#.##.#.#.##.#.. ......... .... #.#....#.##.# ##.#.#.#..... ...#
#.#.#.#.##.#.##.#.#.#.#.#.#.#.#.#.#.#.#.#.#....... .................## ..#.##.#.#.##.#.##.....##.. ..... ........#.#.#.#.#
#............. . .. ...... .... ..#...#.#.#.#.#.#.#.#.#.##.#.##.#.#....#......#...........#.#..#.#.#.#.#.#.#.##.##.# ....#
# #=#.#.##.##.#.#.#.#.#.#.#.#.#.#...#............................ #.## ..#.##.=.#.##.#.##.#.#.#..... .. .............#.#.#
#..... .........................#.# ##.##.#.#.#.#.#.#.#.#.#.#.# #......# .....#......... ......#.#.#.#.#.#.#.#.#.#.#.. ..#
#.#.#.#.##.##.#.#.#.#.#.##.##.#.  ................#.#... .........#.# ##.#.##...#.##.#.#.##.#.##. ....... .#.#.....#.#.#.#
#...#.. ..........#.# ..## ##.#.#.# #.#.#.#.#.#.#.. ..# #.#.#.#.#.. .....#.##.#.#.##.#.#.........#.#.#.# #.....#.#.......#
# #. .#.##.#.##.#.....#....... ........... .......# #.#...........##.#.#............... .##.#.##..... .....#.# # #.#.#.#.#
#...#......#.##.#.#.#.#.## ##.##.#.#.##.#.#.##.##...#...#.#.#.#.#....#...#.##.#.#.#.#.## ##.#..#.#.#.#.#.#......... ...#.#
###. #.#.#........  ......... .. .................#...#...........##...#..... ....#. .##..... #. . .  .....#.#.#.#.#.#...#
#...##.#.#.#.## #.#.#.##.#.#.#.#.#.#.##.#.# ##.##..#.##.##.#.##.# ...#...##.#.#.#...#. ..#.#.#.#.#.#.#.#.#.#.#.# #.#.# #.#
###........#.. ...... ............................#... ...........## #.#.##.#.. ..#...##...... ...... ................ ..#
#..##.##.#...#.##.#.#.##.#.#.#.#.##.##.#.##.#.#.#.##.##.##.##.#.#.............# #...#.. .#.#.#.#.#.#.## #.#.#.##.#.#.#.#.#
##.#.....#.#.................................. ......##.. #.#.#.#.##.#.#.##.#.#.#.#.#.##.#.#.#.#.............##.##. .....#
##.##.##. ...##.#.#.#.##.#.#.#.##.#.##.#.##.#.#.#.##....#............ ...........................#.# ##.#.##.......#.# #.#
#........#.#......#..... ...........##.#.##.#.#. ...=##.##.#.#.##.##.#.#.## ##.###.#.#.##.##.#.#.....##.#....#.#.#.......#
## #.#.#.#.#.##.#...##.#.#.#.#.##.#.............#.##.......... ....#.#.#....##.## #.##.#.#.#...#.#.#... ..##.#.#.#.#.##.##
#... .............##.#..............## #.##.#.#.#.#..##.##.#.#.##.#......##...... ...........#...#...##.#...............##
#.##.##.#.#.#.#.#.#....##.#.##.#.##.##.#.##........#..............#.##.#....# ##.##.#.#.#.##...#...#......## #.#.#.# ##..#
# ........... .. ..#.#.. ...................#.# ##...#.#.##.#.#.#........##.# # ..........  .#.#.#.##.#.#.##.#.#.#.#.##.##
#.#.##.#.#.#.#.#.#...#.##.## ##.#.#.#.#.#.#.#.##.##.##.#.##.#.#...#.#.## ......#.##.##.#.#.#............................ #
#........ ..... ...#....... . .. ............................. .#.#.##.#.#.##.##.#.#...#.....#.#.#.##.#=#.#.#.#.#.#.#.#.##
#.#.###.#.##.#.#.#.###.##.##.##.#.#.##.#.##.#.##.##.#.#.# #.#.#.#....................#.#.#.#.#.#.#=...#.... # #.#........#
#. ..  ........#.#.#...#........#.#.##.#.. ...##..................#.##.#.#.##.#.##.#.............. #.#..#.#. .... #.#.#.##
##.#.##.#.#.##.......#...##.#.#..........##.# ...##.#.#.#.#.#.#.#....#......#.#.##.#.##.#.##.# #.#.#.##.....#.#.#.#.#....#
#..............#.##.#..#.##.#.#.##.#.#.#.... .##..................#.#..##.#........#.............. .....#.#....... ...#.##
##.##.#.#.#.##.......#.#... .............##.#.##.##.#.#.#.#.#.#.#....# ..  .#.#.##...## #.##.#.#.#.##.# #.#.#.## #.#.##.##
#..............#.#.#. ...##.#.##.#.#.#.#....... ..#. .. ......#.#.#.##.##.#.#.#.#.##.#. #.#........## #..  ..............#
##.#.#.#.##.##.#.#.#.#=#....... . .......##.## #.#..##.## #.#.. ............. ........#....#.#.#.#.. ...#.#.#.##.#.## ##.#
#................... ....##.#.#.##.#.#.#... ......#...... ....#.#.#.#.##.#.##.##.##.#...#.#.. . ...##.#.#.#.##.##.# #. ..#
#.##.#.#.#.##.#.##.#.#.##.#.#.#.##.#.#.#.##.##.#.##.##.##.#.#.................##.##.###.#.##.#.#.#.##............ ....##.#
#.. ....... .........................................#.##.#.#.##.##.#.##.##.#.......  . .......... ...# #.#.##.##.#.# ...#
#.##.#.#.#.##.#.##.##.#.#.##.##.#.#.##.# #.#.#.#.###...=............... ... ..##.##.###.##.#.#.#.#.##.#.#.# #..... ...##.#
#........#.#.##..# ##.#......##.#.............. ....##.#.##.## #.##.#.##.#.##......  ....#.#.#...=............#.#.#.#....#
#.##.#.#........#.......# ##..... #.##.#.# #.#.#.##.... ............... . ....##.##.##.#.......#.## #.##.##.#.... ....##.#
##########################################################################################################################
