#####################
#      . . . ..   . #
#=### ## ## ## #### #
#o.      ..  #    #o#
#.#######.### ##### #
#     =. .   .    . #
# ## ### ##.#.#.#.# #
# #.    . .# # ##. \#
# ## ### ## . .  .# #
#= .   #.# # # ## # #
#.# #.##    .  .# # #
# ##.#. .###.###  #.#
#o   ..#o# . . .# # #
# ## #%# # #.## ..  #
#    #   ### ## # # #
# ## ###    . . . # #
#  .     # #.# ## # #
# ## # # . #.#      #
# .   =#.#.  # ## # #
# ## ##    # # .    #
#####################
