############################################
#  #.   .  ........ ..  ## ##.#.##.##.##.#.#
##.#.###.#.#.##.# ##.##.... ..... ....... .#
#.. ##.#.###.#.#.##.#.#.##################.#
## # . .. ...  ....  . ... .. ..... ..  .. #
# ..## #.### ##### #.# #.#.## ### #.###.##.#
## ##.#.#..#  ....#.#..#.# #. =..#.#...# #.#
##.. ....# # ##.#.#.##.  # ## ##.# #.###.# #
#. ####.## ###.## # .  # #..#. ###. . ...#.#
## #.   ..  ...  .#.# #..#.# .#... #.#.# #.#
##  ##.#.# #.####.#..#.#.#. #.####.#. # #= #
#..##.#.# ..#  .#.#.## # #.#...  # #.#.. #.#
##....#..#.#..#.# #.#. #.#.##.####.##.# #. #
#..#.#..#...#.##. #..#.# #  #.  .  ... . #.#
##.#.##. #.##.. # #.#  # ###.############. #
#  .# # ##. . #.#.# .#.# .  .... .. .....#.#
##.#. .... ## ##.#..# ...#.##.## # #.#.#...#
# .#.#.### .......#..# #.# #..#.# ##.# . # #
##...  # #.#.##.##. #. #.#..#.#...# . .#.#.#
#..##### #.##.###.#.##...#.#  ###.###.## #.#
##.. . ... .......... .#.#.##. .. =.. ...#.#
#..# #.#.# #.#########.#.#  # #####.##.# #.#
##  # #.## .... .....#.# #.#. #... . # # #.#
##.#. .....## ### #.# .#.# .# #.#####.#.#  #
#..#.#.#.#.#.##.#.#..#.#.# #.......... . # #
## .## #.# #....# # #..#.#=.#.#####.## ##. #
#..#  .# # .###.#.#..#.#.# # .#.. . #.##.# #
##. ##.##..#    . .###.#.#. # .####......#.#
#..#. ...# #.# ## #.   #.# #. #.  ..#.#.#. #
## ## ###.#.#.# ##.####.#.#.#.######.#.#.#.#
#...  ... ... .....  .    ............ . ..#
##.# ####### ##.##.##.####.####.## #.#####.#
#.. #.. ...# #.#...#.#...#.# .##..# # .... #
##.##.#### # #.###.# .# ##..# ..#.#.#.##.#.#
# ... . .  .. .. ..#.#.. ..##.## .#.#.# #.##
##.# ####.###.#### #.##### #. # #.#. . ....#
#..#......  .  ..#.#.....  ## #.#.# ########
##.#.#.###.#.##.#.. ######... .  .. .... ..#
# .#..##.### # # #.#.....#.#.# #.#.# ###.#.#
## #.#....o.. ...\..# # ##.##.#.#.#..#.#.# #
#o.# # #.#.#.#.###.##.#.#..... ....#.# ..#.#
#### ##o#.##. ## #  ..  .#.#########.###.###
#    . . .o. #.. ..#.## #.%# .   .... .# ..#
############################################
