########################
#    o %  . .   . .  ..#
##o##.# # ## ##.# #.# ##
#               . o    #
## #.## # ## ## #.# # ##
## #.#.## ## ## # #    #
# . =   .  .    . . # ##
##.# #=## ## ## #.#.o  #
## # # ##.   ## # #.# ##
#         ##      .    #
## # # ##  ..# ## #.# ##
#.     ## ## # ##.#.#.##
#.# ## .        ..     #
# # # # # ## # ## #\#.##
#  .   .               #
# # # # # ## #.##.# # ##
# # #.# #=## # ##.# ## #
#  .   .  .     . .    #
# ## ##.# #.##.# ## ## #
# ## ## # #.     .     #
# .    . =  ##.#.## # ##
# ## ## #.# ## # ## # ##
#.     .  =    .  .   .#
########################
