################
# #=# #  . # . #
#o  #  ## #. # #
# ##. #...## ###
#%\.# .##..  . #
# ##. ##..### ##
#   # . #.#. ..#
#o### ### ######
#    == .. ..  #
# ### #### ## ##
# #o. #   #. # #
# ### #.# ##.  #
# = # # #. # ###
##### ### ##o# #
#        .  .  #
################
