#######################################
#.  .. .  #..  # .   ..# # #.# ##.   .#
##.##.#%#  ###.#######.# #.#.. .. ## ##
# # ## #. #  .  .....# # . .##### # # #
# #  . ##.# ## ######  ###.# . ..     #
# ####..# # #   ..  .#  .#..# # # #.###
#   .#.#. #. # #######.#.# #o# ##=#   #
# # # .##.###. #  . . .# # #.  .  # ###
# # ##. #.   #..# #.##. ## # #### # # #
# #  # # =#### # #.# # # . # #  # # . #
# # #..##    ...   . # ###.## # # #####
#.# ##  # ## # #.##.# .. .   . ...   .#
# #  # #. #   #=# ## #.###### ##.##.###
# #.#   #  #.#  # .  #.#...  #.# #. # #
# ##.# ## # ..#= # #.# .####.# #.###  #
#      .  ##.#  # #. # #   # #.#. ..# #
## ######  #.## #.## # ##.#  #.  # # .#
##. ... # #  ..   .  #  # .#  ## #..# #
#  #####. o# ########  # .## ## # ### #
##  .  .#.#  # .     # ##.#  ..     o #
#  ### #. .# #.######   #. # #.# ###.##
## #.# ##.#. #o .... #.#  ## .## # ## #
# .   . #  #.# # ####   #=#. #.=  .   #
##.## ##..##.# # # ..# ##. #..##.##.###
#  #   .#\#= # ## #.# .# .## #   #..# #
##  # #.#..# .    .. #  # #   ##. #  .#
# ##.# ## # ########## ##.## ## ## ####
#.        . .. .        .      . .   .#
#######.###### # #.#.## # ## #### ###.#
#    .#  ..  # ##.#  # # ## #    ## #.#
# ##### # ###.  . .# # .    #.## .... #
#.   .  #   .#.## #.. #.###.#   ###.# #
####.##.#.##.#.# # #.# ## # ##### ###.#
#  # # .# # ##.   .#.#        ..      #
#.##  #.#.#.   ####  # # #.# #.## ### #
# =. #  #.#.## .  .#..# #.#.# # ###.# #
##.# ##.# .# # #####.#      .. .      #
#. # .# # #    #     .##.# # # ##.# # #
#######################################
