##################################################
##  # #.. #=# ## # . # .   .  # ..#.# . .  # # # #
#  #  .#.#   .   # # # #.# ## #.#.# .#.## ##.    #
##  #.## ## #####.#   # # # # # # # # # #.#  # #.#
#  ##            ..# #    .   .=#.#...  #..# ## ##
## #  ###### ######  .###### ## ##. ####  # .    #
##  # #.   #=#  .  # #     .# #   # .   #  #.# ###
# .# .# ####.####.# .#### ## .# #.# ## #  #..#   #
##  # #.  .....  . # .o..   # #  ## #.# #.## # ###
#  ## #############  # ### #  # #      .#..# ### #
##    .   .    .   #  ## ## #.#.### ####..# .   .#
## # # ###### ## # #o#   .  .          .#.## #####
#  # # # .   # # #.#. ## # ## ### # ##.#    .    #
##  # # #### # ###.# # ## # #=#  #. #. ## ########
# .#    .  .       #  ..# # . ##.##  #  #   . .  #
## #.# ## # ## # #.# ## #  ##     #.#. ##.########
##  # #.## ## # #. # #  #.#.  ###.#  # #  #    . #
#  #  ....  . .  #.#.#### ##### ###.# # # ######.#
##.# ## # ## # ## .#.    .                   ..  #
##.## # ## ## # ## # ## ## # # ## # # ## # # # ###
#     .. .    . .    # ##.# # ## #.# ##.# # # ##.#
### ## ## ####### ##.  ..        .    ..     ..  #
#  #. # #.#  ..  ##  # # # #.#.# ##### #####.##.##
## # ## # # ##.#   #  #.# #  ## #     #... # #.. #
# .# # .# # #..# # # #o... # .  # #### # ## .#####
##.#.## ## # ### ##  # ####  # #  #  # #. .# .   #
#..    .        .  # #. .. # #. # ## #   ##  #####
# #.##.## ##.# ### # # ## #. ###   # # # # #     #
## # # # #  # # .# #.#.#\.##.  .#.#   ## # # ### #
#  #. #.  # # # #  # #  #. # ##.#  # # . # # # #.#
##   # # #  # # ##.# # # ##. # #  ## ###...#.#  .#
#  ### # ## #  . # # #    .#..  # #      ###.# #.#
##.    ... . .### .# #.# ### ##.# # # ## #   # # #
# .### #######   # # # # #   #  # #.#  # ###.# #.#
## # # #. .    # # # # ## ## ###  #.#.#  . # # # #
##.# ## ###### ##  # #   ..     #o# .# #.##. # #.#
#.    .   ...  . # #  ## # #.# #..# #      # # # #
# ############### .#.##.#.#.# # #.## ### ##.# # ##
#      ...       #  .     . .  .   % .  .        #
#.### # # # #.###..#.# ## # # # ## # ### #########
# # ##.# #.#.## ## ##.#.##.# # ## # #.  #     .  #
#   .       .....        . .     .#  ## # ###### #
#### ######### ##.# ### ## # # # ## #   #.     # #
# ..#   . . .  # # ##.# # #.#..# #  # # #.#.##.# #
### # ######## #      # .    # #  #. ## #. # # # #
#.  # #  .   #.# ## # #.# ## # #.# .# ..#.#    # #
### ### ##### #.# ###.## # ### #..# # # ## #####.#
#           .  .    .     ..  .# ## ###..      . #
## # # # #.#.# # #.# ## ##.#.# #.. .    # #.## # #
##################################################
