##################################
#.## # # ...#.   # #..# # # #%# .#
# ..  .#.##.# ## ..#.#. .   . #.##
###### #. .#. # ## #..##.#.##.  .#
#... .=# ##.# #..# # # ...#.# ####
####.#o# #  #.. #..#.##### .#  ..#
#. #.#.#..# # #. #.#. ... #.# ####
# #..#.#.#  # # ## #.#####  . ...#
# .#.# #  # # ...  ......#.#######
#.## #.# #..# ##.##.#.####.# .  .#
# #. # #  #.#..#.# # # . ..### #.#
#.## # # ##.# #=# .#o#####..  .# #
#... #.#    # o. # .. .. #.###.# #
#.##.#.# #.# .##.#.#.####. .... .#
#..#.#.#.#. # . #  # ..  # ## # ##
# # .#.#.# #  ##.# ######..# #.#.#
#. #.# #o#..#  .. . ..   # .. ...#
### ## # #### ############.###.###
#. .. ..  ....\   . ...  ..#..#..#
######.# ##.##.#.##.# #.#### #  ##
#.. . .## .#.#.# ###.# .#.   .#.##
#.#### . # #.###..##.##.####.##  #
#   .#.## .....  #......  .# . .##
#.# #..# ##.## ##.##########.#.# #
###  #.. ## .....  .. . .=....#..#
# . ## #..  ## # #.# ## #.#.#.#.##
#.#.#...### # #.# #.# ## .# # # ##
# # .#.#. #   #.#.#. .. ### # # .#
# #.#  # #..###.#.#.### #.  #.# ##
#.#  #.#..#  .. = #.#.# .#.#. .  #
# # #. #.#. #######=# ### #.# ####
### .#    #.  ......  . . .....  #
#   #  # # .#.##.#.##.#.##.##.#.##
##################################
