##################################
#. . #.#   .. .. #. # .. .  . #. #
#### # ####### # ## ### # # #=# ##
#     ....       ..   # #.### # .#
## # ###### ##.#.##.##  . .. .# ##
#. #      #  #.# # .  # #### ## .#
##.  ###.# # .    # ##. #. ..#  ##
#  # #. #. # #.#.# .  #  #.#  # ##
## #o##o.#.#.# .  #.##..# .# #.. #
# # # # ## #.###.##.#.# ### #.# ##
#..     .. . . .  ...    . ..   .#
############### ### ### ##.##.##.#
#.  ...       . #.#.# #.#.# =#  .#
#.####.###.## # . ..# #.#. # ## ##
###..  #.   =.#=### ... # #. .   #
#   ##.## ##.#  #.# #.# #..# #####
# # # ... .   #.# .=##..# # .    #
#.# ## ### # #  ###.  # # ## ##.##
#..   .#   #. # . # #..  o  ..   #
###### # #.# #  # #..%#.# # #.## #
#. .  ...  # .# # # #.#.  .#.# ..#
#.##.## #.#=##  . # # #.# ## #.###
#  #= .   .   #.#  .#.# # .   o. #
#.##.#.#.#####  # # # # # ##.#.# #
#.#. #.#.  . .#.# . # #.#.# # ## #
#..# # # #### #  ##.#.# ...... . #
# ## # #   .# # # #.# # ##\## ####
# # .#  .##.# # #.  . #.# . #.#..#
#. #.#.#.#  #.#..## #  .## #.  # #
# #. #.# ##...#.#...# #  ## #### #
#  # . # . .# # ### #.#.#     .  #
#.#.# # #### ##.  #.  .   # #.####
#.        .  .  # .#.# ## .      #
##################################
