#####################################################################################
#    #..# # ... . .# #   . ...     .  .# .#. # #..    .. #. #.## .#  #  #.#.#. #.#..#
#.# #  ##.#####.### .# # ##.# ##.#.# #.# #  ##.# ####### # ##   #. #.#.#  # ..# .##.#
# #.##  .   .    ..# ##.##  #.# # ##.#.#. # #..# ..... #.#. . #.# #  . ## ###.##    #
#.#. # #############  . ..# #.#.# #..# # #.. #. ######## #### ##.. # # .#      # ## #
### ##.#  ... . .. . ##.##  #.#....#.# #  #.#. #.  . .. .  .# ..# #  # ## ##.## ..#.#
# ...  # ###.# # ###.# .#.# # # # #..#.#.## ##  # ## #.# ##.# ##o.###  # .# ##.#.# .#
## # #.# #  # # #. #  # # #.# # #  # #.#..... .##.# #.#..# .#   #    #.## .  ..#. # #
# # ## # .# #.# ##.# #  # #.#.#.### .#  ##.#.# #    .. #  # # # # ##.#  #.###.#. #..#
#. .. .#.## # #    #. # # # #. .  .#.# ##.#  #  ######## # ##..## #.##.##.# ##.#.####
##.# #.#..  #.# ####.#..#.# #.# #.## #.#. .# # #     ... .....#  .     . . .   #....#
#..#.#.#.#.#. #. o.   ### ## # #.## ##.## # ##  ####.## # #.#.# # ### ## ### ##  ####
####.# #.# .#.# ####.#..    ...  . .       .   ##  # ..#.#.#. #.# #.##.# #  #  # #  #
#..  #.# #.## # # .#.## ## # ######## ### # ## #. #..# # . .# # # #    . # ## #. .# #
####=# # # #. #.#.# . #. # #.#  = .  .# . #.#. ##. #.# # ### .# #. #####....  .# ##.#
# . .# # #  # # . .#.##.# .#  ## # ##.# #.#  #. #.#  ### # ## #.# #  ..  ####### .  #
# ## # # #.# .#####..# ..#.#.#  .## # #.#.# #..#.. #.. ... .#.# #.# # ##.#  .  . ####
#. #.# # #. #.  . .#.## ##.#.###.   #.# # #  #  #.##.#.#####  #.#.# # #  #######.   #
# #. # #.#.#. #####   #.#..#  .#.## #. #.#.### # ... #.#  . #.#.# # #.##.. .. .# #.##
##.# #.#.#  #   . .# #  ## # #.#.# # .#  ... ..# ### # #.###  # # # #..#.## ## #.#. #
#   .#.#.# #..### #...#..#.#.#.#.  .#. #.# #.#. #. # # #   .#=#.# # # #  # # . # #.##
## #.#.#.##=# # ## # #.##.# # # #### ## # # ##.## #.# ##.####.### ##.# ### #####.## #
#  # # #  . .  .  .#.. .   ..  ....  .. .   .    .     . ..   ..     .. .. ...  .  .#
##.#.#.# # ######.#  ######.## ## ##.#.###.# #### ## #.## #### ##.####.# ### ##.## ##
##.# #.# # #.  . . #.#.. . #.=#.# #  #.# .##.#.. #. #.# #.#  =# #.#... # ...#..# .# #
#. # # # # # # ##.#.  ### ##.#  # ## #.#.#.  .# ##.#  # # # ### #.#####.####. ## # .#
### ##.##.# # #.##.# # . .#.. #..# ## ## ### #.  .  # # # #.  . #      .  . #.#.  #.#
#   .. ...     . ..   ###.##.#  #   . .. .   ## ## #  #=# .##.# # #.### # ##. ## ## #
###### #.###.#.#####.#  .  #..#. # #.#### ##...# # .#.# #.#..#  # #.#.#. #. #  # #. #
# .   #.#   ## .  .# #.##.# .#  #.# ##.  # # ### # #  #.#..# ##.#.### ###  ##.## ## #
##.##.# ###.#  ####. .#.# ## ## # # . .# # #..   ...#.# # #   # #  .  . .# #. .  . .#
#.# # # . #  #.#  ##.#       .  # ## # # # #.# #=###. # #  # ## #.########.## ##.## #
#.# # # ##  ## .# .#. ##.## #.#.# .#.#.# # #.# ##. ## #.# #..  .# #..  .   ... #.#.##
# #.#.#  ## # ###.## ##.# ## # .#.## # # # # #. .#  # # # .# ## #  # # #.#.## # = ..#
#.. # #.#.  . . . .  #  = ... #%# #..# #.#.#.##### #. # #.#.. #.# #.# # # #.#  # #.##
### # # ############..###.####. # #### ### #. . .. .# # #. # #  # # .  .  .. .#  #  #
# . .        .  ..  .#  # #  .#.#.    ..     ##.#.##  #.# #=# # #.####.# # ##  # #.##
# ## ##.# # ######## ##.# ## # . ##.### # ##.# # ## #.# #.#     #...  #.# # # #  #. #
##.# #.# #.##..   .# .        #.#  ## ##.# # #  .#... # #. # ##.# ##### . . #. # # ##
# .#.# .   #  ## ## .########## # #...    .# # # #### # #.#  .#.# #   . # #.# #..#  #
##.# #.#.#. # #... # #..  ..    #.###.#####..#.#.  .# # #. # #. #.## ## ## #.. #.#.##
#..#  # ## ##.######. ##.# #.## # . #  .   # .## #### # # #   # #   # #.  ..#.#. #  #
##.# #. . ...    .   #..#.# # # # ##  ### #. #  =.  . #.#. # ## #.### # #### . #.# ##
# .#.# # # ## ## ###..#.#  . .# #.# # # ##.#  ###.# # #.#.##.#  #.# ..    . # # =##.#
##.#.##.# # ##.###=# # .. #.##  #...  .    # # .# #.#.# # # ..# #..##.# ##.#   #  . #
## #  ..  ...  .   # .###.###.#.# ######### ## # # ##.#.# .# #..# # ###.# # # #  #.##
#. # ########### ##  #. . . .  . .  .   . .        .  . #.#. .#.#. ...  ....#. # #  #
## #.#..   .   .#..#..## #########.### #####.## #####.#.#. #.#..#.#### ###### #  #.##
#  # # ## ###.#. #.#.# # #   .  .   .#.# .  # #   ..# #.# # # # #.# .=.#.   .. # #  #
## #  #.### ###.## # # ##.###########.# ### # ###### ##.# .  . .# #.##..## ##.#  # ##
##=#.#...  .        . . ..     . . ...  .  .   . .    ..#.# # ##. # .# # .# # .# # ##
#..#..# # ### # #.##.#### ##### ###.# # ##.######.#### ##..## # # ### # # # #.# #.# #
##.# # #.#. #..# #.# #  =.# ...#   # # #.# . .  #.#.. #.  #    .#..... .  .   .   . #
## #.#.# # #..#. #.# =# # .# ##. #.# # # # ##########..##  ## # #.## ####.## ## #####
# .#.# #.# .# ## # # #.##.#    # ##  # #.#.    .#.#   # # # . # # #      # #.#.#.. .#
##.#.# # # #   .   # #     # ###...# # # #.## #.#. ##.#. ..## # #. # # #.# # #.# ####
#  #.# # #..# # #.##  #.# #. #.  # #.# # # #.## #.#... ## # # # # # #.#.## #.#  .  =#
##.# # # #.# .# #.#  #.#..## ### # #.# # #.#   .# .## #.#.#.# ##  #..   .. #.#.##.###
#..# #.#. .## .##. #  ..#      # ###.#.# #  # # #.#  . .#.#.# ..# .# #.### # #..#   #
## # #.### .# # . #  ## # # ### . . .# # #.#.#..#.### ##  # #.##  # # ## # #.#.##.# #
#  # #..   # .#.#  # # # .# #  # #####.# # #. #.#. .# # #.# # .## #.    ...#.# #. #.#
##.# .##.#..#  #.###  ..# # # #  #..=  # # #.# #  ### #   #.  # ...# ##.##.# # ##.###
#  # #. ##.#  #  .   ###  #.#  #. ## #.#.# .... #.# .. ##.#.# ###.# ## #.# # #  #.. #
##.#. # #   # ## ###  ..#.# # #..# .#. #.# #.### ..## #.# .##.  # #. .   # ###.#.####
## # #   # # . #.# # ##.# #    #.##..# #.#.#.   # # #.#.#.#   # # ###### #  =..    .#
#  # ## #   #.#. # # # # .# ####. # ## # #.# #.#.o#. . . . ## # #..   .. #.#### ##.##
## #  .  #=#  .# # # .  #.#.#   .#   ..#.#.#..# #  #.##.# # ## ##.########.# .# #  .#
#..#.#####.#### ## # # #. #..### #####.# # # #. # ## #  #.# .  ...#. .   ..# #  .# ##
## # # . ..   . . ...##.# # # .#... .#.#.#.#.## # #\. #.# # ## ## # ## ### #  ####. #
## # .##.## # # ##.#.  .#.# # #. #.##. # # #   .# ##.#  # # # # # .#.### # #.# .  .##
# =# # #.# # # ##.#  ## #.### ##.## ##.# ##.####.. #.## #.# #. .. # ....  .#.# # # ##
## #   #     .    .#.# #. .  .  ... .     ..  ..# #  .#.# # ##.## #.## # # # =# #. .#
#. # ## .####### # #  . # ### ## #.# # #.## ##.#  .# #. #.#  # #.. ##.# ## # #...#.##
##.# # # . ..   #.## ## # #.#.# #.##  ## #. .#.## #. .# # #.# ..#.#   #.   #..# #. .#
##.#   # # # #.# .# . ### # # #=#.   #   ####.#.#. ###.## #.## ##. ## #### # # .=# ##
#  # ##.# # # #o#.## #  . # # # # ## #.#..  .   # #. .. ..#..#.#. #  ..  # # .#.##  #
## # #  . ...        #.## # #.# ## #  ## ## ##.# .####### ### # ## ## #### #.## #.###
##.#. ##.# # ##.## #..#.# # # #   .# # ..# #. . # . .   #  .==....   .  ....  . .   #
#  #.# ##.# ##..# # .#.  .#.###.#### .##.# ###.#  # # ## .# ## ## ## ##.#.## #.####.#
## #.#.. . .. #    #. ###.#      . ..#  .#     ## .## ..#.# # ## # #. # #. # ## . # #
## # #.###### #.###. #. ..## #######. ##. #####.# #  .# # # # ..  .#.# .#.#.  # ##  #
#... # # . .  # #. #  #.#. # #. . .  ###.#.  .    .## #=# .## ######.##.##.####.#.###
###### #######.## ##.#.# ## # #######.#.# #######.#.  #=#.# . .    ...# .  . . .  . #
#. . .  .  . .   ...    ..  .. .  .  .. ..     .  .##.# #..# #.## ## #..#.#.# # # #.#
#####################################################################################
