######################################################
##.##.#=# #.#.#.##.#... #. ..# #  .. ....   ....# #  #
# .... .... ..   .   ## ## #..   ##.# # ##.#.#.#. ..##
# ##.## ###.#.## # # .#=...# #.#..# # # #.##   ..##..#
# #.o  .. . .# #.#.#.# .##.# #.# #.... .... .#.#  ..##
#.#.#.##.##.#.......  #....#... .##.# ##.### #.####.##
#. ... # ##..# # #.#.#= ## . #.#... ....... ... . . .#
###.#.#. .  # # ## .. # ##.#.#.##.#.###.# ##.# ####.##
# ..#  #=## ..  . .#.#... ..... #.# # # # ## #.#..#..#
#.# #.##. #.##### ##..#o## #.##. . ....#..   =..# # ##
#... ....# .#.  ...  # .#  ##.# ## ### .#.##.#.## #..#
#.#.## #  #...# ##.#.## ## ...  .  # . #.. ... # .  ##
#.###.##.##.# ..   ... ..# ####.##...# #.# #.##.## #.#
# . ...... .##.#.#.#.##.#... . .#  #.#.. ........ .. #
## # ##.# ## .... ...##  .#.#.# .#.#.  #### ####.##.##
## #   .#. #.###.###.. .##.# # .#. ###    ...= .. . .#
# .  ## #.# . .# . . ##.. .. .#..#...#=##o#.# #.### ##
##.#..  # .#.# # #.#..# #.##.# .#..# ...# # # ......##
## # #.##.##.#.#.# #.#... .#.##. #...# #.  .###.#.# .#
#.. . ... . =. .#  ...#.# #. .# #. ##. .# #. . .# # ##
##.#### #######= #.#.# .#.#.#.  ##.# # #   .#.# ..# .#
#.......... ....#  #..#.. . ..#..# ..#. # #..##.#...##
######.###### #.##   # .###=# ..# .#.. #..  #  .. #.##
# .  ......    ....#..#.  ... # ##  .#. #.#.#.# # #..#
#.##.##.###.###.##.#.#. # ## #.. #.#.#.# .#.  ..# . ##
# .#. #. .  .... #.#..#.......# #. #.#  #.#.###.#.#.##
#.#. #..#.#.# ##.# #.#..##.##.#..# # # ## # #.#.# ...#
#. # .#...##.#...#.#.##. #.#.##.#  #.. # .... ....#.##
#.#  # .#... ..#. . .  .#  .  . ##.  # .#.#.# #.### ##
#.##. #  .#.##.#.#.#.##.##.#.##  # #  .#..#...#.#  . #
#..#%##.#. . .  .#.#. #.     .# #. #.#. # # # #.#.# ##
#.#. #..#.# #.## #.#.# .####.#.. #.#  .##. .. ...#..##
##.### # #.# ##.##.#..#.#.  ..# ##. .#....#.#.#.###..#
#. .........  .... ..##..# # #....=##. ##...# # .## ##
## # #.###.#.#.## ##.#  # ....#.##..##..#.#. .#.#... #
# . # #. .... ..#. # ##.#### # ..#.# ..##.#.###.#.#.##
## #....## #.#.#. #  ..   . ..# ##...# #..# .. ..... #
#.. # #.#  #.  .# .# ## ##### #.#.##.# ## ###.## ## ##
## #..#..#.# #.## #. .. ...  . ..  . .  .... .. . ...#
#...# #.##.# # # .#.## #.# ##.#.#.#.# ##### ###### ###
##.# ...... .. ##.# #.#=##...## #.#  .... .... ... . #
#.. .### ###.#....#   .   .#...  .  ## ###### # #.## #
##.# #.#.   .# ##o# ## ###.####.### ##.. ...... #.#. #
# .. . #.###.#.# ...#.... ..    ... .  #.##.##.#  ## #
##.# #... ...#..# # . #### ####.#.# #.#.# ##.## ##.#.#
#. #...#.# # . #  . #.. . .    #  # . . .=... .......#
####.#.# ## # ##.##.### #.## #.#.# .#.## #.#.# ##.#.##
#. ...  . ... . ... .  ... .   ...#..# #.##.#.# #.#.##
###.#.# # ## ## ##.#.###.#.#.#.#.#..#..  . ..... ....#
#.... #.## #.#...#...#.#.#... #. ##.  ####.#.#########
# #.#.#.     # #.#.#.#.#.##.#.## .= #..   .#. ..  ...#
#. .#. #.###.# # ..  ..#  .  . #.##...#### # # ## ##.#
#.#   #....\.... # ## #..## ##.# #..#... ..     ..  .#
######################################################
