############################
## =#        #   # . =# .  #
#  #  # #.# #. #   ##.  ## #
##.  ###  .# #  # ##  #.#. #
#% ####.## #  ## #   ###  ##
## # # .# . .#   .#.### #. #
# #  #.###.# .# #. ###  ## #
# ##   .# ###.. ##  # .# # #
#  # ##    # .#  # # .##   #
## ..# .#.#  # #. #  #. #.##
# #.#..# .. ##  #   #. # . #
#..#  # # ## .#  ## . #.##.#
## =.#   ### ###    #  .o# #
#.##.  #  # . #  # #  #.#. #
#. # #..#  ## . #o # #    ##
# # #.#..# .## # ##  # # # #
#  .   #  #   #. .# # #    #
#o#=# # #  # #  #. #.  #.# #
# .# #  .#  #  # #. ##..#  #
# #  .#.# =#. #   #  ## #\##
#   ## . .##.#  ## #  #    #
## ##. # #  #..#  .##  # #.#
## . ##. .#. # .##   #    ##
# # # . #   # #..#.# .#.#  #
# #   #### ##. # o. #..#  ##
#  # #= # . ..# # #.##  .#.#
##.   #.. # #.  #. #   #   #
############################
