##########
## #o # ##
#. o# .o%#
## ##.## #
#. .... ##
# ### ##.#
#\# #.= =#
#.. #.# ##
#=#o.#=  #
##########
