########################################################################################
#.# ...#.......#..# #.#........#.#.##... .......#....#.##.........#.....##..##...#. #.##
#..##.##.##.#.#..# .....##.#.#.......##.# #.##.#..##......##.##.#. .###...#.. #.###.. .#
##.. .....#.#..#..#.#.#........#.#.#. .  ...... #.##.# ##.##..# # #.#..##...# ..##.##.##
#..## # ### #.#.#.. #.#.# #.##.# ....#.#.#.#.#.#.............#....#...#.#.#...# .... ..#
##.#...#........#.##. ..#.##.#.##.##.. ##.# .#.# ###.##.#.##..# #..## ...#.#.##.#####.##
##..#.# .#.# # #..#.#.#......#... ...#.....#. .. # # #...#.## ...#.#.###.  ....... .#.##
#..#.. #.. ... .#.......# ##.#.#.#.##.#.#.##.#.#. . ..##....##.#........####.#.#.##  ..#
##..#.##.#.#.# # #.#.##.# .....#. #... .......#.##.##...### .  ..#.#.##.#... ..#...#.# #
#..#  ...#.....#.#.#..#..#.#.#..#.#.#.#.#.###  ......#.#....#.##... ..#.#.##.#..#.#....#
#.#..#.#.#.#.#. .....#..##.#...##.....#.....#.# ##.#..#..##.#. ..#.#.#.........#..#.##.#
#.#.#.#...#.. .#.#.#..#.#. .##.#..### .#.## .....#.###..#....#.#.. #.#.##.#.#.#.#.....##
#.......#..#.##....#.#...#.#.....#...#.####.## ###  . .#.#.#.....#.....#..........##.# #
#.#.#.#.##.##.# ##....#.#..# ### #.#.....#..#..#...##.#. ..#.#.#..##.#..# ##.#.##......#
#.#...........%....##....# ....#.#. .###.##...#..#. .##.##. .#. .#.##.#..  ...## #.#.#.#
##.#.#.#.##.###.##. .#.#.#.##.# .. #=.....#.#..#.. #.  ....#..##.  ...=.#.### ........ #
#..#...#.#. .......#...# #.....##.#..##.#....###\#...#.# #...#.#.##.#.#.#.#.##.#.#.##.##
##...# #...## ##.# # # ...#.##...#..#...# # #......#.. #..##.........#......... ##.#.#.#
# .#... ##...##..... ..#.#. #..#.#.#.##.#...#.##.#. #.#. #.#.####.##...##.#.#.##.......#
##..#.#...##....#.#.## ..##.#.##........# #.. .#.##.....#.. #........#.#.# #.... ##.##.#
#..##.#.#.##.##.#..#. .##.#.. ...#.# ##. ...#.#.....##.##.#...#.#.#.##..... .##.#...#.##
##......#.....# #.#..####...#.## # #.#..#.#.#..## #. . #.. .#.#.#...#..#.#.#.#..###. ..#
##.#.#.#..#.#.. #.##.# #..#.#.##......#...# ..## #.#.#...#.##...#.#.##.#.#....#....###.#
#..# ..##.#...#.#. ..#.##.##..o..#.##.# #. .#......##.##.##...###..........#.##.##... .#
#.# .#. ....#.#..#.#. .......#.###.## ##..#.#.#.##. ......#.#....#.#.#.#.#......#.#.##.#
#.#.# .#.## .##.#. #.##.#.#.#.... ...#. .#......##.# ##.#.....##.#.#.......#.#.#..... ##
#....# ##.. #...## #.#.#...  ##.#.#.#..##.# #.## .....  ..###.#.##  .# #.#.#.##..##.#..#
# #.#.....#.#.#...##.... #.#. #.......#. ........##.##.##. ....... #.... .......# . # ##
#.#..#.## #.....#...#.##.#.###  #.# #. .#.#.####.......## #.##.#.#.###.#.#.##.#.#.#. ..#
#.#.#.... ..#.#.#.#....... ....##.# #.#. .#.#....#.#.#. .#...#.. ....... .  #......##.##
# ...#.##.##.#..#.##.###.#.##.#. ...#.#.##....#.#..#.# #..#.##.## #.#.#.#.#.. ##.##.# .#
#.#.# .# . ...#...........# ..#.#.#.# #..#.#.#. .#.... ..#........# #...# #.#.......#.##
#.#.#.#.#.###...##.#.##.##..###...#.....#..###.#...# #.#.###.#.#.#..#.##......#.#.# . ##
#...........#.#. ....#.## .#....#..#.#.#.#.......#..#. .. ...#..#.#......#.#.#.o....#..#
###.#.##.##..##.##.#......##.##.#.# .. #.#.###.##.#...#.#.##..# ...#.##.## #. #.###..#.#
# ..#..#.#.#. .. ..#.##.##....#.#.#.###.. . .#.#....#.#.##.#.# ####.#.#.#...#......#.#.#
# ##. # . ..# #.###....##..###.... .... #.###...#.#... ............. .. #.#.##.##.#..#.#
#....#..#.#..#......##. ..#...#.###.##.#.....#.#....##.#.##.#.#.#.##.##...#..#.##.##...#
### #.#..##.# .##.#...#.#.##.##.... .##.###.#...#.#  ..##.# #### . #.##.#.#.#...... ##.#
# ## .# #....#. ..#.#.....  ....##.#..... ...#.#.#.#.##... ...### #.......#.. ##.##...##
# ...##.##.#..# #. ...##.###.##.#..#.##.#.##.........#..#.#.#..#..##.#.##..#.#. . #.#..#
#.## .. ...##.#..##.# ......... .#. ..#.#.# .#.##.#.#.#   ..#.#..#. .#...#.....##.....##
#....##.#.#  .# ##..###.#.#######.#.#.#.#.###.. . ....#.##.# .##.. #.#.# ..## #...#.#..#
##.#.##.## ##. #..#...#.#........ .# .#.#...#.#.#.##.#..#..##...###..#..##.#..# # ...# #
#..#.... .....#..#..#.#..## #.####..#.# # #.# #.#.# ..#..#. #.#....#..#.. ..#.#...#.## #
##...#.#.# #.#.#..#....#.#..#.#....#..#.#.... #.#.#.#.# #..#..#.##...###.####...#.#....#
#..#.##.##.....  #.#.### .#....#.##.#.#.##.##.##..#.#...##.##. . ..#.##..... .#... .# ##
##.........#.##.#.... ...# .##........#..#.. ...#.#.. #... ..##.#.#....#.#.#.#..#.#. ..#
#.#.##.##.#...#.#.####.# .#.#..#.###.# #..# #.#... .#.## #.#.......#.#o  .##. #.#.##.#.#
#.... . #.#### .. .. . . #...#..#....#.### #.##.#.#........#.#.#.#.....##....#....... .#
#.#.##.#.......##.#.#.##..#.#..##.##... ...........#.#.###...#.###.#.#....#.#.#.##.#.###
#.......#.# ##.# #.##.. .## .#. ....#.##.##.#.# ##.#.... . #.  .....#. ##.#.... ..... .#
#.#.##.#.....#.#......##.# .##.##.#.#.......#.#... ..##.#.#####.###.##.#....##.##.#.#.##
#.#...#..#.#...# #.#.#...## ....#....## #.#.....#.##.......#..#.........#.#......#.  ###
# ..#. # #.#.#.###.#. .#....##.##.## .. #.#.#.#..#.##.# #.##.#..#.#.#.#.#.#.## #...#..##
#.##.#.......#. .....#.#.#.##.#.. ..# #.....#...#...  ..# #...#.# #.#.#......#.#.## .#.#
#....#.#.###..#.#.##.....#.. ..#.##.## #.##. ##..# #.##.. #.#...... ....#.#.#.......## #
##.#.. #.....#..#...##.## ###.#.#.#.. . .###.. #.. .. #.# #..#.#.#.##.#. ....#.#.###...#
# ##.#. .#.#..#...#.#.....# ..#.. . #.##..#.#.#.##.##.#.#...#..#...#....## # #... . .# #
#......#...#.#.##.# ..#.#...#...#.# ..# #.... ...#.#..#.#.#...####.##.#.#....# #.##.#.##
###.##.###. ....#...#.#...#...#.#. .# ..#.#.#.##....###.# #.##.#.... #..#.##.... #..  .#
#....... ..# ##. .#.#.##.#..#.. ###.#.#...#.# ..#.#. ....... .. #.##...#..## #.#.##.##.#
##.###.###.##...# ....  ..#...#.... ....# ....#.. #.#.# ##.#.##..#.. #.#.#....... .. .##
# .#.. ..#....##.#.##.##.##.#..##.###.###.##.##.#. ... .#. . . .#..#...=#..###.###.###.#
##..#.## ##.#.... ....##.#....#.......# . ......##.# ##.#.##.##.##.#.##..#........#....#
##.#.. ....#..##.#.##....# ##.# ###.#.#.###.###.... . .....#.. . ##.#.# #..##.#.#..#.#.#
#.. .##.##...#.#......##...#..#.#... ... .#.. ..##.# #.##.# ##.#...  ...#.#. . .##   . #
##.#...#...##...##.##.. #.#.#.#. .#.###.#.##.##.....#..#.......#.###.##... .#.##.###.#.#
##.#.#.. #.#..#.. #.#.#.##. ...##........... ...# #.##.. ###.#. ...#.#..#.#............#
#......# #...# ##.....#...#.#.#...#.##.#.##.# #...# ..#.#. . #.#.#... #...## #.##.##.# #
## #.#.#.#.#..... #.#...# .. .#.#..# ..#.#. ...##.. # ##.##.#.#. #.##.#.#. ........#..##
#. #.=.#.#. #.#.# . #.##..#.#.....#..#....# ##...###... . #.#...# .. .....#.##.#.####..#
#.# .##....# .....##.....#.#.##.##.#.#.##.#.#..#.#..#.#.#... .#.#.###.#.#....##....#..##
##.#....### #.# ##...#.##..... .. ... ......#.##.#.#..#..##.#. .......#.  ##. ..##...# #
#...#.#. ....... # #.#..#.##.##.#.#.###.#.# ..#.....#.##....#.#.##.##.#.###..##..#.#.#.#
#.###.#.##.#.##.#. ...#...#.#..........#.#..##.#.###....#.#. .#.. ..#.#. ..#.. .##.....#
#.....#.. .. ..#.#.#### #. ...#.## #.#....#.. ... .. #.#.#.#.#..# #.#.##.#.#.#.#...# #.#
# #.#.# # #.##.. . .... ..##.# ....  #.##..#.##.#.#.##.........# ##.#..#.= #.#   #.#.# #
#.....#  .. ...##.###.##.#.#.#.#.#.#.#.##.#.#.##.#.....#.#.### #....#.##.#.#...#.#. ...#
###.#...##.####.#..... #.. . ......#.#..........  #.##.#..#.....#.#......# ..#.... ## ##
#.##.##..... .....##.#..###.##.#.#...#.#.# #.##.#...... .#.##.#..##.# ##...#...#.#.. ..#
#.... ..##.# ##.# #...# ... ....#.##.#...#. #... .##.#.#....#..#. .##.. .#.#.# #...#.#.#
##.##.#. .. ## #....#..# # #.## . .#.#.#..#...#.# .#.#...#.#..##.#....# #..# ..#.#..#..#
#...#.#.#.#......#.#.##.#.#.....## .....#.#.# ..##.#..##...##.#..#.##.....#.#.#.. #..#.#
##.#....#..#.# # # #.#.....##.#.##.#.##.....#.#....#.#.  #.....#..... #.#.....##.#..##.#
##.#.##.##.....##..o. .#.#.....#..... #.# #.#.#.#.#. .#.#.##.#...#.#.#.#.#.#.#.#.##. ..#
#..#.......##.#...#.##.#...# #...#.#.# ...#... ... .#.#........#.....  ..#...#..... #.##
########################################################################################
