###########################################################################
#    ...  . . ..  .......  ... .  .  . ..... ....  =   . .##.#.# #=## # #.#
## #.#.#.#.######.####.## # ######.#.#.## ####.### ######  .  . ... .    .#
##.# #...  ... ... ..   ...o...  ..# # # ....   ... ... #.## # ## ## ### ##
# .   .# # ###### ##.#.#.#### #o## #.#.#.####.#### ## #.. . # #.#.  .     #
## #.#     . . .# . .#  .....##..#   #.#..  .   ..    ..# #  ...  ## # # ##
#. ## ## ##.# ## .##.#.# # #.   # .#.#.#.### #####.##.#... ## #.#..# .  ..#
##..  .  # #.## #.#  ##.# ## ##  # #.  .. ..... . ..# ..#.# ### # ##.###.##
##.#.###....   .  .#..   .... . #. #.##.##.# # #.# #.###.  .   ..... .. . #
# .... # #.#.#### # .# #.#.## #.##.#.#.##.## #.#    . ..# #.##.###.# ###.##
##.#.# #.# #.   # ##.# #.#.#.## .#. .......   ...#.# #.#....  .   . ..   .#
##. .  #.#.#.##.. . .#.# #..  . # .###### ####.#.. . ...# ##### #.#.#####.#
#  # #.# . .....#.## .... #####..#   . ... .  ...#.# # #  #.. # .#..  .. .#
## ## # .## ###...#  #.#.#.. ...#..#.#.##o#.#.# #..  .. #.## ##.#. # ##.###
#  ... #.#.##.#.# ##.  # ####.#.## #.# ... .## #.# # ##.# .  #.. #  # #.# #
##.# ##= . ..   . .# #.  . ..   ....   ## #.   .  .  .  # ## ##.#. #..#.# #
#. #.#.#.#.##.#.# ##.# #.##.#.#.##.#.#.#  .#.#.# # #.##   #.  # .#..#.# ..#
##.#...   . .#. # . .=..  ..# #.  .#....# # .#.    # # ## .#.#. # .# .# ###
#..#.### ## ##.## #######.#.# #### ##.#.# # ##.#.#  ... # # .##  #.##.# #.#
##. .#.  .... ......   . ..... . .  . . . .  . . ..## #... # .# # ...%..  #
#..# # #.##.#.### ## #.##.##.###.##.##.#.##.#.#.##.#.  .#.##.#. .# #####.##
##.#...# ..... .=  ..# # ...#.. .# #   .#....  # #. #.# #.#. .# #..#..  # #
#. . ##..######## ##.#.# #### ## ..# ## ..###.# .. #..# #. #.##.##.# ##.# #
##.#. .# #.. ... ... .    . . . .#  ....#.# ##.#.#.#.#..#.#.    .  #.# ...#
#..  # #.######=# ##.#.# ##.####=######.# . ....... #.# #..#.## ## .  # # #
## # # #........#  #.#.   . . ..  .  ...# #####.## #..  # #. #  .# ##.#.#.#
#. #= .  #.#.##. .# .#.#.## ## # ###.##.#  ....  .. #.#  . #   #.#...  ...#
##.## ### # # ## #.# ###.#.## #.##.## #.#.#.## # ###.##.#.#. # ..# ## # #.#
#.   .  .  . .=...  ... ...  ..... . .. ..... . ..   .. . .#.# # #.##.##.##
##.###.# # ## # ##.## # #.#.# # # # #.#.## #### # ####.## #. .  ....    ..#
##  ...   #  ...#.#.###.##.##..#...# #... #...# #.  .      #.#.#.#.## ##.##
#..# ##.#.#.#.# . .  .. ..... #..## .# # # .##.  .#.##.##.##.# # .. . ... #
##...#.## #.# .# ## #=#.#.###..#...# ### ## ## #.#.#.##.#  . #.# #.##.# # #
#  #. ... ..#.# ## #.# # ## #### ### .  ....      .. ..  .##.....# #.#.##.#
## ###### #.   ..      . ....   . .  ##.# ###.######.## #  . # #.#. ......#
#... .  #   #.##.####.##.# #.# #.# #. . #.#.#.  ..  ..  ..## # . ..#.# ##.#
##.##.##..# # .=  ...... .  .#.#.. ..####.#.##.#.#.####.# .# #.#.#.#.##.#.#
# .##. .#.#.  ## ##.# ## ## #..### # ........ ..  . .  .#.# . ..  .    ...#
##... ##  . # .#.... .. .....#.  =  .#.##.# #.# ## #.# #. #.# # ##.# #.##.#
#.#.##.##.###.##.##.# ##.## #.#.## # ##.#.## # ## #.# # #  #.# .= .## # ###
#..     . .. ..  . .  ...  ..  .....  .  .. .  .  ...     # . .###.. .. . #
# ##.# ## ## #.#.##.#.#.###.# ##.## ##.#.##.# #.# ###.# #..# #. .# #.### ##
#.  ..#.### ##.#.# #..#.  ..# #.. ...#  ..# #... ....#.##.#  # #.# # # .# #
#.###  . .. =..  .. # # #.##.## ## # #.# #..##.# # ## .#..#.#. .## #  #.# #
# . ..#.## #.#.# ##...#. . ...  ..   . #..#. .    . .#.##.#.##.#. . .## # #
### #.# #.# # #=  ..#.  ######.##.# ##.# #  ##.#.#.###..# ...# .##.#. ..  #
# #.# #.# # #.##.# # .#....... . ...#. #. # #..#...... #  #.# .#.#.#.### ##
#.  #   # #.#...... #.#### #.#=#.##..# #.#.  # .#.## #. #.. .#   #.#.#=#.##
#.### # . . #.###.# . ..  .... .    # .#  #.#..#...... #  # #. #...# ..#..#
#...  #.# #   #  . .# ###.# ## ### # #.#.#.. # #####.# ##...## # #.# #.# ##
##.## # #.# #.#.#####. .. \     . ... .. .# # .. ..#.#. #.#. . ..# # #.# ##
# . #.. ... #.... . . ##.## ###.#.#.#.#.# # ##.### # . ##.#.##.#.  # ..  .#
## ##.###.#.# #.#####.#.... .... ..#.#.#.#  . .#.#.#.# ... #.#. .# #.#.# ##
#.   .   ..... . ..  .#.#.#.#.##.# .. . . #.## # #.# ..## #.  .# #.# #.#.##
##.###.### # # #.##.#.#...#...  .# #.##.##.....  # # #... .#.# #.#.# #  ..#
##..   # #.# #  . . #.#.#   #### #.###.# ## ## #.# # #.##.# .. ...  .# ##.#
# .# #.# ### # ### #..# ###..   .. ....   #   .  #   #..# ##.# ###.# ..  .#
##... .  ...  ..  ..# #.. ..# #####.#.### ..##.#...#   ## ....... .#.# ##.#
# .# ###.### ## ### .  #.##     . .   #  .#.# ## #.### # .#.# #.##  . . ..#
##  . . .   . ..#.# # ##.#.#######.####.##. #.  .. ..  .#.... #.##.#.#.####
#. ##### ###.# ## # #..  .  . ..... ..= . #. # ###.### ##.#.#.#.. .# .  . #
## # ..   ...#  .   ..##.### ##.#.# ### #.# #......... ...## #.###.# ## # #
#... ###.#.#  # ### #.#  ......# .. .. ...# #.# #.# #.#.# .. ... ..#.#. #.#
## #   #.# #.# . . .#...## #.#.# # # #.##.#... ## #. ..#..### #.## ##.#  .#
# .## ##.#. .## # #.#.# #.##   .. o. #....#.## #.##.##.##..... ..#. =. .# #
## =.....#.#   .#.#.#. .  . .##### #.#### .  .    ...    .### # #  #.##=#.#
#  ## ## #.# ####.#.#.#### #.......  .... # ##.##.# #.### ..  #..#.#...   #
##. .# #.# .  .  .  #......#.# #.# ## ##.#. .# .#.#. . .#.# # #.#..#.##.###
##.#. .  # # ## ##.# .#.#.#... #.##.##.#.##.##.#.##.### # #.  ..## #. #  .#
#= #.# #...  # ##.#.#.##.# # #.#........ ... .    ... #.  #.##.#.#.## #.###
## # # #.# # ..... .#  ....#.#.# #.#.# # ##.## ####=#.#.# ...  ...... # # #
# .....  #   #.# #.#. ##.#. .#. .##.# # .. . .. . .. ...  ## #.## #=#. .# #
#.####.##.####.###.## #.##.##.#.# #.#.#.############.####.# #.## #.## #. .#
#. . ..   ...    ....   .  .... . .... ..     .   ..... ... ...... ..  .# #
###########################################################################
