#####################################
#.    . #  o .\ . ## #  # ## # #    #
#### ##. .# #.# #   .. #  .. # ####.#
#. .# # # #.#.# # ## # # ### #    # #
# ###.# # # # # #  ..# .   . # ##.# #
#    .# #   #.  # ## # #.# #.#  # #.#
#.### # # ### ### ## #.##.## # # ## #
#.    .   .    . . . .   o.      .  #
## ## # ## ## # # # ####### ### # # #
# . #  # #    #   # . . .       #.# #
# # # # .# ##   #  ##### ###### # ..#
# # # ## #  # #.#.#     o.      # ###
#.       # #. # # # ## ## ### # # # #
# # # # ##  # #.# # #  #  # #.# #   #
# ## # ## ###.### #o### # # ### # ###
#. = .   .  .       . =    ..   # # #
#.###.# # # #.#.#.##### #### ## #  .#
##. #.##.#.# # #        #   #   # # #
#  #     # #    # #### #.# ##.# # . #
##. #.#### # # #.  .           .  # #
#  #       #  . # ## ## ### ## ##   #
##.## # ## # # #  # .   .       # #.#
#  .#     .# .  #.# ##.# ## ## #. #.#
## #  ### #  ###  # #. #.  .#  .# # #
# .##    ..#   .# #  #   ## ## ## # #
##  # # ##.# #.## # #  #   . .    ..#
## ## #  #=# . .  # ##   ########.# #
#     # #    ## # #   .# .    .  .#.#
# ####.# ### # ##.#### # # ######   #
#  ...   .    ..  ....  . .     . # #
# ## #.# ##%### ## #.# #.## ### #.  #
###.## ## ### ## ## #.# #.### ###.# #
#           ..   =.    .   .  .   # #
## ### ##### # # # #.## ## #.## #.  #
#  #   #   . ### # # ## #  #  . # # #
##...# .#.##     #.#  .  #...##.#.#.#
#####################################
