#############################
# . .#.## #.# ..#. ..#.#o#.##
# ##.#....... ##.#.##.....o.#
#. #.#.#.##.# ...#...#.#.#.##
# # #...#  # ##.#..###.##.# #
#o..#.##.# #.#.#.#=.....o ..#
#.# #. ......=. ...## ##.#.##
#.##.###.####.#.##.#.# ### ##
#....#.#.  ..#.#.#.#........#
####...# # ###.#.# ###.##.# #
#....##. .#...  .#.. .#.#.# #
##.#...#.#  #.##.#.####. #=##
##.#.#.#..## #.#.# . .. ##..#
# .#.#.#.#.# #.#...##.#.#..##
####.#.#. .#.#. ##.# # # #.##
#.....#..## ...# #..... . . #
####.#.#.#.#.##... #### ### #
#......#...#.#%### #...#. #.#
#.# ##...##......#.#.##.#.#.#
#.#.#..#. .#.###...#.... .#.#
#.#.##..###.## ####.#.#.#.#.#
###..#.#... ......#....#..#.#
# . #..# ## #.###..####.#.# #
# #..#.#.#.#.## #.#. ...#.#.#
# .## # .. .... #=#####.# #.#
#.#...# # #.##.##..  ...= #.#
#.##.#.#.#\##.## #.##.###.#.#
# ...#..........=..#. ..#...#
#############################
