#############
##.# ...#...#
# .o#.#.##.##
##.#. #..#.##
#.\.###.#...#
##.#.%..##.##
## ####o.#.##
#..o. # ##..#
##.####.#. ##
#.o ... .# ##
#######.##==#
#....... ==##
#############
