#############
#.o... .....#
##.##.####.##
##.# . ...#\#
#= o#.###.#.#
# ###.#.### #
#.......o.. #
#.##.##.# # #
##.#.#. # #.#
# ... #.#.#.#
##=#=# . .#.#
# =#%..##o..#
#############
