##############################################################################
# ... .... . .. .   .. ..... ..  . .... .. .. .        ......  .=  .  .... . #
# ##.# # #.#.# # #.## ##.# #.#.##.#.#.## #.# #.##.#.##.##.## ##.#.#.# ##.##.##
#.## ... .   ..  . .. ...   .........  ....  . ..  ... .. .. ... . ... .  ...#
#. . #.# #.# # #.# #.# ##.##.#.#.##.# ## #.#.#.#.##.##.##.## ## # # # ## ##.##
# ##.#.# #.# #.# #... ... .... #.##.# ##.. .....=.  ... .  .  . .   ..## ##.##
# ##... ..... .... #.#.##.##.#.... .. .. #.#.#.# ##.## ##.## ## #.# #. .. ...#
#....# # #.# # #.#.  . .  . . .#.##.#.##.. ... . ......  .. ... # # #.## ##.##
# ##.#.# #.#.#.#.#.#o# ## ## #.#.## #.##.#.#.#.##.# ##.# # #.## .. .. . ..   #
# .. .... .. ..  .... .. . ... .... .  ... .  ....  .   ..  .  .# #.#.##.##.##
#.##.#.#.#.# #.#.# # # ##.##.##.#.#.#.#.## # #.##.# ##.#.#.# ## .   ...  ##.##
#. .   .... ...  ....   ....  .. . .. ... ..  .  . ..   ...#.## #.#.# ## ..  #
# ##.#.#.# # #.#.# # #.##.## ##.#.# #.#.## #.#.##.#.## #.#.  .  ..  #.##.##.##
# ... ...  . ..  ....    ... . . ... . .. . .#.## #.##.# #.# ## # #..    . . #
# ##.#.# # # # #.#.#.#.##.##.## #.# #.## #.#. .   .  .  ..  o  .....#.## ##.##
#..   . ..   .  .  .  .... .  . .   ........ #.#.##.##.# #.# ## #.#.# ##.##.##
#.##.#.#.#.#.#.# #.#.# ## ##.##.# #.# ##.#.# #.# ##.##.# #.#........ . ..    #
# ... .   .. . .. ......  .. .   .....   .... ...   . ..  .  ##.#.# #.## ## ##
#.## # #.#.# #.# #.## #.#.##.#.#.##.##.#.# # #.#.##.##.#.#.#.##.# #.#.##.## ##
# .......  ......... ..  ..\....   ....     ..... ... .  .  ....  .. .  .    #
#.##.#.# #.#.# # # ## # # ## # #.## ## #.# #.#.#.##.##.# #.# ##.#.#.#.##.## ##
# ......   .. .. . ... . ..  .....    . . .   . . . ...... . . . ...... .  ..#
# ## # # #.# #.#=#.##.# # ## ##.# #.#.##.# # #.#.## ## #.# # ##.#.## # #.## ##
# ## # #.# #.# # #.##.# #.##.## #.#.# ##.# # #.#.##.## #.# #.##.#.##.....## ##
# .. .. ..  ...... . .. . .. .... ....  ..    ..   .  .... . .  .. ..# # .. .#
#.##.#.#.#.#.#.#.#.## # #.##.##.#.# #.##.# # #.#.## ## #.#.# ## # ##... .##.##
# ## #.#.# #.#.#.# ##.#.# ## ##.# #.#.## #.# # # ##.##.#.# # ##.# ##.# #.## ##
#.. .  .. . . ... ... . . .. ..  ... .     . ... . .  ...  .... .. .. ... ...#
#.##.#.# #.#.# # # ##.#.#.##.## # #.## #.# #.#.# ##.#.##.# #.##.# ## #.#.##.##
#.##.#.  . ..... #.## #.#.##.## #.#.## #.#..... ...  . ..  ....   ......  ...#
#.... .# #.# #.#.  .   . .   ... ....  . ..# #.#.##.# ##.#.#.##.#=## # # ##.##
#.## # ....  # #.# ##.#.# ## ## # #.##.# #.. .. .. ...   .   ..  .. . ..   . #
#.... .# #.#. ....... . . .... .#.#.##.# # #.#.#.##.#.## #.#.##.#.## #.# ## ##
# ## # .  ...# #.#.##.#.#.##.##..   .   ....... .. .    ....   .   ..  ....  #
#.## #.# #.#.# #.#....  .. .....# #.##.#.#.# #.#.##.## # #.#.##.##.#.# #.## ##
#. .. . ..%.  . ...# ##.# ##.##.. .. . ..  .. . ... .. .... ... ##.# #.# ## ##
#.##.#.#.#.# # # # .......  .. .# #.##.#.#.#.#.#.##.#.##.#.# ##. ..    . .. .#
#.## # #.#.#.# #.# #.##.#.##.## #.#.##.# #.# #.#.## #.##.#.# ##.##.#.#.#.##.##
#..   ......   . .=. .. ....          . ... .  ..  .... .. ......       .  .##
# ## #.#.#.#.#.# #.# ##.# #.#.# #.# ## # #.# #.#.##.##.# #.# ##.##.# #.#.##. #
#.## #.#.#.# # #.#.#.##.# #.#.#.#.# ## #.#.#.#.# ##.##.#.#.# ##.## #.# # ## ##
#.   . .. ........... . .   . .. ....        .....  .  . .....  . .. . .  . ##
# ##.#.#.#.# #.# # # ##.# #.## ##.# # #.##.#.# # ##.## #.#.#.## ##.# #.# ##..#
#.## #.#.#.#.#.# #.# ##.#.# ##.## #.#.# ##.#.#.#.##.## # #.# ##.##.#.# #.##.##
#. . .....   ... ....... ......... ....    .. ..  ... ..  ... ......  .....  #
#.## # #.#.# #.# #.# #.##.#.##.## #.#.#.##.#.# # ##.##.#.#.# ##.##.# #.#.##.##
#.... .. ......... .  ..... .. . .  #.# ## #.#.#.##....  ......    . .... .  #
# ## #.#.#.#.# # #.#.# ## # ## ##.#..  . ... . .....##.#.# #.##.## #.# #.## ##
# . .. ...  ... . . ..  ....=.   .. # #.## #.#.# ##.## #.# .. #.. .. ..  .   #
# ##.#.#.#.# #.#.#.#.# ##.#.##.##.# . ..## #.# #.  .  . ...# #. ##.# #.#.## ##
#. .  .. ..#.#.# # #.#.##  . .  .. .#.#.. ..   ..## ## # # . .#........ .  . #
# ##.#.#.#....    ........# ## ##.#.#.#.## # #.# ## ##.# #.#.##.## #.#.# ##.##
# . .. ....# #.#.# #.# ##........ ......... ...... .    .  . ...  ...........#
# ##.# #.#.. .  .  . . .  #.## ## #.#.#.##.# # #.##.##.#.#.#.##.##.#.#.#.##.##
# ##.#.#.# #.#.#.# # # # ## ## ##.#.#.#.## #.#.#.##.  .......  .     ..... ..#
# . ... ..... ...  ..  ... . .  .   ..    . ... ... ## #.# #.##.##.#.#.#.##.##
# #.#.## #.# # # #.# ##.# #.##.##.# # #.## #.#.## #.## # # #.##.## #.# # ##.##
# #.#.## #.# #.# #.# ##.#.#.##o##. ..  .  ...   .    ..  ..  .   ....        #
# ......  .. .     ..  . ......   #.#.# ##.# #.##.# ## #.#.# ## ## #.#.#.## ##
#.#.#.##.#.#.#.## ## ## # # ##.##.# #.#.##       .. .......#.##.## #.#.#.## ##
# .. ... .... . .. ..  .......... ..  . ...#.#.## #.##.# #... . .... . .. ...#
#.# #.##.#.# #.##.##.##.#.#.##.##.# #.#.##.  . ## # ## # #.#.## ## #.# # ##.##
#.... . . ...   ....... .. .  ..  ... . ...#.#. ....... . . . .. ... .. . .. #
#.#.## #.#.#.#.##.##.## # #.## ##.#.# #.##  . .##.#.##.# #.# ## ## #.#.# ##.##
#...   .. . ..= #.##.##.#.#.##.##.#.#.# ## # #.  ..  .... . ....##.#....  . .#
# ##.# #.#.#.#.# ..  ... . .. . ..  .o ....#.#.## # ##.#.# #.## . ...# #.## ##
# ... ...      .#.## ##.# # ##=##.#.#.#.##..................  ..## #.......  #
# ##.#.#.# #.#.## ##.## #.# ##.## # ##.# #.#.#.## # ## #.#.#.## ## # # #.##.##
#... ..   ...... ......  .....  .... . ... ..  ....   . ...... ........ ...  #
#.# ##.# #.#.#.##.## ##.#.# ## ##.# # ##.#.#.#.##.#.## #.# #.## ##.# #.#.##.##
#..   ....... .... .... .  .##.##.... . ... =..... ...  .   .   ....  =... . #
# ##.# #.#.#.#.## ## ##.#.#..  .  #.# ##.# # #.##.# ##.#.#.#.##.##.#.#.#.##.##
#.   ......  ..   . .. ...  ##.## .  .  .....#.## .   . .....   . .......  . #
# ##.#.#.#.#.#.##.## ##.#.#.##.## #.##.#.#.#... ..# ## #.#.#.## ##.#.# # ## ##
#.....  .. .... . . ...  ..... . ....... . # #.##.# ### ##.#........... .  ..#
#.## #.#.# #.#.## ##.## # #.##.##.#.## # # .......... ..   . ##.## #.#.#.##.##
#. .  .  . .  . .  .....  ...  ..    .. .. #.#.##.#.### ##.# ... ..... ......#
##############################################################################
