######################
# #..#o  ..oo..#.#.#.#
#. #..##.#.#.# #...#.#
# #..#o##.#=# .#.## .#
#\ #...   ...# #.#.#.#
# ##%###.#####.#...= #
#.   .......=..  ##=##
############### # .. #
#. ...... .  ...#.# ##
# #.#.##.# # ## #.# .#
######################
