######################################################################################################################################################
#....#.#...#..#..#.#..#.#.#.#.......# #.# #.#......#.#..##.#.#.#.#.#..#.#...#..#..#................. ......................#...#.#.#....#..# .##.#...#
#.####.#.#..#..# #.#.#........#.#.##..#.#.#.######.#.##............#.#...##..#..#.#.##########.###### #.##############.##.#..#. ....###..#.#.#....#.##
#.......##.# .##.#.#..#######.##.##.#.#.#.#...........#.###.#.##.##...#.#.#.#..#..#..........#.#....#.#...............#..#.#.#.###.#..#.#.....## #...#
#.#.##.#.. .#......#.#..... ..........#.#.#.#######.##....#.###.#.##.#.......#..#.#.#####.### #.###.##.################.##.#.###.#.#.##.####.#.#.##.##
##.#.#.#.#.##.####.#..#.##.#.#####.##.#.#.#..... .#...#.#.#........#.#.####.#..#..#............................... ..... ............................#
#......#.#.#..#....#.#..#.#.#.....#.#.#.#.#.######.####.##.#########.#.......#..#.#.####.##.##.#.##.###.##.#.#.##.##.###.#.###.#############.#.##.#.##
###.##.#.#.##.#####..##.. #...#.#...#.#.#.#.#....... ................######.##.#..#.#....#....#.#...#.#.#.#.#.#.##.#.#...#.#.#..............#.#..#. ##
#.#..#.# #.........#..#####.##.#..## .#.#.#..#.####.##.##.##.####.##............#.#.#####.#.##..###.#.#.#.#...... .#..###.##.###########.####.##. #..#
#.####..##.#########.#..........#...#.#.#.#.#.#...#.#.##.# .#...#..#.##.#.## ##.#.#.........#.#...#.#.###.#.###.####.#......... .......... ....# #..##
#... ..#..............#####.##.#..##..#.#.#.#.#.##.##.#..##..#.#.###.#.#.#.##.##..# ####.##.#.#.##..#............ ....#######################.##..#..#
#.##.#..#.##.##.##.#.#..... ....#...#.#.#.#.#. . ......#..#.#....... ...........#.#.#..#..#...#...#..##.#.#.#.#.#.## #...........................#..##
##...#.#.#..#.#.#..#. ##.##.#####.##..#.# #..#.#.#.##.#..#...##.#.##.#.#.# ##.##..#.##.###.####.##.##.##.#.#.#.#.#.##.##########################.###.#
##.##..#...#..#.##.#.#...#.. ...... #.#.#.#.# .##.#.#..#..#.#.#.###..##.#.#.#.#.#.. ............................... ....... .........................#
#. ..#.###.##.##.###.####.#.########..#.#....#......#.##.#..#.#....#........#.#.#.#.#.#.##.#.##.#######.######.##.#.#.##.#.##.##.##.#.#.#.#.#.#.#.##.#
##.###........................... ..#.#.#.#.#..#.#.#......#.#.#.###..#.#.##.#.#.#..#.#.#.##.##.#..... ........#...#..#.##....#.##.#..##.#..#.##..#.#.#
#......##.#.##.#.###.#########.#.#.#..#.#.#..#.#.#..#.###.#.#.#. ..#..#.#.### # #.#........ ....#.#.##.##.###.#.#...#.....#.#.....#.#...#.#..#..##.#.#
###.##..#.#.#.#.#...#........#.##.#.#.#.#.#.#...## ##.#.###.#...#.#..#....... ..#..#.##.#.#.##.#.#.##.##.## #.##.#.#.#.####.##.#.#...####..#..#.#..#.#
#.#.#..##.#.....#.##..##.## ##..#.#.#.#.#.#..#.#...#..#......## #..#..#.#.###.###.#.#.#.#.#..#.#.............................#.##.#.#.....#..#...#.###
#.#.##.#..#.#.#.#.#.#.#.#...#..#....... #.#.##..##.##.#.###.#.#.###..#.##.# #... .#.#...#.#.## ##.##.##.#.#.#.##.##.##.##.#.#.......#.#.# .#.##.#....#
#.#..#.###.#.# ##.#.#.#.####.#.#.##.#.#.#.#.#..#....#.#...#.#.#....#.#.. .#.#.###.#.###.#.#.#...#..##...#..#.#.#. # #.#.##. #######.#..##.##..#..#.###
#.#.#.... ............... ...#.###.#..#.#.# .## #####.###.#.#.######.######.#...#.#...#.#.#..#.#..#. .#.#.##.#.####.#.....#. .....#.#.#...# .#.###...#
#.#. #.####.#.#.#.#.#.#.#.#.#.......#.#.#.#.#...... .....................  .#.##..#.##..#.#.#. .#.#.#.#.#.#..#......#.#.#.#.##.##.#.#.#.#..#.#.....#.#
#.#.#..#...#..#.#.##.#.#.#.#.#.#####..#.#.#...#.###.##.##.##########.##.# ###.#.#.#...# #.#..#.#...##.###..#..#.###.#.#..##.#.#.#.#.#.##..#..#.#.#.#.#
#.#..#. ##.##.##.............#......#.#.#.#.#...#..#.#.#.#.... ....#.#..# #.....#.#.##..#..###..#.#.......##.#....#.#.#.#...#...#.#.#...#..# ##.##.###
#.#.#..#.#..#...#.#.###.##.##..###.#..#.#.#..##..#.#.#....#.#####.#...##.#.##.#.#.. ..#.#.#... #..#.##.##.#...#.## .# #.#.#.#.#.##..#.#.#.##... .....#
# #..#.#.#.#.####.#.#.# #.##.#...#..#.#.#.#.#...#.... .##.#.#...#o.#.# .......#.#.####..#..#.#..##.#.##.##.#.#.#.###.##.### #.#...#.#.##..#..##.## #.#
#.#.#..#... ......#.#.#.#....#.##..#..#.#.#..###.######.###.#.## ###.#.##.###...#.....#.#.#.##.#.  ..............  .........#.#.##..#...#..#..#.#..#.#
#....#..#.#.#.#.#.#.# #.#.#.#..#.# .#.#.#...#.. ......... ....... ...#.#....#.##..##.#..#.... .## #.#.##.#.#.#.##.##.#.#.##.#.#...#...#...#..#.#.# #.#
###.# .#...#.#..#.#.#.###.##.#...#.#..#.###..######.##.#.##.###.####.#. #.#.#...#.#...#.#.#.##..##.#.#.## #.#.#.###.#.#.#.#.###.###.#.#.#..#.#.....#.#
#.#..#..# ##.###. #. ..... ..#.##...#.#...#.#.......#.#..#.#..#.#..#.#.#.#.##.##.#.###..#..#.#.#.............. ............... .....#...#.#...##.#.#.#
#.#.##.#........#.#.#########....# #..#.##...# ##.#... #.#..#.#.##.#.#.#..............#.#.#..#.#.####.###.##=##.#########.##.##.###.#.##..## #.###.#.#
# #.#...#.##.###..#..........#.##...#.#...#.#.##.#.#####.#.##.##.#.#.#..#.#.#.##.#.#.##.#..#.#.#.#..#.#....#.#.#.........#...#.##.#%#.#.#..#.#.....#.#
#.#.##.#.#.###.###.###########.#.#.#..#.##..#............# ........#.#.#.#.#..#.#.#.##..#.#. ..#.#.#.. ##.#.##.#########.#####.#..#.#...#.#...##.#.#.#
#.#..#.#....... ...............#....#.#...#.##.#.##.####.#.####.#.##.#......#....... .#.#..#.#.#.#..# #.#.#... ......... ......##.#.#.##...#.#.#.#.#.#
# #.#. .#######.######.## #.##..##.#..#.###..#..#.#.#....#.#...#.#...#.#.##.#.#.#.#.##..#.#.#..#.#.## #...#.##.###.#.#.#.#.###..#.#.#...#.#..#...#.#.#
#.#..#.#o. ...... ...#.#.#...#.#....#.#.....#.###.##.#####.###.#.###.##.##.#.#.#.#.#.###.##.##.### #.#.###.#.###.##.#.#.#.##.#.##.##.###.. #.#.#.#.#.#
#.#.##.#########.####.##.####.#.####...#.##...................... ............................................... ..................... #.#..#.#.#.#.#
#...# . ......... ............ .... #.#.# ..###.##.##.#.##.#.####.####.#.#.#.##.##.##########.# #######.##############.#.###.#######.###...#.##.#.#.##
###..#.##.#.##.#.##.## ##.#.##.#.#.#..#.#.#.#..#..#..#.#.#.#.#..#.#...#.#.#.#.#.#..#.........##...=...#..............#.#...#.......#.#..#.#..........#
#...#..#.#.#.##.#.###.#.##.## #.#.#.#.#.##..##.#.##.##.#.##..#.# ..##.#.#.#.# #..#..#.# ##.#.#..######..#############.#.###.###.###.##.##.##.#########
#.#..#........... ....... ..........#.....#....... ........#.#.####.#.# ......#.#..#.#.##.##.##.......#.#..... .................................... .#
#.#.#..##.##.#.##.#.# ##.#.#.##.#.#.#.##.#..##.#.##.#.##.#.#............#.#.##...# ...........#.###.##....##.##.#.#.#.#.##.##.#.#.### ###.############
##.# # #.##.#.##.#.#.##.#.#.##.#.#.##.# #.#.#.#.##.#.##.#.#.#.######### ##.# ####.############.## ##.###.##.##.#.#.#.#.##.##.#.#.##.###.#..... ......#
#................ ............. .................. ... ................................ ..... ........ ............... ...................#.##.#.#.#.#
#.##.#.##.##.#.#.#.#.### ###.#.##.#########.###.##.##.######.##.##.###.#.#.##.#.###.#.#.## #.##.#.####.###.#.###.#.##.#.#.#.##.####.#.#.#.###.#.#.#.##
##..#.#.###.#.#.#.#. #..##.#.##.#.#........#...#..#.#.#.....#.###.##.##.#.#..# ##.#.#.#..#.#..##.#...#.#...##..# #.#.#.##.#.#..#..#.##..#............#
#. #..#..... .#.#.##.#.#........#.#.#.##.##..##..##.##.####.#...........\..#.#....#.#.###..#.#...#.##. #.#...#.#.#.#.#....#.##.#.#....#.#.# ##.##.#.##
##..#.#.###.## .#....# .#.##.#.#..#.#.#..#.#...#..........#..# #.#.#.##.#.##..#.#.#.#....#.# .##.#.#.#.#.#.#.#.##. #.##.#.#..#....#.#.#.#.#.#.# #....#
#..#..# #...###..#.#.#.#.#.##.#.##..#..# #.#.##..#.####.##..#.#.#.#.#.#.#.#..#.##.##.####..#.#.#.. ..#.#.#.#.#...#.#..#.#.#.#..#.# .##..#.###.#.####.#
##  #.#.#### ##.#.#.##.. .........#.#.##.#.#.#.#.#.#...#..#...#.#.#.#.##...#...... ......#.#.. #.##.#..#.#=#.#.#...#.#..#.#..#.#..#...#.#............#
#..#...................##.##.##.##..#.# .#.#.#.#..#.#.##.##.#.#.........# ##.###.# #.##.#..#.##..#...#.#.#.#.#.#.#.#..##.#.##.#.## ###.##.## ##.##.#.#
##.###################.#.#.##.###.#.#..#.#.#.#.#.#..........#.#.#.##.##.#.#..#.#..#.##.#.#.#.#.#..#.#..#.# #.#..##.#.#........... ........#.#..##.#.##
#...... . .. .. .. ................ #.#. #.#.#.#..#.#.#.###..##.##.##.###.## #.#.#.....#...#.#...# ..#.#.#.#.#.# ..#..#####.#############.#.##.......#
###.#.#######.##.#.#######.###.#.##.#..#.#.#.#.#.#.#.#.##.#.#..............#...#..####.#.#.#.#.#..####.#.#.#.#.#.#.#.#......#. ...... ....#....#.#####
#.#..#... ...#..#.#........#...#.#..#.#..#.. #.#.#...........####.###.#.#.##.#.#.#.....#.#.#.#.#.# ....#.#.## .#.#.#.#.##.#.#############..#.#.#.#...#
#.#.##.######..##..#.#.#.#.###.#..#.#.###.##.# #..#######.#.#.. #.#.##.#..#...##.#.###.##..#.#.#.#.#.#.#.#...#.#.#.#..#..##. ...........#.#.##.##.##.#
#.#.#........#.#..#..#...#.. #.#.#. .......#.#.#.#........#.#.# #.#.....#.##.#...#...#...#.#.#.#.##.#..#.#.###.##..#.#..#. .#.#.#.#.##.#.......... ..#
#.#.##.#.##.#...#..##.####.#.#.#.##.#.#####..#.#..#.#####.#.#.## ##.##### .#..##.#.#.#.## .#.#.#.....#.#.#.#.....#.#..#..##.##.#.#.#.##.#.#.##.#####.#
#.#..#.#.#..##.#..#........#.#.#..#.#......#.# #.#.. ...#.#.#.. ..........#..#.#.#.# #.#.#.#. ##.###.#.#.#. ##.#.#.#.##.#.#....#........#..#.#.#. ..##
#.#.#..##.##.#.##..#.###.#.#.#.#.#..#.#.###..#.#..######.##.#.#.##.# ##.#.##.#.#.##.##.#.#.#.#. .#.##...#.##.#.###.#.#......###..####.#.#.#.....###.##
#.#..#.......#..#.#..#.#.#.#.#.#..#.#.##...#.#.#.#......... #.#..#..#..##..#.#.... ......#.#..##.....# #...........#.######.#..#.#....#.#..#.#.#.....#
#.#.#..####.#..#...#.#.#.#.#.#.#.#...#.#.###.#.#.##########..#.##.###.#...#....#.#.#.#.#.#.#.#.#.##.#...##.#.##.##.#......#.#.##.#####.#..#.##.####.##
#.#.##.#....##..#.#..#.#.#.#.#.#..#.#.................... ..#.........###.##.#...#.##.#.#..###.#.#.#.#.##.#.##.#.#.#.####.#.............#.#..........#
#.#..#.#####.#.##..#.#.#.#.#.#.#.##..#.##.#.#.#.#.#.#####.#..#.######...#..#..##.#.......#...........#.#.. ... ....#.#....#.##.##.#####.#.############
#.# #.............#.##.##.#.#..#.#..#.#...#..#.#.#.#....#.#.#.#.....#.##..##.#.#.#.#.##.#..##########...## ####.##.#.#.##.#..#..#.#...#.#............#
#.#..#.#.##.##.##............#.#.##.#.####.###.#.#.#.##.#.#.#.##.##.#...#.#....#.#.#.#.#.#.#... .....#.#.#.#..# .#.#..#.#.#.##.#.#.##.###.##.##.#.#.##
#...# #.#.#.#.#. .##.###.##.#..#..#.#..........# #.#..# #.#.#....#..#.##...#.###.#.#.#.#.#.##### ####..#....#.#.#..#.##.#.#.#..#..... ... #.#..#.#.#.#
###.#. .... #..##.#.##.#.#.#.#.#.##.##.#######.#.#.#.#.#.....###.###....#.#..#...#.#.#...#...........#.#.#.#.....#.#.#..#.#..#..##.######.#.#.#..#.#.#
#.#.#.##.##.#.#.#.#....#.#.#.#.#.#...#.#.....#.#...#....#.#.#.. ....#.##..##..##.#.#.#.#.#.#.##.##.##...# #.######.#..#.#.#.#..#. .#... ..#....#.#.#.#
#.#.##.#.#..#.#.#.#.##.#.#.#.#.#.##.#.#.#### #.###.#.###.##.#### ####.#.#. #.# #.#.#.#.###.#.#.#.#.#.#.#..... .....#.#....#..#..##.#.####.#=##.#.#.#.#
#.#..#.#.##.#......#.#.#.#.#.#.#..#..................... ........ ......#.#..#.#.#.#.#.....#.#.#...#.#..#.#.###.##.#..#.#.#.##.#.#.#. ..#.#.#..#.....#
# ..#.....#..####.##.#.###.#.#.#.#..##.##.#.#.#.#.##.#.#.##.#############..#.#.#.#.#.#.###.#.#.#.#.#.#.#.#.#..#.#..#.#.#.#.##.##.##.####..#..#.#.#.#.#
###..###.##.#.....#..#.....#.#.#..#.#.## #.#.#.#.#.##.#.#.#.#.............#..#.#.#.## ##.#  ##.#.#.#.#.#....#.#..#.. ........... .. ....#.#.#..#..#.##
#...##.###.#.####..#.#.#####.#.#.#........ ...............#..#.#.#.#.#.##..#.#.#.#.. ....#.#...##.##.#.#.#.#..#.##.##.######.##.#########.#.###..#...#
###.............#.#..........#.# ##.# ##.#.#.##.##.#.##.##..#.#.#.#..#..#.##.#...#.#.####...##.......#.#.# .#.#.#..#.#.....#.#.#..........#.. .#.##.##
#...####.###.# #...##.##.###.#.#..#.#.#.#.#.#.#..#..#..#..#.#.....##.#.##.# ..##.#..#....#.#.#.##.###..###.##.#. #...#.## ##.#.#.#.#.#.##.#.#.#.... .#
#.#.#...#.....#.#.##.#.#.#.#.#.#.#..#.......#.#.#. #..#..#..##.##..# #.#...#.#.#.#.#..#.#..#.#.#..#..#........#.#..#.#.# .#..#..#.#.#.#.#.#.#.##.#####
#.#.### #######.#.#....#...#.#.#.##.#.##.#.#..#..#..#..#.##..##.#.#.#.#.#.#..#...#..#.#..#...#..#..#.#.#.#.#.#..##..##..#..#.#.#..........#.#..#.#...#
#.# ............#..#.##.####.#.##.#.#.#.#.#.#.#.#..#..#...#.#..............#.#.#.#.#..#.#..#.#.##.#..#..#.#.# ##.#.#...#..#..#.#.#.#.#.##.#.####..#.##
#.#.###########.#.#..........#....#.#...#.#...#..#.##..#.#...#.##.# ##.##.##.#.#.#..#.# .#..##.#.#.#.#.#............##..##.#.#.##.#.#.#.#.#......#...#
#.#.#.............######.### #.###..#.###.###.###.#.#.#..##.#..#...#.#..#.#..#.#.#.#..#.##.#.........#..#.#.##.#.#.#.#.#.....#..........#.#.#.##.##.##
###..#.########.#.... .#.. #.# ...#.#.#................#..#..#..####.#.##..#.#.#.#..#.#.#..#.# ######..#.#.#.##.#....#..## #.#.#########..# .#.#.... #
#. .#.........#.#.#####..##..#.####.#.#.##.###.####.#.##.#..##.#.....#.#..##.##.#.###.#.##.#.#.......#...........#.#.#.###.#.#.#........#.#.##.#.##.##
#.#..#.#.#.#.#. #......#.#.#.#.#....#.#.###..#... #.#.#...#.#..##.##.#..#................#.#.#.######..#.#.##.##.#.#.#..#.##.#..#.#####.#.#....#.#.#.#
##.##.#.# #.#.###.#####.##.#.##.###.##.#.## #.####.##.##.##.###.##.#.####.###############..#.#.......#.#.#.#.#.. #..## #.....#.##.....#.#.#.##.#.....#
#................... ..... ....................................... ......................#.##..##.#.#..#.#.#.#.#.#.#....######.#.######.#.#..###.#.#.#
#.####.##.##.#.#.#.#.#.##.##.##.# ##.#.#.##.##.#.##.## #.##.##.#.#.#.#.#.#.#.##.#.##.##.#....#.#.#.#.#..##.#. #.##.#.#.#................# #.#....#.# #
###..# #.#...##.#.#.#.#..#.#.#.#.#.##.#.##.#.# .#.#.#.#.#.#.#.#.#.#.#.#.# #.##.#.##.#.##.#.###.#.#.#.#.#.....#.....#.#.#######.#########..#.#.##.#.#.#
#...##.#..##........#.#.#..#.#...............#.#..#...#...#... ................ ........ #.#...#.......###.#.#.###..##..................#.#.#..# #.#.#
###.# ##.##.####.####.#.##.## ##############.##.#.#####.###.############################## .##.#.##.##...#.#.#.. #.#...#####.#####.##.#.#.#.#.#..#.#.#
#................ ..... .......................................... ...................... .#.#.## ##.# #.#.#.#.#.#.###.# ....#...#..#.#.#.# ##.#.##.##
##.#####.##.#.##.##.##.#######.###.####.#.##.###.#.#.##.#.##.##.#.#.######.##.##.###.#.###.#..... ...# .##.#.##.#....#.#.#.#.#.##..#..#.#...... .....#
#..#.....#.#.##.#.# .#... ...#....#....#.#..#. #.#..#.#.#.#.##.#.#..#....#.###. #...#.#..#.#.#.##.#.#..#...#.....#.#.#..#.#..#...#..#.#.#.####.###.#.#
##.#.#.#.#.#....#.#.#..###.##..##.##.###.##.##.##.###.##..........#.#.####..##.#..##  .#.#..##.#.#.#.#..##.#.#### .#.#.#...#.#.##..#..#.#.#...##..#.##
#...#.##.#.#.####.# .#.#. #..#.#........................#.#.#.##.#. # #....#....#...#.#..#.#...........#.#.......#.#.#..#.#......#.###.#..###.#..#...#
##.#.....#.#......#.#...#..#.#..#########.###.# #####.##.#.#.#.##.###.#####.##.##.###.##.#...##.#.##.#.#.#.#.##.#..#.#.#...#.####.......#......#..#.##
#..#.#.#.#.#.##.#.#.##.#..##.#.# .......#.#..#.##...#............................ .=.....#.#.#.#.#.#.#.#.#.###.#.#.#.#..#.##. ...#.#####..###.#..#...#
## .#.#.##.### ##.#..#..#.#....##.#.#.#.#.#.##.#..# #.##.#.##.#.##.##########.#.##.##.#.#..#.#...#.#.#.#.#.......#.#.#.#..#. ##.##.#....#.#.##.#.##.##
##.#.......... .. ..#..##.####...#.#..#.#.#.....#.#.#.#.#.#.## #..#..........#.#.##.#.#.##...#.##..#.#.#.#.###.##..###.##.####.##.#.##.#........... .#
#...#.##.###.##.#.#.##.#...... #.#.##.# #..#.#.##.#.#.#.#.......# #.#.##.##.#..# .....#..#.#.#...#.#.#.#.#.#..##.#......................#.##.##.#.####
##.#.#.#.#...#.##.#..#.#######.#.#..#.#.#.#.#..#..#.# #.#.#######.#.###.##.#.#.#######..#..#.#.##..#.#...#.##.#... ###.###.#.#########.#..#.##.#.##..#
#..#.#...#.# #.#..#.##.......#..##.##.###.#..#..#.#.#................ ................#..# #.#...#.#.#.##...#.####.#.#.#..#.#........#..#..........#.#
##.#.###..##.#..#.#.#..#.#.##..# .........#.#..#..#.#.#.#.#.##.###.##.#.#.#.##.###.##.#.##.#.#.##..#.#.#.#.#.......#.#.#.##.#.##.#.# #.#..#.#.##.#.#.#
#..#.... #...#.##.#.##.##.#.###.###########.##.##.###.##.#.#.###.###.#.#.#.# ### ###.#.##...##...#.#.#...#.#.###.#.#.# #.#..#.# #.#.#.#.#..#.##.##.#.#
##..####.###.#....#..#..... . .. ............................................ ...........# #...##..#.#.##..#.#.##..#.#.#..#.............#.#........#.#
#..#...# ..#.##### .##.###########.######################################################...##.#.#.#.#.#.#.#.#...#.#.#.#.##.#.#.#.#.##.#...#.##.##.#.#
## ##.#..##.......#.#.. .......... ............. ......................... ...... .......#.#...#.#.#.#...#..##.###.#.#.#.#.. #.##.#.#.#.#.#.#.#..#.#.#
#...#.##.#.#.#####..##.#.##.###.##.#.#.###.###.#.####.##.##.#.#.###.##.##.##.#.## ##.#.#.#..##.#...#.#.##. #.......#...#..#.#.....#.#.#.#.#.#.#.#..#.#
##.#. ...#...#....#..#..## ##.###.#.#.#..#.#..#..#...#.#.#.## #.. .#.###.##.#. #.#.##.#.#..#...#.#.#.#.#.#.#.###.#.#.###.#..#####.#.#.#.....#..#.#.#.#
#...##.#.###.#.###..#..#....... ........##.##..#..## #.#.#....#.#.# .........#...........#..##.###.#.#.#.#.# #.##..#......#.....#.#.#.#.#.#.#.#....#.#
##.###.#...#......#..#..#####.##.#.##.#.....#.#..# #.# #.#####.#.#.# ########.###########..# ......#.#.#.#.#.....#..####.#. ####......#.#..##.####.#.#
#.. #.##.#.#.#.#.#..#..##...#...#.#..##.#.#.#..#...#.#.#............................... .#.#.#.###.#.#...#.#.##.##.#......#.#...#.#.#.#.#.#......#.#.#
##.#.....#.#.#.##.#..#.# .#.#.##..#.#....#.##.##.##....#.####.#.#.###.#.#.##.#.####.#.##.#..#.##.#.#.#.#.#.#.#.#...#####.##.#.##.#.#.## # ###.###.##.#
#...##.#.#.#.#....#.##..#.##.##.#.#.#.#.#.....#.. .#.#.#.....#.#.#...#.#..#..#.#..#.#..#.#.#.........#.##..#...###......................#............#
##.# ##.#.#.#.####..#..#............. ...####.##.##..#.#.####..#..##.#..#..#.#.#.#..#.#.##..#####.##.#.. #.#.#...#.#.#.##.##.#.#.##.#.#.#.#.#.##.##.##
#.................#..#..##.##.#.##.####.#......#.#.#.#.#.... #.#.#.....#..#..#....#.#.#....#.....###.#.###.#.#.#.#.##.##.#.##.#.##.#.#.#...#.#.#.#.#.#
##.###.#.####.##.#..#..#.#.. #.#.#.# ....##.#.#..#...#.#.#####.#.#.#.#..#..#.#.### .#.# ##.#.#.#.##..#.#...#.#.#.#......................#.#. #.#.#.#.#
#..#...#.#..#.#...#..#.#...###.#.#. #.#.##.#...#..##.#.#.#.....#.#.#.#.#.##.#.....#.##.#.#..#.##...#.#.###.#.#.##..##.#.####.#.### ##.##...#.#.#.#...#
##..## #.##.#.##.#..##.###.......#.#.##.....#.#..##..#.#.#.#.#.#.#.##........#.#.#. .....#.#.....##..#...#.#.#...#..# .##. .#.#..##.#.#.#.#.. .#.#.###
##.#...#....#..#..#.#. ..#.# #.#.#.#....#.##...#...#.#.#..#.##.#.#...#.######...#.#.##.#.#.#.#.#...#.#.#....##.###.#..#...##...#..#.#...#..###.#.#.#.#
#..#.#.#.###..##.##..#.##.#.#.#.#.#.###.###.# ##.##..#.#.#.....#.#.###...... #.#..#.#..##..##.#..##..#.#.#.#........#.#.#...#.#..##.#.###.#....#.#.#.#
##..##.#.#..#.#..#..##.#..................o ..... .#.#.#..####.#.#.# ..######...#.#..#.. #.....#...# #.#.#.#.#####.#...##.###..#....#.#...#.##.#.#.#.#
##.#...#..#.#..#.##.#...##.##.#.## ##.###.##.# #.##..#.#.#...#.#.#..##.......#.#..#.#..##..##.#..#...# #.#..#....#..#.#...#...##.##.#..##.#.#..#.#...#
#..####..#....#...#..#.#...#.##..#.#..#. #..#.##...#.#.#.###.#.#.#.#.#.###.#.#.##.#..#.#.# #.###.#.#.#.# #.#..#.#..#...##.#.#..... .#.#.#.#.##.#.#.###
##.....#..#.#..#.#..##..##.#.#..#...#.##.#.##.#..##..#.#.....#.#.#.#.#.#...#.# .....##.#. .#..##.#.#.#.#.#.##.##.# .#.#.#.##..#.###.#.#.#.#..#.#.....#
#. ##.#..#.##.#...#.#..#...#..#..#.#...#.#. ...#...#.#.#.##.#..#.#.#.#.####.#..##.# #...##.#.#...#.#.#.#.#.......#.##.#.....#.#.#..#..#.#.#.#..#.#.#.#
##..#.##.#.....#.#...#.#.#.#.#..##.##.##..#.# #..##..#.#.#.#.#.#.............#.# #...#.#.#.#.#.#.#.#.#.#.#.######. #..#.#.##. #.##.##.#.#.#..#.#..##.#
##.#...#..#.# #...#.#..##..#.##.#...#.#..#.#..##.#.#.#.#.#.....#.####.#.##.##.....#.##.#.#.#.# #.#.#.#.#.#...... # .#.......#.#..#. # #.#.#.#..#.#...#
#...####.#.#...# #..##...#.# ....# #...#.#..#..#.#...#.#..####.#....#..#.#.#.#.#.#..#..#.#.#.#.#.#.#.#.#.#.#.#.##..#.########.####.#.##.#.#..#.#.#.#.#
##.#.....#.##.##..#..#.###.#.##.#...#.##.#.#  #...##.#.#.#.....#.###.###.###.#..#.#..#.#.#.#.#.#.#.#.#.#.#.##.##.#......................#.#.##.#.#.#.#
#..#####.#.. .#..#..#..#...###.#.###..#.....#. #.#...#.#..##.#.#.............#.#....#..#.#.#.#.#.#.#.#.#.#...... #.## ##.#.##.#########.#.#.#..# #.#.#
##.....#..#.#..#..#..#..##..........#..#.#.##.#...##.#.#.##.#..#.##.#.###.#.#..##.#..# ..#.#.###.#.#.#.#.#.#.#.#.#.#.##.#.#.......... #...#..#.#.#.#.#
#..#.#.#.##.#.#..#..#..#...########.#.#........#.#...#.#.#...#.#.#.#.##.#..#.#..#.#.#..##..#.......#.#.##...# #.#..#.#..#.###.#.##.##.#.#.#### #.#.#.#
##..#.##.#.#...#..#.##..##.#.. .....#..#.##.#.#...## #.#..#.#..#.#......#.##.#.#.##..#.#.#.##.##.##..#...#.#. #..#.#..#.....#..##.#.### #......#.#.#.#
#..#..... ..#.#..#...# #.#.########.#.##.#.##..# #...#.#.#..##.#.#.#.##.#....#.#....#..#.#..##.#.#.#.# ##...#.#.##.#.##.####..# ...... .#.###.#..# #.#
##..#.##.##.#..#..#.#.. .#........#.#.#..#.#..##.###.##  .#..#.#.##.#.#.#.###...#.# .#. .#.#.....#...#.#.#.#.......#... ....#.#.##.##.#.#.#.#.##.#.#.#
#..#.#.#.#. #.#..#...#.###.#.##.#.#.# .#...##.#........#.#..#..#. #.#.#.#....#.#.#..#..##...####.###.#.#.#..#.##.#.#.#######.#.#.###.#.#..# #..#.#.# #
##.#... .##.#..#.##.##.#...###.#.#.#..#..#.....#.#.####...#.##.# ##.#.#.######.#..#..#.#.#.#.........#.#.#.#.##.##......... ............#.#...#..#.#.#
#..#.# #..#.#.##..#.#...##..........#.###.###.#...#....#.#....... .............#.#..#..#.#..###.#.##.#.#.#.#..... .##.##.##.########.###...##.##.#.#.#
##.##.#. #..#.#..##..#.#.# ##.#.#.#.#....... ..#.#..## #.##.# ##.#.##.#.#.#.##.#..#..#.#.#.##.##.#.#.#.# #..#.####..#.#.#...#......#.#..#.#....#.#.#.#
##.....#..#.#..#.#. ##.#...#.# #.##.#.##########. #.#.#...#.#.#.#.##.#.#.#.##..#.#..#....# .  .....#.# #.#.#.#...#.#..#..## .##.##.#..#.#..##.##.#.#.#
#..#.##. #.#..#...#.#...## #........#.#..........#.....#.#..#................#.#.##. #.#.#.#.##.###..#...#.#.#.##...#.#.#.. #.##.# #.#..#.#...#..#.#.#
##.#.#.#....#.##.#...#.#....#########.#.######.#..#.#.#...#.#.##.##.##.#.##.##.#..#.#..#.# ## ### ##.#=#.#.......#.#..#..##... ..#.#.##.#..##..#.#.#.#
#..###.#.##.#..#..#.#...##.#. ........#.#....#.#.##.##.#.#..#.#.##.##.#..#.##..#.#. .#.#.#..... ...#.#.#.#.##.##.#.##.#.#. .#####..#....#.# ..##.#.#.#
##.....#.#.##.#..#...#.#.#..#.####.##o#.#.###..#.......#..#.#.. .......#.... #.#.##.#..#.#.########..# #.#..#..#.#. #.#.#.#......#.#.###..#.#.#..#.#.#
#..#.#.# #.#..##..#.#....#.#.#......#.#..... #.#.#####.#.##.#.#.########.#####.#.....#.#.#.........#.#.#.#.#..# .#.#.##.##.#######.#....#..##..#.#.#.#
##..#.##....#..#.#...#.###.#.#####.##.#.######.#.....#.#.#..#.#.#........#... .####.#..#.#.# ###.##..# ##...#.##.#.... ............#.###..#...#..#.#.#
#..#.. ..#.#..#...#.#..#...#.......#....#. ....#.#.#.#.#..# #.#.#.#.#.##..#.##.......#.#.#.#.#.....#.#...#.#...#.#.##.#.#.##.##.##.#....#.#.#. #.#.#.#
######################################################################################################################################################
