########################################
# . .=  ## # ## #.# # #      . . .   #.#
# #.#.#..     ..# #.. # ## # # ## #.#  #
# ## ## #########.###.# ##.## # # ##.#.#
#.     ....  .    ... ... ..  ..       #
## ### ## # # ## # #.######## ## ###.###
#= #.###.#  #.#   # #  .    #  # #... .#
##. .  . .#.#% .# # #.# ### # # . # ##.#
#..## #.##  #.# . # # #  .# # .# #.#.#.#
##.# # .# # #o..# #.# #.##  #.#. # # # #
#  #  #.o #.#####.#.. #  .# #..# .  ...#
## # ## # #o..\   # # #.##  ###  # ## ##
## #    ##. #####.. # # . #.   # # #.# #
#. # ## ..#.#   . # # # ### ## .=# #.# #
##  # # ##  # ### # . ..   . = #.# #.#.#
# .## #.  #     # # # ### # ###..#.#.# #
## # ...# #.# ##  # ..   # #.  #.# ....#
##. #### #.# # ## # ###### ### #.#.### #
#  # .. o .. .. ...     .      ..# #.  #
########################################
