#####################################################################
#.... ...#.#...#.#.. ..#....#...#.#.#..  .#.#.#....#...#.....#.#.#..#
# ######.#.#.###.#####.####.##.##.#.####.## #.#.##..## #.#####.#.#.##
#. ........ ........ ................. ............#.....#.......#..#
#.##.##.#.####.#########.#.#.#.##.###.###.##.#.#.#..##.#.#.##.##.#.##
# ..#.#.#.#...# ..........#.#.#...#.###.##..#.#..#.#......# ##.#.#.##
#.###.#.# ..## .#.##.#### # #..#.#........#....#.# .# ##.#  .....#..#
# # ..#.###...# # #.#.. .#..#.#...#.## #.#..###..#.#.#.#..###.##.#.##
#.###.....#.##...##.####.##.#.##.#....#.#.#....# #.#.....##.##.#....#
#...#.#.#.....#.#.........#.#.....#.#.. #.#.#.#..#..####  .....#.####
#.##..##.##.##..###.##.####.####.##.# ###.#.# .#...#.....###.#.#.#. #
#.#.#.........#....... .... . ...#. #.#...#.###..# #.#.#.#.#.#.#..#.#
# . #.#.####.#..#.##.## ###.##.#. #.#.#.#.#....#.# ##..#.#.#.#.#.#..#
#.##..#.......# .##.#.#.#..#.##..#..#..##.#.##.#.#...#.#...# # # .#.#
#. .#.#.#.## #..#=..... .#.#...# .#.#.#...#.#. # ..##.##.##.#.##.##.#
#.## .#.#.##.##..# ##.#.#..# #.#.#..#.###.#.##.#.#............ .... #
###.#.#.#.......## #..#..#.# ##...#.... ..#..#.#.#.##.########.####.#
#.....#..## ###.#...#.#.#..# ..#.#..#.#####.#..#.#.#.........#.#. #.#
#####.#.#...#.#..#.#.# ..#.#.#.#..# #....  ..#.#.#.#.#.######...#.#.#
#.. ..#.#.###.#.#.....#.#..#.#.#.#...######.#....#.#.#.#.....#.#..#.#
#.#.#.#.#.......######.#.#.#.##...# #.......##.# #.#.#.##.#.##.##.###
##.##.###.#####..... ...... ...#.##.##.#.##. #.#.#... ..#.#.#... ...#
#.o.............##.##.#########..#.. #.#..#.#..#.#.###.#..#..#.#.##.#
##.####.#.###.#.#..#. #........#..# #.#.#....#.#.# # ...###.#..## #.#
#.#. .# .... .  ##.##.#.########.#...... .#.# .#.# ###.# ...##..#.###
#..#.#..#.#.#.#..#....#...........#.# #.# #..#.#.#.... .#.#....##...#
#.##.###.#.#.## # #.##.#########.##.##.#.##.#.#.##.###.#=.#.##.#..###
#.... ............... .... . ... ....... ......o...#.. .###..#. #...#
#.##.#.##.####.# #.#.#.####.###.#.# ####.# ##.# ##.#.#.#....#..##.###
# #.#... # . .# #.#.#.#...#.#.##....#. .#..#.#.# #..##.####.##......#
#.#.#.#.#..###..#.....#.#.. #. #.###..##..# .#.#.#.#...........######
#.#.#.#..#. ..#..#.##.#.#.#...#.....#...#..#.# #.#..##.#.#.###.#....#
#.#.#.#.##.####.#......##..##.##.#.#..#.#.##.\.#.#.#.##.#.##.# ####.#
#.#..............##.#.#...# #..=..#.# ..#.#..##..#........ .........#
#..#.#.###.##.#.#.##...##.....##.#....##. .#.. # #.##.#####.#.##.##.#
#.#.#.##.#.#.##.... #.# ..###..#..###.. #.##.## .#.#.# ......#....#.#
#.#......#.#.. .##.#..###.#. .##.##.# ##.......# #.#..######.#.##.#.#
#.#.######.# ##. .#.#...#.###. .........#.#.# ##.#.#.#....... ......#
#.#...........#.#.#.#.## ...#.##.#.#.##....#.#...#.#..#.######.#.##.#
#..###.### ## #.#...#.. #.###.#.#.# ##.## ##.###.#.#.##.#....#.#..#.#
#.#..#.#. .#..#.#.#.#.#.#.#..... ... ....  ........#.#.## ####.#.#..#
# .#.##.###.### #.#.#.###.#.#.#.#.#.##.#.##.##.#.#.#.#.........#..#.#
#.#............. .........#.#.##.#..#...#.##.#.#...#..#.## #.#.#.#. #
#..####.###.#.##.########.#.#..#.##.####.. ....#.#.#.##.#.#.#.#.##.##
# #... .....# .#......  #.#.#.#...... ..#.####.#.#. ......... ......#
#..####.####.## .##.## ## #.#..####.###.#.#....#.#.#.#.##.##.#.#.##.#
#.#...#........#.#...# # ...#.# ... #.....#.##.#.#.# ...#.#.#.#.##.##
#.###.#########.#.###.#.#.##.#.#####.####.###.##.#..### #..... . ...#
#...... ...  ........... ......... ..............#.#......###.#.#####
#.# ##.##.####.###.###.##.#.##.#.###.#### ###.#.##..#.#.#...# #.#...#
#.#.##.# #....#..  #.#..#.#.#..#..  #.. #.#..#.#.. #.#..#.##.#..#.#.#
#.#. .....#.# .#.#....#.#.#..## ###.#.#.....#...##.#..#.#.....#.#.###
#.#.####.#.##.#.##.#.#..#.#.#.......#...# #.##.#.#.#.#..#.###...#...#
#.#.#....#....#.. .##.#.# #.###.###.#.##.....  ....#.##.#.... #.#.#.#
#.#..###...##.#.## ...#.#..... ....... .# #.###.##......#.#.##..#.#.#
# #.#....##.#.###.####..#.#.#.#.#.#.##.#..#.#.# #. #.#.#..#...#...#.#
#.# .#.#..............# ##.#.#.#.#.##.#.# #...#..#.# #..#..####.#.#.#
#.#.#  #.#.#.###.##.##..................#.####.##..#.#.#..#.....#.###
#.# .###.#..##.#.#.##.#.##.#.##.#.#.##.#.........#...#..#..#.##. ...#
#.#.#....#.#  ...#....#.# #.##.#.#.# ##.#.# #.#.#..# # #..##..# #.#.#
#.# #.##.#..##.#.# ##.#.#.. ............#.##.##.##.#.#..# #..##.#.#.#
#.#.#.#..#.#...#.#..# #.#.#.##.##.###.#.#........#.#.#.#...#.#..#.#.#
#.#.##.#.#.###.#. ###.#.#.##  . ###.##.##.## ##### #.#.##.#.%##.# #.#
#. #.....#...#.#.#.o..#o#.. .#.#  . ......#.#.  ...#.#  #. #..# #.#.#
#.#.####.####.#.#.###.#.#.###.#.####### ###.##.###.###.##.#.## #.#.##
###............... ......... ..... ...... ........ . .. . ........ .#
# ..#.######.##=# #.##.#############.# # #####.# ##### #.###.#.#.##.#
#.#.#....  . #..#. ....#.. ......... ....... ... ....#.#...#.#.#..#.#
#####################################################################
