#############################
#  .# #   # . # .#.#.# #.   #
# ### ###.# ### ## # #.# ## #
#    ..   ..  .  . # # # # ##
### #### ## ### ## # # #   .#
#.##..  #= #  #  # # # # # ##
#    ###..#  #. #. #.#  .# ##
##.# #  #.##  #.##.# # # # .#
#..# ## # .# #.  #.#.###.####
## #  # #.#..o# # .         #
#  #.# .#.##.#. .#.###.##.# #
## #.## #  #. # # .# #. # # #
#  #  # # #. # ..# #.# # =#.#
## #.#.=#. #  # ## # # .### #
#  #. #.# #  ##.# .# # #  . #
####.## # ##o# . #.#o# .###.#
#        .    # #  ..# #  ..#
# #.# #.# ##.##.## #.#  # #.#
##.# # # # # #  .#.# # #  #.#
#  .o.    . .## ## # #  #.# #
#.#.##.### # .# . #. #.##.# #
##.#.# . # #.##.# .# # #. # #
#..  #.##  # #   ##%##  #.# #
## ##.## ### ##.#  ... ##.#.#
#      .   . .. # ## # #. #.#
########.# #\##.###.# ..# # #
#   .    #.#  #  ..  #.# .# #
## ##.## # #.# .#.#.#  .#=#.#
#############################
