#################################
#  # #  #  #.##.# # #  . ## # # #
##.   .## #.. .  .#. # # %  #.#.#
## ###.   .#.####.#o## #.## #.. #
#...   ## #..  . .# # ##.#. # ###
#### # #.#.# # ####. ..   #.#.# #
#   .o    . . ... ..####### #. .#
##.## #.#### # ####.#  . =..#.# #
#.# ###.# . # #.. #=.#.## # #.###
#    =  ###.#  ## # # #   # #.  #
## #.## . . #.# #.# # ##.## # ###
#  .# .# #.#.  .#.#.#.  .  .# #.#
##### #.#.# #.#o..#  ###### #.# #
#.  . ..  .  .### #.#   .. .# # #
###.## ##.# # .  ..o # #.## #.# #
# ## ## #.##.######.# # # # # # #
#..  .   ....  .  #.#.....  # #.#
#.# ##### # ## ##.# ####### #.#.#
#.#.# ..# #.#.## #. .     .  . .#
#. ##.###.#.#.#   # # ##.##.# #.#
#.# .    .# # ##.#.  #.## #.#.#.#
# .#.##.# #.#. .. #=# .  . .# #.#
# #  .### #.####.# ..#### ### # #
# .# # . .# .   ..# #       . ###
#.#..#### # # ### # ####### #.  #
#. #    #.# # # #.#.   . .#..## #
#.## ##\# # #.#   # #.##.#. #  ##
# #   # # #.### ## # ## #.# .#.##
#..# #.#  # ..   ..  ..  .#.#. .#
# ## . .#.#.########.#.#.#  .#.##
#.#. #### . .... ..# # #.##.##.##
#. #.#. ..# # #.## # #.#.   . ..#
#################################
