#####################################################################################################################################
#    # ##  #  #.#.#.## #     .  #.# #. .#   # #  # #     #  ..   #  # ## ## # #  .     . .    #   .  .#       . =.    #   #  .      #
# #.#    # # #  .   .   #.## #.# .    #.#.### ## # #####.# #### #  #    . .     # ## ## # # #.## #### # # ## ##### ##.  ##  ##.## # #
#.# .#.## .#   #### ##### #  #.######...       .         .     ..#  #.###### #### # # # ## ## .  ..    .              #.#.# #  # #  #
# #.#.   #.# #      .      # #..      # ## ## # ## ## #.#.# # # # .#  #            .   .      # # ## ## # # #.# ### ##  # #. # #  # #
# #.##.# #.# ###### ##### ## #.##.# ##  #.. # #  #  .# #  # ### ##  #  # ####### # ##### # ## #.### # ##.# . # #. # # #.#.# #. # #  #
# #  # #.#.#      .              .  o #.# # ..## # #   ##    . . # # .#   .. . .# #.. ..# #.# #  ..       # # .  #  #     # ##.# .#.#
# #.# .# # # # ##.## #### ### # ##.# #  #.# # .# # # #  # # # # #  .#  # ## #.# # # ## # . .  ####### # ## # # # #.#.## # #    # #. #
# #.##   ..    .#  #    #   #  ## # # # # # #.#  #.# #.#  ##.# # # #  #  . ##  .#     . # # #  .     .   .       .    . ### ## #.##.#
#. . #.### # # #. #  ### ## ..#         # #.#  #.# . #. # .  ... #  #  # #   .#   ## #.#  #.  ##.## # ## #.# # # ##=# #        .    #
### ## ..###.#.##  #   .   .# #.## #.## .  .# ## # ##  # .### ### .#  #.# ### # #.# ## ## # ##.## ## # ## #.# # ##.#.#. ###### # ####
#   ...#  .  #  # #  ## # # #   #   =#  # # # #  .  .#  #   # #  #  # ..       .   .    .     .    .         .      . # #.   .#.  . #
##.### ##.## # # ## #.##.# # # # ####.# ### # # ###### ## # ### ##.## ####### ###### ####.############.# ######.####### # # # #.# ###
#        .                 ....          .             .    .     .        .. ..    ..   .        .    .           .      ### # #.# #
# #.#.# # # #.### # ##.##.# # ## #### ## #.##.# ##.# #.# # # ## ## #.# # ## ## # ## ##.## #.# ##.# # # ## # ##.# #.#.##.# .       # #
## # #.# #.   ..#. # #    # # #       . # # ## ##.#.## ## # # ### # # # ## ## #.## ##.## # # # ##.# ## ## # # ## ## # # ##### ### # #
#    .    .## # #.#  # #.#. #.# ##### # .   .   .     .  . . .  .  ...         . .         . .    .. .   .       ..   . .       . . #
## ## #.##  # ##.# # # #..# #.   .. #  # ##### # # # # ### ###### ##### ## ### ## # ############.####.# # # ## # ##### #### ##### # #
#.#  # #.# #. . . .    . ## ### ####. #. #     ##  #.  . #.#        . .. # #.    # # ..  .     . .   .# #.#.# #  #   .#.   .      # #
#  # #   #.######## ## #    .       #  # # #.#   # # # #  .## ###.#.## # #  ## # # ###########.## ### # # #..  # # ## # # #.### # # #
# #    # #    .  .   # # ##.# #.# ##  #. # #. .# . #   # #.. ..    #.# ..#.#..  .. .   .   .        #.# #   # ## # # #   ....  .    #
# ## #.### #### ##### ## # # # # #.##.##.# ## # ## #.# # # # # #####.# # #  # # ## ## ### # #.#### #. # # #      .   .# #.# #.#### ##
#             .                 .   . .    .       ##  . #.     ..     #.# #     .  # #        .    # #.# ###### #####  ..# #  . # ##
##.## ## ## ## ## #.## ## ### # ## # ## # # ##.###.  # ##  #### ## #.##  . ## # ## #    # ##.# ### # .# #  ..  . .    #.#.#   ## #  #
# # # #.#. #. # # #    #   .# # # # . ### . . #. ..# # # #.#  . # # ## # # .     .. # #.. # .    . ## # # ##.###### ### ## #.# # #.##
#    .  ## # #   .# ## #.#.# .# #  #.# .  #.# ## # # # #.#  ###.           # ### #.##.#### ##.# # # # #        .  .             .   #
# # # #  # #  ### # #    .  # #.# #.. # # #.#.  .# # #   # #. # # # # ## #           =    .         # # # ## ## # # #.# # # ## # # ##
## .# # #  # #    #  ## ## #. .   .#.# .#.# #.## # ### ### # #  #   #.#  # ### ###.#.## #.## ##.# ##  # # # #. # ..# # # #.## # # # #
#  #  # ##   # ##.# #   . .## # # #. # ## # # # # ..   #  .# ## # # ## # #.# ###=## ## # # ##.## ##.###    . #  # #..      .   ..   #
##  # #.   #.## #     ## #.        #.#      # #  # # #.### # . .         . .  .      . .   . .      ..  # ## #.##..# ##.#.## # # #.##
# .#..# ## #    . # ## #.# ###### ##  #.#.#     #  # #   # # # #.## ####.## # # ## ### ## ### #### ## #   # ##.# #.  # ## .# #. .## #
##  # .. . . # # ##          ..    . # #.## #.#  #   # # #  #  ##.#   .     # # .# #      .        # #  #.      .. # #.  .#   .#    #
# .#  #### # #.#   .##.#### # ## # #   .. . # # # .#   # # ##.# . #### ### ## # #  # # #.## ## ## ##  # # ## #.#.#  ..# # ## ## # ###
## ## #. # # # # ## # .   ...    # #.# # ##.# # ## ### .##.     #     .     . #  #   # #  . .# #  # .#   . ..#..  .#.# #      .     #
##  # # # #  ##.  #   #### ### #  ##.#.## ##  # .    #.#.  # # #. #.## ##.## #  #  #  .# ##.##  #  #  #.# ##.# ## #     # # # ## # ##
#  #. . . .#   # #  #  .    .   .#.  #    . #   ## ## # ## ## #.# ## ### # ## ## ## #.#.## ## ## ### ## ## ### # # #.### # # ## ## ##
##  # ### #  # #. #  ##.# ##.#.# . # # # ## # #     ... .                       .  ... .o.      .   .    .            ..   .    .. .#
# .#  . #  #. ## #  # ## #.## # #.# # # ## ##.############# #####.### # ### ## ############## ######### ### # # ## #### ## ## # ### #
##..#.# # #. # . ##     .        .  . . .         .  .      . .   .  ..     ..  .   .           . . . .   ##.#.#  #    #  #   . . # #
#  #.  ..  # ###. # ### # # ###.# #### ######.####.## ##.#.##.# ### ### #.## #.## ##.## ### ### # # ####.#. .   # .# #. # ##.# ## #.#
##  # ### #  . # #  #. # #....   .#. #.  .  =#.  # #.#.## # ### #. ## ##.##.# ##.## # ### .  .   # .#    # #.# #..#. # #       .    #
#  #. #.  ## #.  .#..#.# ## # #.## # #### ####.##    .      .   .# # .  .     .    .#     # ## # ##.# ##. # ##  #. # #.####### ##.###
## .# # #    ### # .## #.     # .    . .      .  # ### ## ## # # # # # # ######## # . #####.#  #  . #  # #   . #..#..          .   .#
#  ## #.#.##   # ## #  ## # ##..## ## #####.###.#..#..  ..# # # .#  # ##  ..  .   # # #      #  # # # ##  #### .# .# ### ## ##.### ##
## #  # #  # # #. # .#. .    .# # . ..#.  .  .   # ## ###.# # ## # #     ## ##### # ..  ###.#. #.## #.#  #    .# .## #.# # . #    #.#
#  .# # ###  #  .#  #  ## ## ##  #.##  #### ### #    . .. #  . # # #.###.#      .   # # # #  #      .  # # # #..#   .\  ## #.# #### #
## ##... . #   #. #  #.# .      ## #. #  .    #  # ####.### ### ## # #.# ########## #    .# #..## #.#.# . ##.#.#  ### #.#       .   #
#  #  #.## # #. .##.# .#.# ##.#    .#.# ### #.#.## #      .    . ..# ..    ..     . # # #.#  #.# # # #.# #.  . ##  .#.# #.## # ## # #
## ## #..# #. .# #..##.## #.# # ##.##.#.# # # # #. ############### ########.#####.#    # ## #      .    .. #.# .. # # # #  # # ## # #
#   # # #  # #.#  #  .   ...#..  # .  ... #. .# .# .   ..       .              .  # # #       ## ## ## # #  #. # # . .# #.#.  #   # #
##.## ## ### # # # .##.##### # # # ######## # # # # ##### ############## ##########.# #####.### ## ## ## ## ## ## ### # # ### #.### #
#         ...# #  #   . ..      .      . .  .       .  .    .  .      .     ..       ..   .          .       . .  ..      . .  .. . #
## ## ###### ##.##.### #### ########## # # #### ## ##.## # ## # # # ## ######## ######## # # ## # # ##### # ##.## # ## # # ##.### ###
#       . .   .    .     .      ..    #.# #   #.#.## #.#  #  .. ##  # #.        ...  . .# #  # #  ##   . # #.   #.. # # #  .  # #  .#
## #.###.# # ## # # ## # ## ## ## ###  .. # ###. .  .. # # .# # .  #   # # ### #.# ## # #.## #  #    ## # . ## #  # # # # ###. .# ###
##.#. .#  # # ## # ## ##.## # # ### # ### # # . ###### # ## # #### ## ## ### ## #.## # ## .  # #  ## #  ## #  . #.#   # #   #.# # # #
#   .##. #       ..  .  .  ..  .. .   # # # # # # .  ..    .          .       ..  .. . .  # #.  #  #..#   . ##.#  # #     # # # # # #
###.# ### ####### #.# #### # # #.####.# #.  #     # ## ## # # ##.### ####### # #######.##. # # # # #.#. ## ## # # # # # #  .#  .#.  #
#.      . .       .  .   ... . ..     .   #.# # #  # # #  # ## #   #.#      # #   .    .# #          ##  #  ..  #.#   # # # # # #.###
####### ## #.# ## ## # # # ## ##.###### #.# #.#  # #    #.#..    ##. #.# #### ##.## ### #  # ###.# #  # ## #.###  #.# # #.#.  #   . #
#      .              # # #  .# #.    .#  # #.# #.  .# ## # ## # #.#.  ##.   .  .   .   . # ## #.###.#  #  #   .#.# #.# ..# # # # #.#
# # # ## # #.## #.# #.# .   # # # ## #. #.# # #.# ## # #  #.    .  # #    ##.######## ###   ..  .    .#.##  #.#.###  ## # # #.# # # #
#.# # # # # .# ## # #. # ## #   .  . # ##       ## #.# ###.# ### ## ## # # # #  .  .    #.###### ### # # #.#        #   # #=#   # . #
# .##.#  . #.#    #.# # # #.##### ## #.# .#####           .  .. .            . ## # #.#.#.#     .  .  .  .  ## ## #.#.#   # #.#  .# #
##.#.## #.## #### #.#.#  .     .        # .  ..#.#.# #.## ### ## # # ### ####.#.###.## #  # # ## # # ## ## #   #  # #   # # #  .#.###
#    .    ...      .#  # ## ##.# # # # #. # # # #.   # # #  # . # # ##      # .    . .  # # #. #.#  #. # .  #.## ##  .# # # # # #   #
# ###.######## ###### ## ## #.# # #.## ## #.# # ## ###.#. # # ### . . # ## ## ##.#.###.# .# # #  #.#  #. #.#       .# #     #.#.# # #
# .    .  . ...        .       ..          .   . #  .  #.#.    . .####. #   .  # # #  #.# ## #.#.## # ## #. ####### . # # # #..   #.#
# ### ##.#### # ##.####### ## #.################ # # # # # ##.### #  .#  #.## #  #  # # #.          .   .#.#. .     #.# # #.# # # #.#
# #  ##  #  ##.#. # .  .. #.# #.   .   .. ..      .# #   #.#  . # # ### # .# .#### ## # # #.#.#### ##o# #   # # # #.# #    ##  .# ###
#  #   # ## . ..#..##.### #  .  ### ##### #.# # ##. .. # #  #.# # # #    #. #    . #    # .#.#  .  #   # # # ## ### # . # #   #. .  #
# #..## ..# # # # # #. .#.# # #  .        # # # .  # # #.#.#  # # # #.# ## ##.## #.# ## # # . # ## . #    .#      ..#.# # # ##.######
#  # . #.#. #   #  .# # #.  #  # # ###### # # # ##   ### #  #.# #    .#.     .# ##.##.# #  #.#  #  #  .###.# # ## #.   .           .#
# #  # #  #.# #.  ## ## . # # #  #  ..  #.#...# #  #      ## # ## # ### ## ##    . .  ..  ##  # .#.#.# #      # # . #.# #### ### #.##
#..# # #.# .# # #      .# # # ### #.###.# ## #.. # ###.# #   .          # #.# ###.####### #  #. #    #.# #.#.#    # #       # .# # ##
# #. #   .#  .  # # ### . # #        .  . ..  #.#   .# #.# ####.####### # # # #  ..     . ##  ## # # #.#   #.##.###   ### # ##.# .  #
#  # ###.#  ## #  # # # # # ### #### ## # #.###  # #   . # #... .   . .     # # # # # # #. # #    .#  . .# #  # # ..#.         . ####
#.#.   #= # #   # #   .  .#           #  #      #.  .#.# #  ## #.# ####.###.# #.## # #  . ##.# # #.# #.##  # #  # # # #.#### #.#   .#
#  # ##..#   # ## #.# # #.# # ## # ## # ## ####  # #   #.# #  # .# #  # #..  .#.%.    # #.  ..  ## #.o. .#.#  # # # #        #.#.## #
# #  #.# .#.#  .  # ## #     .         .        # .#.#.# # # ## #..#.#  #.### #.######  # # ##.#   # #.#  .  #  # # #.#.## # # # .  #
#. #  . .#    # #.   .. # # ###.# # # # #######  # # #   # #    ##.   #.### # #     . #   #.   # #  .#   # #..# ### #  #   #  .. #.##
# ## # #  # #. #. # # # #  .#     # ## . .  .   #  #.. #   #.##  # ##      . .# ### ## ## ### # ##.### ###.###     .#.## # #.### #  #
#.   ..# #   # .#  # # ## # .## # #    # #.#.##. # ###.#.#.#  # # . ..# #####  ..    ... .  . .   .   .....   #.# #. .    ##  .# # ##
# ## #  . #.#  #  #       #.# ### ## # # # ## #.##       # # ##.##.##.  .    .## ## # ## ##.# ## ## ###########.##  #.####   # #   .#
#  # # # ## ##.##   ## ## #.#.     .    .   . #.#  # # #.#.#.        .# # ###.# # ### #.#    # .# .     .    ..   # #    . #     ####
# #  # #   ..     #     #  .. #.# # # #.## ##.   # #.  #..# ###########.### #.   ...  #  # #  # ..# #.### ######.#  . ## ##  # # .  #
# .# # #.#.######.  ##### # # ##.##.# # ##.#.## # ...#   #      ...        .  # ######  ## # ## ## #  ..   ...    # # # # ## . # ## #
# #.   # #     .# #  . .            .     .  .#  #.#.#.#.#.# #.## ##### ### #      .  #.. .   .      #.## ###.## #.   #. . ..# # # ##
#. # #.# #.## ##  ####### ### ####### ###### #  #    #.# # #  .. ..   #     . ##### #  .#### ####### #. # #    # .# # #=## # #     .#
#.#. . # #..#. .#.      .     .    .  ..    . #.##.#.# # # # #.## # # #.# ###.  ..   .#. .  .  .   . . # ## ## #.#  # . ## # .##.####
# .#.#.  # #  # # ### ### #### #.#.### ## ## ##  # # # # ## #.# ## # # # ## #.## # ## #.### ##### ## #.      ..# ## #.#     .#.#..  #
#.##. .#.#.### #. # #  .  # .  #.# #   #        # .#.      .  .. . .  .     #  # ##.### # . #.   ..  # ######.#. .#.# # #### #   # ##
#.   # #    .. .#    # ## # # # .#.#.# ## ### #..# . # # ### ##.#### # # # #  #  ...     ## ##.## ## # #      ## #..# #   .  # #   .#
# ## #   ######## # #  #  # #  # # # #  .     #.#  # # #  .# #    .  ##.   .# . ## # ## #.   ...     #. #.###   . # #  .## #..   ## #
# # .  # #    .   # .#  # # ..#..#.  . # # ## #  #. ## # #.#  # #.##  # ##.##.# ## ##.# ### ###### ###.# ## ## ####.# # ## ## ## ##.#
# ## ## # ####### ## # #=## # ###.### # ## ##.#.## #   # # # # #.. # #  # ##.     . .           . .   .   ..                       .#
#            . .  . .  ..    ....   =  .. .        #.#. .#   .  # #  ## . . # # ## # ##### ## ##.#.## ## ######.###.# #.###.#.# # ###
##############.#####.#### ########### ##### #.#### ## ##.## #### # ## # ##### # # .# #..     ## # # ## ##. .  #.# . #.#.  #  #.#.# .#
#.      . .    .. .. ..    .       .     .             ...       .       ....    #.# # ######   . #    .#.## #. #.# #  # # .#  .   ##
##.# # ### ## #.## # # ### #.# ## #.# # # ## ##.#.### ### ### ## # # ## ## ## # ##   #.   ...# ## # #.##  .#  #.# #.#.#  ##  # # # ##
# ## #       #.# ## # ##.## # # #.  . # #   .# # #  # # # #  # # ##.#.#.#     # #  ###.###### .   #.# # # #  #   . .# .#. #.#  # # .#
#  .. #.## ##  . .   .  .     # # #### .# ##.#   # #  # # # #  . ..       #.#   .# .    .  . # ## # # #   ## .# #.#.# #  #    # ## ##
## #.#. ..   #.# ## ###### ## # .     # # # .# # # .# # #.#  # # ## # # ##  # # #  # ##.#.##.#     .#  ##   .#   .#.  ##  # #     .##
#  #..# ## # #   #  #..   #.# # ##.## # # ## # #.  # .#.# # ##.# #.#.## #.# # # ##.#.# # # # # ## # # #  .##.## #. .#. # #   # # #  #
# # ### ## ##  #  # # # #.#   # # # ## ##..#    .#..#.# #   .  #  ..  . .   # #     .  . # #.   # # #.# # #   # # #.# #.  # #. #.# ##
#  .. .     .#   ## ## ## #.# # # .   .   # .##### ##.#.######.#.#.### #####  #.#.# ###### #### # #.## ## ## # # ## # ## #  .#  #   #
###.# # ## # # #.  ..    .  #.   # ## # # ## .    .   . . ...      .     .  # . .               .     . .. .      ..     .# #  #  ###
#   # #  # ##. #.######## #.### # # ##..#..#.### # # ###.# # ##.## #.## # ### ##.########## ########### ## ### ####### ### # ## # # #
# #.# # # .. # . . .. .     . . # #    # .#     #.#      # ### #   # # ##. . .  .      ..        . . .   .        . . ..            #
## # ## .# #.# ### #.#.## ##### #  ###.## ## #.#.  # # # .   .  .#  .     # # ##.## ### # ## # ## ## ############## ## ## #.# # # ###
#       # .#.#    #  ##   ..  # #.#  #..#.   # ##.# # # ##### #### # ## ### # .## # #     .  .        .       .     .. .# # # . .   #
# ### # ##   # ##  #    ## #.#  #=.#  .# .##  .    ..      ..         ..  ..# #.   ..####### # # ### ###.########### ##.# # # ## #=##
# #   # .#.# # .# ##.## #  #  # # #. #  # .# #.## # #.##### # # ## #.###.# #  # ### #        . .     .  ..  .          .   .  .  .. #
#.# ### #.##.# ## #.# # ####.## # ## # ##.#    # .  # #  . # ## # ##   ## #.#     # ###.## ## # # #.## # ## # ### # # ###.## ########
#        ..    ..    . .   .       .. .  . # ## # # ### ###. #  # . .#    # # # ##    # .# # # # ## ## ## ###  . .# #   #  # ...   .#
###### ### # # #### ##.# ## # #.# # ### # #.    .          #  #  .##.  ## # # #.  # #.#.#...   .  . . .   . .# ##.  # # # #. ## #.# #
# .           .   #  ## ## # #.##.# # ###.## ##### # ####.## # # # # #    ..#.# # #.     # # #### ##### ##.##  # #### ##   #     .#.#
## #.# ## #.## ##   #     .   .   # .      # #     ..   . .        .  # ### #.# #  .#.# ##  .#    #   # #    #    .     # #  #.### ##
# # # #.## # # ## # .##.# ## ####  # ## # #   # # ## #####.## ###### # ## # # #  .# ##  #..# .# #   #    # #   # # ##.##  ##.       #
#  . .  ..         .# ### .    .# #     .  # # #     . . . . ..   .        .#.#.###.. # .#.  ## # # ### #    # #  ###.# #. . ### # ##
## # ## # #### #### #..  ## ## #    ## ##.##. . .# ##.# ##.##.# ## # # ##### .#.#   ### ## # # .  #   . ## #.   # ##.   # ## #   #. #
# # # # #  .      # # ####.## # # #  .       ### ## ## ## #.## # # #     ...# #..##.#    ..#  # # .# ##  #  ##.#    # ##   # ## ## ##
#.#.# ## # ###.## # #.#   .#. . #.#.### # ##.#   .     .     .  .    # #####  #.# # ### ## ### ## # # #### # # ## ## # ## #  ..    .#
#     .   . . .## # # # ## ####.#   . . #  #  ##### ##.##.##.# #.# #        # # #   . .  .  . .        ....  . . .     .#  # ###.#.##
##.####### # #  .  .#.#  . ..   # ### # # ## #.   . ## # # #  #    # # # ##. .#   # ### ## # # # # ### # #.# #.# # ## ##  #. #  .. .#
# # .    ### # ## #.# # ## #### #   #   # #  # ## #     .  # ##.## #.# #    # # # #.#   #    .# #  # #.# # ## #.# #.##. #  #.#### ###
#  ## ##.  .    # #.      .  . .# # # # #  #  # ## ### ### # #. #  # #  #.### ## #.# #.##.# #    #.#.# #.#.    .    ..#.# # .       #
# # ## # # ### #  # ##.# ##.# ##.   # # # #  #. . . .  ..  ..## ###.  .#  .                 # # #  #.#  .# ## ##.#.# # .#..# ###### #
# ..   .     .  #.  # # .# ##   #.# # . #  #  # ###.### ####   ..  # #.###### # # # ###.##.#. #  # # # #.## # # # # # # # # .  ..  .#
## ###.##.## #.#..#.#  #.#  . #  .# # # #.#  #             . ## # #  #.  .  # .# # #..  . . # #.# ##.###  ..    ..  ..  # .# ### ####
##  .# # # ### ##.# # ##   ##   # ..# #.# ## .# ## # ## ## # #  # .#.# #### # ## # ### # #.#=.    .      ### ### ### ###. ## # .   .#
#  #.  #.     . #.# #.   #.   #.# #.#.#.#  # #  # .#  #  #.#  # #.#..#.   # #  .   . .  .   ## ## # ##.#    .. .  .     # #    # ## #
#####################################################################################################################################
