####################################
#.# # # #.# #.#  #.## ## ## # # # ##
#  .    . . . .# .    .  %    . o  #
# # ##.# #.##.#  ## # #.#.#.#.# # ##
# .  # # ## #. # .    # #. ..      #
# #.# .       #  # # ##  .#\# # # ##
#   ##.#.## # ##        #   # #   ##
# #  #   # ##  # # ##.#.# #.    #  #
#.  # .#.     # o. .        #=# #.##
# # ## #.#### ## ## ## ## # #   .  #
# . .   .   . .   .   ..  # # # # ##
# # ### # ## # #.# #.# #.# .#  .   #
# ### #   # ##     ..   ..#   # # ##
#.    . #  .  o#.## ##.## # # # #  #
# ## ##   #.# ## ...   o     =    ##
# ## ## #   ...  ## # # # # # # #  #
#.     .#.#.# ## ## # ### #.#  .# ##
### # # #...   .            . ###..#
#       # # #### ##.##.##=# #   # ##
# # # # .      .   . . .   .  # # ##
#.# ## # # # # # #.# ## #.#.# .    #
#     .          # #     .. # ##.# #
#.# #.#.## #.#.#.    ## # # . .   .#
#      .  .  .  .# #.##.# # # ## # #
# # # ##.# ### #. . .  .    . .   .#
##    ##.# =   . ###.# #.# ## ## # #
#  ##      # # # #    .   .  . #   #
## .. ## # # # #  # ## # # ## #  # #
#. ##           .# #.## #.#    #. .#
##   .## # # # #. .    .  ..# #  # #
##.##. # # #.# # # ## ### # # ## # #
#. . .#  #           .        .  . #
##=##.## # # #.#.# # # ###.## ##.# #
##.##..  . #.  # ## ##    ..   #   #
#    .## #   #  .     .# ## # # .# #
####################################
