##############################################
#...#.. ..   ## # # #.# #.# # #   ..# ##. ...#
###.#.#.# ##  .    ....   #. . .#.#      ### #
#.# ## # #.  #.#### #.# # ##.## ### #### #.###
#.  .o   .##.# #. ## #.#   .  .    ..    ..  #
### ## # #.#  . # .     # #o###.## ###########
# # # ## #.#.# ## ###.##    ..     .  .   .  #
# . #..  # # #  .  .   .# ##.## #.#.## ##### #
### #### #.#.# ##### ## # #    .#.#. #.    ..#
# #     .# . # #..  .# #. # ## #.# ##.######.#
#.# #### ##.##  #.## . .# #       .      . . #
#  .       . . # #. .##.#. ## # ##.## #.# # ##
# # ##.# #.#.#.# ###. #.# #..#.# .# ## # ##. #
## ## #.#.# ##  ...# ##.   #.# # ##  .. .   ##
# . .    ....  ####. # o#=# .  # #  # ### #.##
##.# ## ##.### #  .#. # #. # #=. .# #  ...#  #
#  .# #..# #   ## ##.## # # .# ##.# .#.#### ##
## #  # #  ..#...  .   .# .#.# #    #     .  #
##.## # .# ##..## ## ##.#.#  #  # #.#.##.## ##
#     #.#  ..#.###.# #.... # . ## # .# ## # .#
## # #...# # #. ## #. # # #  # .    #..  ...##
#  ## #.#  ## .#.  . #..#..# # ##.#. ## # # ##
## . .#  #  .#.#.# # .#.#.#  #..### ##.#.## .#
#.# # #.## ###%##. #.##.#  # # #..   .. .  .##
# .... ..     .  #.#  .## #... #.#.## ###.####
## ## # #.##.#.## # .# .  ## # # # #    # #.##
#.#.## ##   .  .  .# ##.# .  # # #  # ## ... #
#. ..    .##.# #.# .. # #.###  #.# #.   # # ##
# # ## ## #. ..#.  #.# .     #.# #.## ##  ## #
# .#   # .##.# #.# # #.## #.#..#.#.     # .  #
##. #.###. #   # # # #. # # .# # #.##### .# ##
#..#=# ## #. #=# .## # #..# #  #.#. ... #  # #
## . . .   # #.# #.  # ## # ##.##.###### ###.#
## ## ### ## # ...## #  # #..#.=  . ....   ..#
# . #.  # #  # # #   # #  # #. # #.### #.# # #
##.#  #.# .# #.#.. # #.##.# .# #.##  #  #.## #
# ..# #.# # .# # #. .#  #.#.## #... ##.#  .  #
##.## # #  # # # . #.#.## # #  #.##.#.# #.##.#
# .  . . \#. #.# ###.# ...# .#.# #   .   . #.#
###.# # #. #.# # .. .#.## #.#     # ## # #. =#
#   #.  # ## ##.######.## ## #.####.#.#.# # ##
# # # #.  #... .    .  . . .... ..     . .. .#
#.## # ##  #.## ## # #.##.# # ### #.### # ####
# ..    ..# ##.# ##o# # ## ##.#.    #.#.#    #
## # # ##   ..      ...        ##.#   #   ##.#
##############################################
