################################################################################################
##.#.# # # #...# #.. ..#...  ....  . ...#.#.#.#.# #  .# # ... . # #...  # .#.#...  . . .# #. # #
#... .    .#.# #  #.##  # ##.## ##.# #.#.    ..  ..## # #### ##   # ##### ## ##### #### # ## # #
# #.## ###.# # # ## ## #.## # ###.# #  # ##.# ### #. .      .. .###  .  .      . . .  ..  ...  #
##.# #.#. .#.. .    .... ... ....... #. #  #.#. # # ## ##.#.# # . . # ## ##### # # ## # ###.####
# ...#. ## #.##.##.# #.## ##.# ## # #  ##.#.  # #.#.# #.# ## #. # #.  # # ... ##.#.# ##..    . #
##.#.# #.# # .# # # #.##.## #.. #... # .  .# # .#.  .    . .. # # #.#  .# #.#.#  # .  ..#.# ## #
# #  # # . #.#  # #        ..# # .##.  ##.# ..# #.# ####.#####  # # #.# #.###.## #.# ##.#.#.# .#
#  # # # #.# .###.### ##.###   .#. . #.#..## # .#  #.  #.  .  # # # # # #  .  . .  #.# .# #. # #
#.#  # #.# # #  . ....# ##.# # #.#####  #.... # #.# .## .#.##=# . #  .#.#.#####.#.#.#.##.#..#  #
# ## #.#...# #.## ###. .     #.#    . .# .##.#  #. # # # ### ## # ..# #     .. ...  . . ..#. # #
#.. . .#.#.#.#  # # ..# #.#.#. .## ### .#..#  # #.#. .  .. .. ....#.. # #.##.# ##.## ## ##  #..#
# ##.#.#.# #.. # .# # # #  #.#.#..     ## #. # ..   #.#.#.# #.# ### ###.# # #.#.### #.## ##.# ##
#.# .# ## .#.#.### # .# #.## # # # ###.#. .# .# # #.## #.# ## # . . ..  .     .  .  .. . .  .. #
#. # #. .#.#.#= . . # # #.. .  =# #. # .# ## # .  .  .o  .  . # ##.### # # #.##.# ####.# #.#####
#### ## ##.# ###### #.## #####.#..# ##.#. #  #.## ## ### ## #.# #.#   #.#.#  #  # # ...# #.#.  #
# ... . .. # ..        .. .. # ## #.#.. # ##.#. # #  # ### #.##.#.#.# # # .#..# # #.##.   . ## #
###.#.## # #=#.# ######.## ###. #.#.## #.. ..# # ..# #.. . ..         ..# #..#..# #.   # # # ..#
# # # .  #.#.#. ... .       . .#  .....## ## # .#.##  #########.# ##### #.## ##=# # ## #.#..## #
#   # ##.#.# #.##.##.#### ####  .#.#.#  # .#.# #..   #   . .  # # # ..  #  #   o .#. ..  #.# ..#
#.# #  ..#.#.# #.##.# ... .  # #.# #.# #..##.#. #.##..#### ##.# . ##.## # ## #### #.# ##.. #.#.#
#.  #.##.#.# # #. . #.### ## .    .. . .# # .# #..   #  . ..# # #..#.#  #.#  #  . #.# #..# ###.#
#.#.# #. # # # .# # . . . # .#.#.# #.# # ..# #.##.##. .###.# .# # # . # # .# #.## # #  # #    .#
#.# #. #.# #.. #.## # ###   #..#.##.#. ## #..#  #   .# ..#. #.# #. #.#..# #      .#.#.#..#.### #
#.#.  # .#.# #  ..  ..   .#  #.      #.   .# #.## # # ### ### # #.# # #=# ###.###=#.#  # #.#.#.#
# #####.##.#.## ### # #.# # #. #.##.#  #.# #.# #  ...    .....   ..   .. =. .  .#.# #.#  #.#.# #
#.    .    #  ###.##.## #.#.###.##.#.# ## ## ##.# #### # ##.### ####.## #.# #.#   #.#. #.#.#.# #
###.#.# ##.#.#    .    .    . .   .. . ..  ..  .  #. # ## # # #. . . ......##.# #.  #.#    .  .#
#.  ..  .# #.  ###.####.#.###### ############.#.# #.#  .   . .#.# # # #.#.# ..# # #.# ## # # ###
# ##.##.## #.#.   ## . #  .    ....... . .. # #.# # ## ###.####.. # # # ## ##.# #.#....  #.#.  #
#.  . . . .# #.#.#...##. # # # # #.#.# # ## # # # # .# # # #   .# . .. . . .   . .# ##.#.# # ###
### ######.# #.# # #.  #. ....# ## #.##.#.# # # #.# #. # .  #.# . ## # # ########.#.#   .# # # #
#        . # #.  ..  # ..#.#.# . .   .. ... # # #.#.##  ##.#  #.#.#.# # # . .   #.#.##.# # #   #
#####.## # #  ######.. #.#.#.  # # #.##.# # #.#.#.#  # #...###. #...  ...# ##.#.# #. . #.#.. # #
# . . # ##.# #  . .. #.#.#   ## ## ### # # . ##.   .# .. #  . #.# ########.#.# #  #.## . # # # #
##.## # ...#..# ## #  .# #.# .  . ...    .# #. .# #  #.#.  ## #.# .  . . ..    .#.#.  .#...#.# #
## .#.#.##.# ## #.##.### ##.# ####### ##### # ### # ##.#####.## # #.######## ###.# ##### #.#.# #
#. #..  ...#   .. ....   ... .  . .  . . .   .    ...   .=  .... .       ... . . . . . ... . . #
#.#.#.#### #.## #.### #.## ##.# #.#.#.##.#.# ## #.#.#.## #.## # #.##.# #.# # ### ## # ## #### ##
# =.         # # ## #... #.#.#  ##.# ## ## ## #.##.#.# #  .#.#.# # ##.# #.# ## #.#.  # # #   # #
### #.#.## # #. ..  . # #.   .#. . #. .   .. ...  .    ..#..  ..  ..    .. .     .# # .# #.#. .#
#.## #.# # #  #.###.## # # #.##.#### # # # # ##.## #####  # # ### ###.# # #.##.#.##..# #.#. ##.#
#  .. ..  .# #. .    . .. = .     .   # # ##.# # #.. ..# #     .#.#.# # # .... # #  #.  ...#.#.#
#.## # # #.  .##.# # # #########=#.#.# .. .  . #  .### ...#.# #  .#.#.# ###.## #= #.#.# ##  .  #
#.#.#. # # # # .#. ..# #.  .....=..# .# # # ## # #.#=  # #  # # # #.#.#.. # .  . #  # #. # ### #
# #.## # #.#.## # ### ##.##### ## ## #.# # #.# ## # ###.# ##.## #.#=## ###.#### # ## #.# #.# ###
#.# ...  # #.  ..  .... .. . .. .  ..... .  .....  .. ..   =.  .       .  .  .. . ..    ... .. #
# # #.##...# ####### ### ##.## # ##.####.#.##.##.# #.### # # ###.######.#.#### #### # ###### # #
# #.###.##.# # .... .#  #.# #  # #.. .   .#..#  ..##..   # #.#  #.    # ..   #.#. # #. .. .#.  #
#  .  . .   ..###### ## #.#.## #. #.# #.# #.##.## #.## ## ## #.## ####.##.#.#.## # # ## ### #.##
#.# # ####.# #.  .  .    .#  # #.# #.# .  ..o...  ...  ..  .   . .. .  .      .  . .... .     .#
#.#  # . ..#. # ### # ###  .#..#     .#.# ##.# ########.#### ##.##.#.# ### ## ####.# # # # #####
# .#.# ###.#.# #   .# ..  #. # #.## # #.#  #.   ..  .. #.... # #.#   #.#. # .   .. #.## # #. . #
#=## # #. .# # #### # ###.# #  # . #.#. # #. ###.## ## #.####  #.  #.# #.# .## ## # . .. .#.#%##
#.  .    # #   ..... ... .   #\#.# #. #.  .# # ## #.#.##    .#.# #.##  #  #  ...#. # ###.#..  .#
# # #.## # # #.## ####### #.## #.# #.#..# # .#. =.#.# ...##.#..  # . # # #..#.##  ## # ## #.## #
#.##.## # .#.# . .. .  ..     . # ## ## # ##. .## #.#.##...#.#.# # #.# # ## ##.###... .  .  #..#
#. ....  # # # ## # #.##.## ##.#.  . .  . .# #   .. #  #.#.#.#.#.###.# #...  ..   .# ## #.#.##.#
#.# # ## #.#.#.# # #.##  .#. # .##.#.## #.#  #.#.##.. #..#  .... .  .# # ## # ##.#.. # .#.#. # #
#.##.# #.  # #.#...#...# #  ## #.## #.# #. ##.# # # # ## #####.#.#####  .#.# #.. # #  ##=## # ##
# .   .# #.#  ## #.#.#    # #.....  #.# # #.    .     . . . .  #.. ..= # #.  ..# # . #. ... . .#
#.###### #.# #.    . # #.# . # ##### .#  .####### #.## ####.## ..#.#.#.# ### ##.##.#.. #.##.####
#.    . .# # # # # #.  #  # #....  .#.#.# .      .#.  .   .#.# # . ..# ..    . .. .# #.##.#....#
########## # # ## ##.### # #.#.#### # #.##########.## ### ## #.## #.##.### ##.## ## .  .# #.##.#
#  .   .... ..  . .. .    . .   .     .  .   .  .. ..  ..       .   .    .# #.# ## #.# ## . . ##
#.############.# # # ###.### ### ##.##.# # ### # ##.### # #o##.# ##### ## #.##. # . .#..  #.# ##
#  .. .. . . ..# .  ...# #  #..# #. . #.# ## ##  .#  .#  #.# .. #   .# #  .. .#.# ## # #.##.  .#
# ##.# #.##### ##### ##.## #  ##.# #.##.#.# . ..##  #  #.# # # #..# #. . ##.#.  # #=...#.#..##.#
##..# #.    .# .     .. ..  #  . . .  . #.# #.#  .# ##.#.# # # .#.##.#=#..# ###.#  # # #..# # ##
# .#...#.# # # ### # #### #.# ## #.## ## .#...# #.. ..... .# #.#. .. # #.#   .  #.#  #  .#  ...#
##..#.#.#.# ##.#  . .   .   #.#.# # ### # ##.## # #####.## ### ## # #  #= # ### #..# #.## #.####
#..# .. ..     .#.#.#########  . .... ... .   ........   . . ..  .  .#.#.##.# # ###. .  . .. ..#
## ##.##.# #.#.#..  .  .    . ###.#.# #.##.#.####.# ##.## # ##.## ###. .. ..   ....# ### #.#####
# . ### #.## #   ###.#.###.##.# . #. # #.#   #...#...##.##.#.##.#    #.#.####.#.#.#  #. # #... #
## #. ..  .    #.# .## #.  . .# #.#.#   ...##.##.# #. .   . ... ..# ##   #. #.#.   # #.#   .#.##
#.. .###.# #.#.#..# .  ..# ##.#.#    #.### ..  . . #.## ## # ## #.#.  .#.## #  .# #..#.#### ## #
## # .   ## #  # ## #### #.## #.###.## # #.#.#####.#.# # ## ## # # # #  ..  . # # ## ..    .  .#
##  ##.#   . #   .. . .   ...  .    . .....= ...  .  ...... .  .    .#.#.## #.# # . .# #.#### ##
#  #..   # ##  #####.## ## ###.### #######.### #.#######.## ##.# ##=#  #.## # # ## # #...   .  #
##.##.## ### #.#. ...#.# # #.  # .# . .  .. ..  . . .  # # #   ## ##.#.. .  ...    # ######### #
#.  ..     ..  #.# #. .#.# #.#.##  #.## #.# #.## #.##.#  ...# #   .  #.## ## ### # . . =     . #
##.#.#########.# ##.## # ### ##.# # ##.## ## # ## #.## # # ##.#### #.#. #..# #.## ##.##.#.###.##
#.#   .  ... # ...  . .  .. . .  . ...  .... .....  .      .     .   # #  #  # . ... #.##.# # ##
# #.## ## # ##.#.#########.# ## ## ## ## # #.#.## #.# # ## ##.#.###.#   #  # # #=### # # ##.#  #
#.#  #...#. #.=# .. .   .  .#.#.#.# #.# .## #.# ##.# # # ##.#.##   . # #  #. # # #   #    ..  ##
# #.#. #..# .# .## #.## ## #.    . .# ###..  .  .   ..  . .      ####.  #..# ..# # #.# ## #.#.##
#.   # #.#..#  ##.##.#   #. #.# # #.#   . #.##.#.###.#.#.##.##.#  ...#.# ##.## #.## .# #   .# =#
#.# #. #  #  #.#. #.  #### #.## ## # #.####.#.#.##=## # #.### ##.##.# . ..      .  # # # # ##.##
# #.#### # .#.  # .#.# .  .      .. .=...  ..  ..    .  .       .    # # ### ## #.#. #   ...  ##
#     ....# .# #  #. # ### ##.####=######.###.## #.######## ########.# # # ### # #.#..##### # .#
#.#.#.##.#. # . #. #    . .#..# . .#  .    .#. ..# ... .  . #     .  ..#.  .  . ..   #... #.# ##
# ##.# ##.# ##.##.#.# ##### ## ###.#.### # ##.###.##.#######.# ### ## # ####### ####.####.##. ##
# . ..  ....   .  . . ... .. ..  ...  . ..    . ..=     .  .    . .  .. ..     ...  ..   .  #. #
##.#.### #.## ###.#.######.#.# ########.###.###.######.#.##.##.#.##.######## ##### #.## ##.# .##
#  #  .#.# # .# . . #..   .  #.#...  ...# .     ... .  . ....# #             .   # # #. #. .#..#
################################################################################################
