######################################################
# #.# ## ## # ## #    .  .  o.    .=# #  #.# # # # # #
#     .    .  .   ### ## #### #####   #.#. # # . #.# #
##.### ## ## ###.#  # #.#    #   .. # # ## # ### # # #
##   # # . #.  # ##.##. ####  ##### # # .# #  .#.# #.#
# ### # ##.#.# #.     # . .#.#. o . #.#.#  #.### # . #
#.  .. ...  .# # # ###  ####.# #.## # # ## # # = . # #
# # # ## # #.  # # #  # #. . # #. . . . ...# # ### # #
##.# #.##.# #.## ### ## ####.## ### ######## ###.# # #
# ...   .  .          ..    .   . . .       ..     . #
## ##.# ## ## ## ##.# # #.#.# #.# # # # ##.# ##.# ## #
#.# ## ## ## ## ##.# # # # # # # #.# # ## #  # # #.###
#        . .  . . .   %         . .  .  . .#  .  ... #
#.#### #.# #.# # # # # # ### ### #.## # #.#  ##.# ##.#
# #   =# ## # # # #.# # #.  #   # #.  ## # # #. # # ##
# #=## #.   .  ..    .   # #  ##. ###  . # #  #.#    #
#.# #  # ## #.### # #####   #. .# ..# # #  # #  # ####
#  # ###.#.# #. ..# #   ##=##.##  # # ## # # .# # = .#
#.#.     #.  # ## #  ##  #.#    # # #   .# # ## # # ##
# .# #.#. ##. #.# # # # #.. # # #.#.# # #  # #o# # #.#
# # #  #.#   #.   # # . .# #  # # # # #  # #  ...  . #
# # .#.#  ## ###### # #.# . # ### ## # ###.# #.# #####
# #.# ## #. .     .=# #. # # ..  . .  ..  .#.#.#.#  .#
# #. .    # ####### .## ## .##### ## # ### # ##  ## ##
#.# ## #.# .#. . .. # ..   #. ...#       # #. .#  .  #
# # # #. .# #######. ## ## ## ##.\## # ##  # ##..### #
# #   .# #.       # #.###...## # #.. #.  # # #.# #   #
# # ####  #.######..     #.# ..# # # # ##. # #.# # # #
#.#.# . .# .  .. .# #.# #  # # # #.# # # # # #.#..##.#
# # ####. ######### # ## #  ##.# #.# ### # #   # # . #
# # .  #.#   .. .. .#  . # #  .#=#.#   . # # # # #.# #
# ##### #.########## ##### ### # ## ######.# ## # # ##
# . .. .. . . .   .     .  . . .    .      #   ..  . #
# ## ###.# #.# ## ### #.# ## ##### # #=####. ###.# # #
# # .  #.# ## # ##   # #.#  #.    #.# #. ..# #  .#.# #
#. #.###.#     . # # # # # ##.##### # # ###. #.# ## .#
# # .#   #.## # #  #.# #    .    . ...  . .#.# #  .# #
# ### ### #.## # #.###.# ##################  #.#.# # #
#....    .    .  .  .    . .. ..  ..    . .#=# # #   #
# ### ## #.######.############.############..# # # # #
# #  ### ## .   .  .   . . .    .      .   # #.#. ##.#
# ##.## # # ##.# # #.#### #.## # # ### ####  # #.# . #
#.   . .    #.##  ##.   # #o#.# # #   .#  .#.# # # # #
## ### # ## #... #   ### . ## # #.#### ## #  # #.#.# #
#  # .#.# #. ###  ## .  # #.   .   .     . #  # #.## #
## .# # # #.# .  # #.##.#  # ## #### # ### #.#    .  #
#  # .#   #  # # #  .#  # #  # #.= # # #  .#. # ## # #
## ## # # #.# #.# ### ## #.### ### ## # ####.# ## # ##
## .   # ..     .    .   .  .    .   =     ..      . #
#  ###  # #.# #.#.#.## ## # ##.#.# ### ## #.####.#####
## ..# #  ## #.# # # #. #.## ## # ## ##.##  #  .   . #
# ###.# #    ..      # #.    .   =    .  .# ####.#####
#  ..    .## # ## # #. .#.## #.## ## ## # # .  #     #
######################################################
