############################################
#       #.# #  #.#   #.#   o#.     #.  ..# #
#.# ### #    # #.  ###  ## #=# #### ##.##. #
##  #.#.# #### # #     #    .      .     # #
# #.  #.#      ###.###. # # #### ##### ###.#
#   #.### # # #    #.# # # #.o. #       .  #
###  #  .  # # ##### #.#. .  ## # ## ## # ##
# . ## ####           . # ## #.#.  #. ## # #
#.#.     .#.## # ## ## # #.. .  # #  #     #
## =## # ## #  #  .#.# ..  ## # #.###  #####
#  # ## ## # ## #### # ## # ### #.  ## . ..#
##  .  .  .         .#   #   . #  ## # ## ##
#.################## # #.# # ## # . .# #.# #
#.     .        .    #  ## ##.# # ##\#.    #
###.# ## #.# ###.# # # #.o.   .  .#   #.## #
#    #.## #  #  ###  #  # # #.###..# #   # #
### #      # # # # # # #.#. # #  .#  ##.#  #
# . # ### #..#   .     #  #.# # ##  # #  ###
## # ## # ### .# #### # #   # #  .# #.#.##.#
##   .  .. . # # #  #. . ## # # ##. #   .  #
# %## # # # #  # ## #.## #. # #  .#.# ## # #
##.# #  # #  # #   .#  #  #  ## # # #.#..#.#
##=# .# # # #  # ## # # .#  #   ## ## ### ##
# .# #  ##.  #.# #  #  # ## #.##   #       #
##  .## . # #  #  #.#.# # ### ## ## #.######
# ### . # #  # # ###  .   .  .  ..   .     #
#    # #  # #  #  # ###### ## ## #### ## # #
## # ## ## . # #.#       # # #   #. .#  #.##
#. #    #  ##  #  ## ## #  # . #.# # # #.  #
## # ###.###.#.#.#  #.#.##.####  #.# #  ## #
# ## .     .  .# ##  . . .  .  # #. #  # # #
#o# ######.# # #.  ## ##.# ## #  ##  # #=# #
# .  .   .#. # .# ###  ## #  ### .# ## # # #
## #.## #. # # #   #=## #.# # ## ##   .  ..#
# # #.#  # # #  #.#          .. .. #.# # # #
# # .   #  #.# # .#####.#.#### ## # #. ## ##
# # ### ##.# # .#.    # #    .# #.   #  .  #
#  ## #  # # # # # ###  #.### # # # #  ### #
# #  .  ## # # #..## ##.#.   #  #. # # # # #
# ##### #.   # . #      # ###.# #### #.# # #
#      . # ## # # #####.#          .   #.  #
# #.## ##. #     .   .# ## ## ### # ## # # #
# # #    #  # # ##.# #   .####. . #  # # # #
############################################
