###################################################################################################################################################################
#..#  # #.#..##.# # #  #. #.  #.#  # #.#.#.# .  #.# ...# . .   ..# #.# ## # # # #.#.#      ....     . # .  # ....... # # .#.   .#. .     .... . ..#.#.# # #.#..#. #
##.# # .#  #..  .... #. #.###.# ##.# #.#.#. ## ## ### # .###.#.## .#..=... ..    . . ## #.##=## #.### #.## #.#########.## # ###.####.######## ##### # .   . ## ## #
# .#.## # # .#########.# .... . =    .. .# #..  ....#. # . .#.#..# ################.# ##.# ###.#.## # #  .       .  .  .    ..  .   . ..    .... .. .# ####       #
## .... #  #    ..   .. #.#####.#### ## #. #.# ###.# .##.##.#.#.#   .  .. ..  .. .#. ..... ..  #. ..# ## ## ######### ## ##.#.###.#.##.###### # #.# #  #..#.# ## ##
#..# ###  #  # #.#.## # ..#.. . # .#.#...# #.#..  #.#.#        ..#.# ####### #.##.#.### ####.##  ##.# .#.# .. . . .... ##  .#.#.## # #.#  . ... #.#. #.# # .#.#...#
##.#   .# .#  # #.  ..# # #.# # #.#.  # #. # # ##.#.   # ###.#.#   #.#  ..    ## ##...#  .. #.## #  . #.  ## ### #.# # . .#.. .. ....# .#.## ##.#.# #  #..#  #.#.##
##.#.###  ## #  #.### #.#. #.## #.## # #.#.#.# #. ### #  #.#. #..# ## ######.#......##. # # #..#.## #..# #.### ## ## #=#### ########.# #.# #.#...##..#=# ## #  .  #
#. #. ..# #. .#.#. .# #.# # .# .   #.#. ...#.#  #.. #.##. .  #  ## .  ...  #. #.#.#.  #. .# # #  .# # # .# .    .  . # #.=. #. ..  ....# . . .#.#   ##.  #...###.##
##.# #.#.  # #... # # # #. #.##.#.#  .## # #.#=#. # #  #.#.# ##.#..### ####  #.#.##.##  #.# #. #.#. . .# ###########.#.#.##..# #.# # #  # ## #. ### #  #..#.#  .  #
#  # # .# ##.## # ##.##.#.##  # #  # #. .# # #..# #.# #     .....# . . .  .# #.#... # ##.# ## #.  ###.# ... .. .  .#.# #.# .#.# #.##.# #.#.#..#  .# .# # #. #.## ##
##.#...# .. .. ..  .....# #. # .#.#. ####. # # #  # #. #.# #.#.##. ###.##.# .#.#### #     .. ..#.## # .# #.# ## #.# .# . .#.#   . .... #     #. #.#.##.# ## #. # .#
#. #.# .# ## #.##.#.# # #  #..# ...#.. . #.###.### ##.#..# # #=.##.#...#   #.#.   . ###.##### # ....#.#..##.#.##.# #.# ###.# ####### ##.#.##.## ##. #. #. #.#.##.##
## # # # .# #.# # #.. #.. ##.#..## . #.#.#. .  .    .  # # #.## .#.### ##.# . ## ##.. . . ..#. #.##.#..#  . ..  ... ...      .  .    =.  .... ....# ##.# #..# # ..#
## ##.# # #  ..  .#.# # #.  . #. ..# ## ##.###.#.##.# #  .# #.# ##  .#.. . #.# #.#  #.####### #..# #..##.############### ################ ##.#####  .# #..# ## #.##
#  .....# # ##.## # # #.#.# ## .# #   . .  #. # ## #.# # #   . ....# # #.### ... .#.#  .   ... #  . # #..#.. ....   . .. ....  . ..   ....#..  .  #.#  # ##  ..#.##
## ######.# #.# ## # # ##.##.### # #####.#. # ..  .. . #. ### ##.#. .. #. .  ## ###..##.###.# #..# #  .# # ## # # # # ## ##.#.# #.###.#.# .# ######. #.# #. ##.  .#
#.. .. ..  ....   ..    ..  .  .... .      ## ## ##.## # #   #. #..#.#..## # #   . .## ##.#.#  # .# # #. #.# # #.#. ##.# # #.#.# ##.## #  #  #.  . .#.   .# # ## ##
#.##.####.# ##.######## ###.#.# # ##.#.#.# #  # #.# .# # ### ## ##.##.## ###.# #### .. ..   # # .#  . \#.# . # # .#  .    .  ..  .    . # .#. ## ## .#.##.# .. # .#
#..# .. .#.#.#.#  ... ... #  #.#.#.### #.#  #.# #= .#. #  . .. . # . ..   ...     #=######### ##.#### #.#.##.# # #.####.################ ## ###.#.# # # ###.### ###
#### #####.  #. # # ## #.#. #  .    .  #.# ##.#.#### #=. # ## ### .##.##.###.# ## #  .  =.      . . .....  ....  .. .   ... ....  . ..... . ... ..= ....  .   . ..#
# .  #.    # . # .# #. .#.#. #.## ## # # #. . . . .  ..#.## #. . # #.# ###. #.#  ## # # # #.# ## #.## # #.## ##.## #.######.# #.## #.##.###.# ####### ### # ## ####
####  # ## #### # ###.#.# # ##. # # # . ## #.#.## ## #.# .#.# ## #   ..   #....# #.  #.# # # ## #.#.###.#.#...#.# #..#  .  #.# # #.#   #  # # # . .  #    #.. ... #
#. =.#.#.# .. ....   ..  .# #..# .#. #.#... # # .#.# ##. # .  .#.# ##.# ##  ## #..#.# .. . .   .   .   .. ## #.# . # ##.## # #. .   .# #.# ..#.####.##.#.## ##### #
# ##.#. ...# ## #.## # ###.  #.####.#. #.# # ..#.#.#.. #.# ## # .. .# #.#.# .#.# #   # ## ####### ##.####..#... # # #.##.# # #### ## #.# .# #....  .. . .    . =#.#
## # #####..# #.#  #.#   ##.#    .  .# # # ## #.  .. ## .#..# .# # #    ..  #.   .#.#  ###. . .. .# #.. #.# .# #    .  .  . . ..  .#=#.# #.  ##.##.##.#.### #####.#
#...    .. #. # #.#..# # . ..#.# #.#.# #.# .# ######## # # ## #.##. #.### #..### #  .##.##.######## #.##.#.#.##.# ################# ## #.##.#.# # # #.#.. # #   ..#
##########.##=## #.##.#.#####.# #.#.# #.##.#    ...   .... .....   # .#.. #.#  # .#.#.. ...  .. ....  . .  .... .    ... ... ..  . .   #  #.#.# # # #..#.##.# ###.#
#   ..      . .  ....   ...   . . . ...   .##.# ##### ####.##.#.##.## ..#.#.#=#..##   #.## ##.#### #.#.##.##.###.##.#.#.## ## #.##.# #.# #  # # . . #.#..#..### # #
#.## ## # ####.# # #.##.##.# ####.####.#.#  .# # .. # # .. ..# . #  #.# # #. ..# .  #. #.#.#.#....# #..#.#. # .##.# #. ##.## # #.# #.# .  # #.##### # ## ##.  ..# #
## # #.#.#   .# #.#. . #. .# . .   .. # #  ### ####.#.### ##.## #. ##.##.##.###  ##  #.# . ..# # ##  # #..#  # . .# # #.. ..   . #.#.#.#### #..  .. . .#  # #### ##
# . .# .  ### #.#  ###.#### ######### #.##   .    ..   .   . .#..#.#=   . ..# .#..#.#  # ##### # #  ##.#.#. #  #.#   # ##### #.## .#.#.#. . # #.# ### # .## . .   #
#### # #.#  # # # #....   . ..    ....  ...############ ######.###.## ##.## #.# .#  ## #.    . # ##.#o.  .#. #  # #.#.. . . .#   # #.# ## #.# #  . .# ## # .#######
#..#  ## ## # # #. ######## ##### ## ##.## # . ..    . . . ..  .. . #..# #. # ##  #..# #.##.## # .  .# # ## ## ## #. ##.# ## ####..# #.  ##.# #.# #.# .# .# # . ..#
#.## #.   #.# #.# #     .. #   .. # # #. #  ##.###### # # ##.###.#.#  #. ## # .  #. ##.#  ..    #.# #. #. . #.    # ## #.# # .  .#   #.#.. ... .#.# #.#  #..#.#.# #
#. . #.# # .# . # .##.##.#..##.## # . # # .#.#   .  .. . #. # .#.#. # ##. # #.##. # #..#.#####.# ##..#..### ##.####.     ... ##.# .# # #### #.# #.# #  #..#.#.# # #
## #. ## ##.#.# #.#.## ###.#.### # ##.# .# #   # ##.## #. # # ## # ## .# ##.#.#= ## .# #  .. ..# = .## #. #. #.. .  ##.# #.# # #.# #.#  ..# # # #.. # # .##.# #.#.#
#  # # . .   .# # #  . ... .  .. . ..   #. #.# #.#. #  #.#. .. ..  # .#=.  ..#.# ...#   .# ###.####.#   #.# # .####.# # # ##  .. #.#.# # #.  #.## ###..# #. ### # #
####..##.# ## #.#. # # # ##.# # ## ####..# # #.#  #.##.# ######### .# ##.## # .. ##..# #.#.# .  . # .# # . .## .. # #. ..... # ##  #.# #.##.# . .  ...#.. #. .. ..#
# . .#..   .# # #.# #  # #.#  ##. ... # ##.# # # ##. #..  . . .. #.# . # #  .### .  # .#.#   # ## ..#   ###. #.# #    ## # #. #.## #.#..#.#. ## # # #  #.# .###.# #
# ##.###.## #.#.#.  # #..#  #. .# #.## .# .# #.#.#..#..## # # ##.#. #.## ##.#.. .##  # # # #  ..  #  # #.. .## .# # # #.#.##.# .   # #.#.. .# #.#.# # #...#.#  # ##
#.#. ..#.#..# # # ###  #.  #  #   #.#.#.## # #..# ##.# #.# #.#.### #. # . # ## #..# #  . #.###.#.# .# . # #.#  #..  # .   .. #.###.#.# .#.# # . #.# # .#.#...#....#
#..#.##  .# #.# # #   # ##.##.#.# #.# .  # #.# # ......  .  ...  .  #..# #   ###.#.. # #     #.#.## ## ##..  #. ### #.###### #.#...# # #  #. ## # # #.#. .#.#  ## #
# ## ..# ## #.#.#  ##...  ..#.#.#.#..## ## # # # ### #.#.# # ##.## #. #.. #.#. ...#.#  #.# ##  #  # .#. . #.#  #. #  ....... # ###.#.#. #.#.#...#.# # .# #.. #.#.##
# .  ##..     #.#.#   #.# #.#.# # # # # #  # #..## # #. #.#..#.  #  # .#.#.. ### #.  # # ## ##..###.#  ###  ## # #. ## ##.##.#   #.# #.#  #.#.# #.# # #. ## #. .. #
# ##.#.#.####.## . .#.# # #.#. .. . ..#..# #.# #  ...#.#.  #.. #...#. #   # #  # .# #     .. #.# ..  #  . #.     .#.# .. #.# #####.# # .#.#.# # #.##   # .# .# ## #
## #  ..   . .. # ###.#. ##.# #### ## # #  #=#.#.###.# .#.##.#  ##  #  #.#  .# # #.  #.##.####. ### #. #.#  ##.# # .# ## #    .   .#.# # .#.#  .#...#.#  #  ## # ##
#.. .#########.#. # . #.# . #.# . # # #..# #.#.# # #.#.#  ...# #.  ## # #.#.# .#. #.#. # #  ...# .. .# #  # #...# # #..# # # ##### # # .# #...#.#.##   #  # . . ..#
## # #.  . ..   # .##.## ####  ## ..# #.# .#.#.#.# #  # ######.### #  #..    #.#.#  .# #. #### .# #.#. #.# .##.#. # #.# .#.. #. .# #.#.#  #.#.#.#...#.##.#  #.#.# #
#.##. .# ### # #  #.. .     . # . # #.  .#.# #.#.# # #..  . . .. ...# .## #.#. .  # #. #.#.  #.#.#. .# #.##..# ## # #  #o###. ## # #.#  #.#.#.#.#.### ....#.# .## #
#.# #.#.##.## #.#.##### ##.### ## ##.##.## # # # #.#.#.#.# #.##.##.#  #   #.#.## #   # #  ## #.#.##.#. # .# #.#.#.#.#.##.  # #.#.  #.# # ## #.. #     ## #.  #.#  #
#  . ..... =..... .  . .. ...  ..  .. ...  #.#.#.# #.# ## # #.##.#  #.#####...#. .# #..#.#.#.# #..# .#.#.#..#  .    #.#  #.# . # #.#.# #    #.#.# #.#.# # # #.. #.#
#.####.##.# ##.## ### # ####.#####.##.##.# ###   #.#.#   .  .  . . # .   ...#  #.## ## # #   ..  ## # .# .#.####### #  #.# # #.  #.#.# #.## # #.# ##  #.  # .#.#  #
# #.  .# # # # # # . #.#.  # . . #.# #.#.# ....# .    ##.##.####.# .# # ###..###.#   #.#.##.## #.#   #.#.# . ..   #..###.#.#. .#. .#.# #. #.#.#.... #.#.##..#.  # #
##.###.#.  #.# # .#.##  #.##.# ##.## #.### ### .# ##.#.# # #  ..   #....#.#.# . . #.#   ..#..# # ## # .#=## ## ## # #   .#.# #.#.#.#.# ##   #   # # # #   #..#.#  #
#    .. ##.#.# #.# ... ##.#  # ..    .. ...#   #   #. . .#. ##.#.# ##.# # #.#.## # ..#.#.# .##.#. # ##.#  #  #.#..# #.##.###. ...# #.#. ..#.. #. # #..# ## .#. ## #
## # #.#.# . #.#. # ##... .#. # # # ##.# #.### ..# # # # #.#.## # . . #.#....#.#.## # .#. #.# .# #.  # #.#. # .##.# ## #. . .####..# # ###..#.# #. .#.  ..#..#  # #
#.#.##.# # ##  # #..#..# # # # # #.#.## ##...# #  . .# #   .   ..# ##.#.#.# #.  . # ## . # .##.#  #.#..# ## .#..#.#  #.#.###. . .#.# #.# .# ###. # #..####. ##.# ##
#... . # # #.#.#. # ## #   #.#  .  .... . .#.#.####.#.#.#########. .# #  ##. ### #   # # ##  #.# ##..# #. # #.## ##=#..# # ..## # .# # # #  ... # . #.#.. #     . #
# ## #. .#. .#.# #  .#.# #.# .###.# #.# ## ###.. ...  . ..     ..#.#. # #  .#..#  #.## #. #.#..# #..#..#.#  #. ....  #.#.#.#.#.#.# # #.# ## #.# ##=#. .# ##.#.# #.#
#. # #.###.# # # .#### .#.## #.  #.# ...# .  ..## # # # ## # # #.#.##.#  ##. #.# ##.#..# #.. # #  # ## ## #.####### #..# ##. # # #.# #.#   . ##. #  # #. . .#.# #.#
# #..#.....# #.#.# ... # ....## ## ##### # ###.# =# #.#.. # # # # ..# #.# # #  #.# ..# # ##### # ## .#.. .# .     # .# # . #.#.# # #.#.#.##.#.. #  #. # ### #.# # #
# ## # ###..#.##  ## #.#####... ...  .   #   #  ## #.#  ## .#.# ##.##.#.#.#. # # ## ## #. .  . #.   ## #.#  ## ###  ## # ##..   .#.#.# #  #.#.#. #..# .#..#.# # #.#
# .# #.#.. # .. .#.# #.. ..#.##.# #.##.##  ##..#. . . #.# #.# #..# #  #.# #.#.    # #. ## ##.# ##.#.# #.# #=#. #..#   .#.. # #####.# # # ##.##..#. #..#  ## ##.# ##
#o#  #.#.# .# ##.# ### ##### #.# #.#.###=#...#  .###.#    .   # #.  #..   # #.## #. ##. # #.## . ..  .. ..  ###.#   #### #.#.#   . # # # . .  #..#..#.## #     # .#
##.## #.##.#   # #  . . . . .#. .  . . . ..## .#.  #.##.## #.# . #.# #.####.## #. #..# # .#.# .#.# #.##.# #  . .= #..  . #.# # ###.# #.#### ##..##.## .#. #.# #. ##
#.   .... .#.#  ..##########   # ###.#.#.#.# # ## #. .# # .   # ## #.  ... . ....#. ##. ###.##.## # ## # ##.######.#####.### ### # . #....#.# # # .#  ## #. ##.# ##
# #.# #.## # . # #.. .  . .. ### #..#.#.#  #.   # .#.#   #.## # #.  .### ## ##.#. # #  # .   .. . .... .... ..   ..... .. .. .  .. # #.# #. #.#. #.##.... #...... #
## ##. # #.# ##. ## ########.#.. #.##.# .# #.# ##.## #### # # #.##.#.# .  #.# .# ##.## .# ####.##.##.#.#.#.### ## ## #.## ##### ## #.# #  # #.# # ..#.####  ## # ##
#.   .#  #.#. .#.          #. ## #  .. .#  # #.#     .  .      ... # #####.#.##  #.  # #.# . #.# # .#.# #.##. # .   #.# #.#     .#.#.#.#.#  . #..#.# .. . #   . . #
#####  # #.# ##. ######.## # #.. .## ##.## . # . ######.##.#.### #.#...... =...#. #.## ..# ## .#.## #... ..  #  ##.## #.##.#### ##.#.# #.##.#.#.#  .# ## #  #.## ##
#..  .##.#.#. .# #....#.#.##.# #.##.# #..#.#  .# .. . . .# ###.# # # ####.#####  #..#  ## .  # #..#.### ####  #  # ... . ... =#.# .. # #.   .##..# ##.#   #.#..# ##
#.#.# #=.#.#.## ..# # #.#. . # #.#. # # # . ## # # ## #.#......#...# #  #.#  . #. #. # ..# # # #.#   . # ..# ## ##.###########. #.##.# #.## # . # .# . ####.###...#
##.#.# # #.# # # ## ##.#.####.# # # # #.## ##.##.###.#.#.#.#### ##.#.# #.#.##.## ##.#. ##  ##..# ## ####.#...    . .. .....  .#.#..#.# #.#  # #.##.##.#  ..... #.##
#     ...   .    .   ... .. .    .. ..   ..  .     .    .    ... . ..  .  . ...  .. ##.# #.. #.#..#.. .. . #.### ## ## ## # #.#  ### # # .# ##...#  #  # ##.##.# ##
##.##.#.###### ### # ## ####.## # ###.# # ## ## # ## ##.# ##.## # ########## ## # #. #.#=# ##. #.#  # # #.# .#  # ### # .#.#.## #. ..#.#.# . .#.##.#  #...# # ##  #
#.  .#.#    .# .  # # . . ....# #.#  #.#.##.##.# #.#   #.#. #..#..#   .    .## # #. ##. .. . #.# ## =#.##..#..#  .... .# #.# .   # #.#.#.##.## .#. .#  #.#..# #  ##
###### ## # # .#### ######## #= # .#. .. ... .  .#.#.#.#. #  #  #  # ####.#.#.   ##.#. ###.# #  . # # .. .#..#..### ## # #..# # # #  #..  # #.#  # # .# . # .  #. #
#...   .  #.##.#  .  ..  .... # # #. ###.# ## ## #. #.##.## ## ## #. #   . . .##  #..# # ##.# .###  # ###.## ##.# ## ###.# #.#..#. #.#.#.# .# #.##.##.##.## # ##.##
### # #.#.# .# #######.# # # #  #..# .  # #  # # # #. . ....   .. ## .##### #    #..# .    . # # ## #... . ..      ...   .....# #.## # # .# ..#... .#... #  # #.. #
#.#.# #.#..###...  ...#.# #   #.# #..##. ..# . ..# #.# ## ##.## #.   #  ..# .# # .#  # ###.# # ...# .## # ##.##.## # # ## #.# #.#.  .#.# #. ###.#.# # ##..# #..# ##
#.# # #.# #  . #.##.#. . . #.#. ..## #.## ##.##.##.## ## ##.# ##.#### ### #.#.## # =#  ..#.#.# ####.## # #.# #=## # # ##.#.#.# #.###.#.#..#.#   #.# # .#.## ### . #
# ## ## #  ###.# # #.## ###.#.#.#.    ..  ......  ..  . .  .  . .   .   . .     ..# .# ##  # # . .....   .. . .  ...     .   .. ...  # #.#..# # . . #.#.. . .  #.##
#.... . # ##.# ..  .  .. . ...# ..## ############ #### ### #.## #.# ##.#.# ###.## # ##.# ## #.#.### # #### ########## #.##.# ## # ## # # .#..## # ##..#####.####..#
### ### # #  # #### #.##### #.#.# # .#.   .  . ..# ..  # .#.## #.#.. # #.# #..#.#.#.#..#..      .....   .   .  . . ..  #.## # #..# #.#.# #..#...# ###  . .# # .  ##
#. #  #.#. #.# .... #.  . .#.#  #. #..## #######..#### #.#    .  #.##..# #.## # # # .#  ######.##### #### # ## ###### # .  ...# #.. .# #.##. ### # ## ## #..#.##.##
#.#  ## #.#. #.##.#  .# #.#..##.#.#..#. . .   .# #  .#.# .# #####.  =#.. # .# ..#.#.#  # ... # #  .. #  .#.#. .# . .  ####### ##.###.#.#   .#. =. . .   #.# #. #  #
#. #.   #..#.#.  . .#.##.#.#  # #..#. ## #.####..# ## .# #    .  # ## # ##.#. ##. # ##.#.#### =#.###.# # . #.#..##### .....  . .   # #.#.##  # # ####.# # # # #..##
# #  ## # #. # #####.  . ... #. #.#..#    .    # #.# #.# ##.#.## #.#.    ..##   #. ..#. . ...#.# ..#.#.#.#.#.# #  ..  ####.# #.#### .# #.# .# # ## .# .## # #  #  #
#..#  # # .# #  . . # ###### ## #..# # # #.# #.# #.  ..# .. .#.# #. #######.#.###.#.#  ######.# ###.##.# #.##.#.##### . . # . #  ..# #.#  # . .  . # .#. .. #.#  ##
#.##.##.# #. #.### ## . .. # .# #.#  ##.# #.#.##.# ## ## ## #...   #... .. ... ...#..#. ... ..  . . . . ..   .. .=    ## #..# # ##.# # # ##.##.# #. #...### # ##  #
#.   .. # .#.#.#.#.#.####### ## #  #.  . ... . .  .   .. #. # ##.#. .## ######### # # .###############.########## ###. ##.#.#.#.# # .#   #  # ## #.#. #.. . #. #.##
######### ##.#  .. . .... . .#  #.#  ## #.### ##.##.#.##  # . .# # #  ..    .    .#..# #.    ... .....   .   ..  .  ..#   .   . ...# # #..# # # ##.### #####.##.. #
#.  . .  .#..# # # # ###.# #. # ##.#.##.###.## ### #.#.# ##.###.##.## ########### #.# . #.#.## ## #.## #.##.## #.#.##  # ## ###.# #  # . #..  .  .      . .....# ##
####### #.## #.## ##.#.# ###.#.. ..  ..   . ..  .  .   . .. .. .   .     ... .  . #  #.# # #.### #.## ##.# #.##.# # ### #.# # ##.#.#.#.#  # ## ##.# ##.###.#.# #. #
#    . .....   .     .   .    #.#############.########## ####### #################..# . .....   . ...  ... .  ..  .. ..  .    ... . .. # ##..# # ## #.##  # #.#. ##
## # ##.#.## #.## ### #### ##.#.  .  ..   .. .. ..   .. .. .  . . ..    ..    . ..#  ## ### ###.##### ##########.###.#.#.# #.# #.# #.#.# # .#. ..   .  .#.  .  #. #
## # # .. # # #.# #.  #..# #.  ###.# # # # #.#.#.#.#.# #.###.########.## ##.# ## ##.#. #  . .= ..  ..... .      .#.##.# #.# # ##.##..# #. #  ############.###### ##
#...##.##.# # #.#.# #. .#.  #.#  #..# #.#   #.#.##.##...# .#.#  ..   .#. . .# # #...#.##.#####################.# ... ...  .. ..    # # # #  #. .  .   .  ..  ...  #
## # ..  .. . #.# # #.#.##.#. .# #.## #.#.# #.. . . . # #.# #.######## ##.## ## ### .     . .... . . .  . .....# #.# # ## #### #.# # #.#..#.#.# ##.# ## ######## ##
#. . #.## ##.#   .#.#    . ##.#..# .  ... #.#.## # ##.# . . =..      .   .......  #.####################### # #   #.##. #..   # # #  # # #..# .# .# #.#.#   ...#. #
## #.###  # # #.#..## # ##  #. #.#.##.# ###  # ### # #..### #.### ###########.##.#..#   . .. . .  ...  . .# ## # ## #.###.### #   .#.# # .# #.## ##.# #.# # #.# .##
#..#..  # #.# #.# #. ..# #.# =#. # .# # #.  # . .. #. #  ..# #. .#. .   .. .#.#.# # # ##.## #.#.##.#.##.#.#.. .#. .     . # # # #.#   .# # .#..... .# #.# ## # # .#
## # ##.#.#  .# #.### # .. ### #.###.##.#.# #.#.##.# ## ##.# # #. # ######## .# #.#. ## ## # ##.#.##.#.#.#.#### ####.###.## ###.## # #.#.##  ####.#.      . .  #.##
#. #.#. #.# ###.#. .#  #=#.... .. . ..  .##.# #.## #   . #.#.###.## . .     #.# #.#.#   ..   .     . .. .      .   . .  .    ... .  . .#. # #.  # #.### ## ## # ..#
## #..#.# #.#.  #.##  # .# ############ #.. #.#. ..## # #. #..    ..######### ..# #  ####.#### #############################.### #####.###. .## . #   .# .  #  #.##
#  # #  # #.###  .#.# .#.#.#.  .   .. #. ##.#.#.## .# #.## # ####.# #. . .. ..# . #.# ..#    .. ..      .   .  ...  . . ...# # .  ...#... #.# # # # ## ##### ##. ##
##    #.#.#  .#.# # #o##.# # ##### ### .# # # #.#  #. .  #.#.#  . # # ## ##.# .## #..##.#.###.#.##.## #.###.##.#### ### ##.#.  # ####  # #  #.    # .  .    ...#. #
# #.## ##.# ##..# #.# # .#.#.   .# # .#.#.. .#.#.#. # #.## ##.# ### ### # # ### # . #     #  #.#.#.#.#.#  #.#.. . # # ...# # #. .# . #.# .#.######  #.######### .##
#   .   ..    #. ...#.### ##.#####.##.#.### #. . ..#.##... ...  .. . ..  ..   ..  #  # ##. # #  .#.#.# #.##. # #.#. # #.#..#.#####.#.#. ###. ...  #.# .. .    .#.##
##.####.#.#####.# ## .. ...  . ... .  ... # ####.# # .. ##.## #### # ### #.##.##.## ## # .#  #.#.#.# # #.#  #.# #.# #.#  # # .     . # # .  ##### # # #.# ####.#. #
#  ...  # .  .  # . #.# # ##.####### ###.#..  .  # ## #.# # .  .. #.##.#.#  # #  #..#.# #. #.# #.#.# # #. #...    # #  .#  # ##.#.## # .###.# .  #. #.# # #..  # ##
##.#.# #..#######.#...## ##..#   ... # .# # ####.# .# #.#..# #.# #  .  #.# ##.## ##..  .# ##.# #.# # # # ##.##.# # .##.#.### # # .#  # #. .. .## ## ## #.#=#####  #
##.#.## #.#  .... ### .. ..#  # ## # .# #.# #   . .# .# #.#    # .# ##.# #.#.  # .# # ##. # .. # #.#. ... ...###.##.. . . ...# ### # #..### #.. .  . . .. .   . .##
#..#   .#. ######.. # ##.#.# # ##.# ## =. # .##.##. # #=# #### # ## ## #.# ## ##.##.#...#. #.###.# .##### #.# ... ..#.##.# # .    . .# ## #  #.#.###.###.##.# ##..#
##.. ##.# #. ... .###  # # # .  . ....#.#. .#.## # # .#    .. ...  ..  ..#  #.#..#  # # # #.  .  . # .  # # # # ###.#  # # # ###.#.# #.#    # #.## ### ###.#.#. .##
#. # .#.# # ## ## #.. #..# # # ### # #  ..#   ...# .#.#.#.######### #.## # #. .# ##.##.# #.#########.##.##.# #.## ##.##.# # ##.## #=##.#### .  .  .....   .    #  #
### # ###.##.## #.####.## # # ## ## #.# ###.##.#...#. # # #.  . . .# # #.#..# #.  # .. .... .  ..   ....   .   ...  .    . .  .  . .  ..  #.##### #.### # ## ##. ##
#. ..... .   .  . .      .  .=.       ...   #. # #..# #.#  ## ## # # #.#.#.#   # #. ### ## #### ## #.## ###### #######.## ## # #####.# # #..#   .#.#   # # #.#.#..#
# ######.##################################.###.## #..#.###.## ### # #.# # .# # . # .  .... .  .# #....# ....... .  = #..#.#. ##.  # #.##.#.##.#... # ## #.#.# #.##
#..    ..      ..  . .     .  . .. . ... .      . . #.#    . ..   .    #.#.# . #.#..##.###.### ## #.##.# ##.## #.# ## #.# .# #   #.. # . .#  #.# ####.#.  .  #.. .#
# ###### # ##.# #=# ###.###.######## ##.###.## # #.# .#.##.## ########.# # .# # ..# # ## #..   .   ..# # #.## # #.#.###.##.##.##.#.# #.###  #...    ...# #.# #.# ##
## .  .#.# # =##.# #  # #..#    . .  #. .. #.# .##. #.#.#.  .#   . ....#.# ##  # ##  ....#.##.##.##.#      ....  ... ...  .  .   #  .#   .#.# ### #.# #  #   # #. #
#  # # # #..#. #   # #  .# # ##.####.#.# # # #.#. .#..# .#.#.# #### # # .# #  #. #  #####.##.# # #.#.#.################## ######.##.#.#### #.##.##.##.### #.## #.##
##.#.#.#.# #..#. ### ##.## # #   . # #.#.# . #.###. # # ## ##. #   #.# # # ##  #  #. ..  ..    . ...    . ..   ....    .  . .  ... . .  .   .     ..   . . .. .#. #
#  #.....#. #  #.# .. #.# .#..# ###. #.#.# ##....#.## #.#..  #..##..  .# #. # # .#..#.# # ##.#.# ## ##.# # ###.##.# ########.#### #.# #.## # ## # #.# ###.#####..##
## ##.##.# #..##..##.#. ## # # . ..# # #.#  .# ##  #. #  # ## .# # ##.#..# #.. #. # .#.#.# ..#.# #  # #...## # #.#.#........#  .#..# # # . # #  .# #.## # # .  #. #
## .##.# # .#.#..# #=## .#.# ###### ## ### #...  # ##=#.#..# #.#.  # # #.# ##.# .# .# .# # # #.##.###  # # . #.   . # #####.# ##. #... . ###. #.#         #.##.# ##
#  # . ..# # .## # .... #..#. .. . . ..  ....#.##  . .#..# . #.. #. .  #.#  #  #  # .# # #.#.#  ....  #... #.# ### ## #..   # . #.#.#.## #.. # . ## ##.##  ..  #..#
##.###### # ##.#.####### # # #####.##########.## #.####.# ####.#.#.#### # ##.## ### #  #. ...#.### ##..# # ..  #.   ..# ### #.##   # #.#.###  #.# .#.#  # ##### .##
# ....   ....  ...  ...     .   . . ..  .   ..    ..    ..  . .   .   ....    ... ...# ### #.#.   .#..#  .#.## # ## # #.    #.. # # . .  ....## .#  . .# . ....# ##
## # #####.########.# # ##.## ##############.##.### # ## # # #.# ##.# ##.# #.#.##.#.#... ....#.###  #  #.#.#.## # ### ####### ##  #.###.# ## #  #. #.#  # ## ##. .#
#..#.  . # #.  . ..#.#.#   .#  ... ..  .  .# #   . #.#.# # ##.# #..# #.#..# ## # ## ## #.###.#.# # ##.#     . . ..     ...  ..### ### ##  .#..# .#.#.####.# ## #.##
##.#.#####.#.#### #. # #### ############.# #.# ### #.#.##.#.#   .#=#... .# ...  .  . # .##.#.# #  .   # #### # ##.#.######### .## ... .#.#.# # .# .   . .  .   #..#
#. #.  .   . .  #..#.#.. . .  . .. .. . .  .      .     .  .. ## #..## #. ##.# # ## #..#  .. # .##.##  #  . #. .. # #..  . . .# . ### #.....  #. # ## # # ## ## .##
### ##.####### ## ## #.########### ######################## # # ##.##.# ### #.#.#.# ##.#### #.##.## # ##.####.#.## # ######## ##.##.##.# ##.## ###.#.# # ##.# ##. #
# ..  ..   . .. .. ..  . . ...  = .    ..  . .. ....   .....  .  ...   .. ..   . . .. ... =   .. .  ..   .     . .. .  ....  . .     .. . .. ....  ..  .   .   ..##
###.#.##=## ###.# #.#.## ##.# ##.##.########## ##.## ## ## #.#.# #.# ###.## ##.#.####### ## # # # # ########.### #.#.## #.#.####.###############.###.#.#.#.#.# #. #
#. # #.##  ...  ## # # .##.#.#.#..#.. .   .   # .# ##.#.#..# ##.#. #. .#...# # #  . . . #..  #.#.#...  .   #.# #. #. . ..# # . .. .  .   ..... .#  #..# # #.# #..##
#.##.  . # # ## .. #  # #. .  .#.## # ##### ##..#   ..#  #.#.  ..# .#.#  # #. . ### # #.#.#.#.    # ###.# ##.#. #  # # #.#.##### ####.#.# ##.###. # .#         #..#
# #.=##### ### #####.## ## ### #.#  # .. .   .#.#####.###.#.#####.###.###.## #.#.. .#.# #.#..#.###..#  #. # .# #..##.##.#. .. .# #. . # ## #.#.## .#  #.#######. ##
#..#. .. . .... .. . ...    .  ...# ..### #####  .. ...     ...      . .   . #. #### ## #.# ## .  #. #..# ##...##.#.  # .#.#.# .  # #.#    .=.. . #..#       . #. #
# ##.# #### # ##.# ## ##.## #.###.#.#.. . . . ..#.#.##.## # ### #####.####.##  # ..  ...# #.#. ###. ## ##. #.#  #..# ## ## ## ####.#.  # ##### ##..#..#.#####.#. ##
#    #... ..# # .  ..# #.. # #  .#   #.### #.## #..# # #.#     # . ..  .  #.## .#######.#.#  #. . #..   . #..# # .##... .    . .    # #   ..   #..## ##.#......# .#
####..### ##.##.###### ###.# ### ## #. #   ##.# # # . ## #####.############  #.#... ....# ####.##.# #.# # .#  .## #  ###.# # #.# # #. #.##.# #..#.# .#  # ### #  ##
# .  #......  .  ..  ..  ...  .... . ## ###.# # .#.# #. ..     .. .   ... . # .###.####.#   .  # ##.# #.# #  #  #..# # ##.# #.#.# #.# ## # ## ### ###.# # # ## #..#
####.##.######### # ###############.#.  .. .. . #.   # #.#.#.##.## # # # ##..#.    . .  #.# ##.#.  .# #.#..# # ##.##  . .  .. . . .   .   ..  . .... .    .. .. .##
#  .. .   ... .. ... .. ..     . .. ########### .#.# #  #.# #.#.# # # #.##..##.####.### #.##.#=#.##.#.# #.#  #..   . ###.##### #.# ## #=#.##.## # ## ## ## #.###..#
#=########.####.## ###### ## #### #  .. . . . #.#. # # # ... = .. ..   . .# # .#    .... .   .  . . #.#.# .# #######.# ##..  # ##.#.## # #.### # .. #  .#  .##.# ##
#.#  .  .  #.... # # .. #.#. # ..#. ## #.#.##.# #.#  #  ### # #.###.### ## =.# ####.##.# # #=##.#.#.# # #.## .   ..# #  #.## #. ..  ..    ....  # #.###. # #   #  #
#  ##### #.##.# #. # #.#..###. #.##.#=#.# # # #  .=# # #. .# ##.#.#.# # #.# #  . ..# ###..# #.##.##.. # #.# .#.##=## #.## ##.  # #.#.####.# ### ..#.  . ##. ##.#.##
#.#  ..  #. #.#  # #  # #  . #.#.   #.  .  .  # # # .# #.#.# #. . # #.. # #  # ##.# ... .#.    .. . #.# # ##..#.# #....  .. .# # # # . ..#.# .. # .## # #. #  .#  #
## ###### # ## ##.##.##.###### #####.##########.## #.# # ###.## ##.# #.##.# #.## #.# #### ########## #.#.# #.#  ...#.########.# # # ### ## #####.#.#.##.### ##.#.##
# .. . ...  ..        ..  .   .. . .     . =..  .   ..   .  ..  . ...   . ... .. . ..  ..      .. .  .   =.  ##.# #..# .  .=.    ..  . .   .   .. . ...  .. .  .. #
# # # ## #.## # ## #.##.# ### #.# ###.# #.# # ## ##.####### ### ####### ## #.###############=#.#.#.###.#####..###. #. #.###.# ##### ## ### #### # #.## ## # ##.#.##
## #.##.#.# ## # ## #.#.# .. #.# ## #.##.# #  .#  #. ...  #.#.#.#  .  #.# #.. .. .......   #.## #  # ..#     # .  # .#  # #.#   ...# #.  # #  # ## # ### #  # #   #
#. .   .. .   .  ..  .###.# ##.# #  .    .  #.# .#..### ##..#.#.# #.#.#. ..#.##########.### # # ## ####.#### ..##  #..# # #.# ###.#  ### #  #.#..  .... ..#.#.## ##
###.# #.# ## ## #.#.# . .....  #.#.##.# #.# #. # ##.# ... # # #.#.##.## ###  # .    ..   . ..     .      .   #... # .#.   #.#.#.#  #.    # #... #########...# . ..#
#.## #.#.##.## #.# ##.######.###.### #.##.## ## # ## ###.##.#.# #.......#. #. ############# ############ ###.  ##  #..# ###.# #.#.##.###.# ## # .   . ..  #  #.#.##
#. .  ..   .   . .  .. ....  .=.........  .  . .       .  .  . .# ##### .# #.#....    ... ..#       . .  #   # # .# =#..#. .# ..# #..#.# #... # #.# ##.###..#  #. #
#.###.##### #.##.# #.#.## ##.##.########.####### #### ## #.####.#     #.##.# .##### # ## ## .##.#.# ##.#.# # #  # ##..# ### ##### ##.#.##. #### #.#.# ..% #  ### ##
#.  #...    #.#. #.# #..# # . #     .  #.#. .. ..   #..#.#   .#.  ##.# =...#.#..       #  # #   #.   # # # #.# #. .#.# . . ....    .  .. # #. ..# #  # # #..# .   #
###################################################################################################################################################################
