#################################################################################################################
## #.##.# #.#.# # # #.## ## #.# # ## # ## #.##.##.#.## # ## #.# # # # ##. # # # # # #  #   # # #   .#  #.# #..#.#
# ...  .    .    ..     .. .  .......   .     .  .. .  .  . .  .    . .. #  # # # # .#  # # .# # ##..#    .# #. #
###.## # # ## ##.## # ## # ## # # # ### # # ###.# ####.# # ##.# #### ### .# #.#.# #.#  #.  # # # ## ## ##### ##.#
#.  # ## .# # # # ### #.## # # # # #  # # #   #   . . # # # # #      #  .##.#.# # #. # ## ##.# #    ..    .. ...#
# # # ...#    . . . . .  . #     #  # # # # ## # ### #. # #   # ##.# #.# # .# # #.# #=..  . .# # ## #.# # ## ##.#
# #  # # #.# ## ## #.## ##.#####.#.## #.. #.   # #.#..#  .### #### #   # .# # # #.#= #.## ## # # # ##.## # ## ###
# #.#  # ##.#   . # #. # #  ..    .   . #.# # #. # # ##.#.  #  .#  # # . ## # #.# # #. ##.##      . .           #
# #  #.#  #  ##.##  .# ..#.# ############.# #  # #   . .# ##  #.  #  # #.   # # #.#  #    . .## ##.# # #.# # # ##
#. .# # .## # # # # ##.##  #  .   .    .  # ## . ## # # . # #.# #  # # # ##.#.# #.# #  #####.#.  .  # # #.# # # #
# # .  # # .#.  #...     # .##### # ##.## # .  # .#.# # #   . # #.## #.#.. .# # .   .#     # # ## #  . ..  .  . #
# # #### # #. #  ##.# # ##.#   .# #  .  #.  # #  #. # #  #.##.# # # .. ..## # # # ### .# ##     #  ###.## ### #.#
#.. #.  .# ## #.#.# # # # . .## # #.###.# # #  # ## #.# #  .# ## # # ###      .  . . # #.  #.# #. #   #   #.##.##
# # # ## #   . ..  .# #  #.#  #.# . #.# #.# .#.# .## ## ## ##  . ..#  .#.## ## ##### # ##.#     #.# # # #    . .#
# # # #    # ## ### # .#.# # ## # #   # # # #. # #  .    #.   ##.# # # #      .  ..     .  # ####.# #.#.# ## ##.#
#.# #  # # # # .#.  # #..#.#  . # # #    .#  # #  ##### ## ##  #.# # #.  ##.########.#### #. #   .#.# # #.#..   #
#.  # #. # .  # ###.# ## #   ##      ####.# #  # #.. .# #  #  #  . # # #.# #       .   . = # .### # ##.##.## # ##
# #.# ##. #####   # # .# # #  # # #.#  .# # .# # # # #   # .# .# #.#  ## # # ## ###### #.# # #   .  .    .      #
#   #. # #    ..### # #  # # #  #.#.#.# # # ## #.# ##.# #.##  ## #.# # .  .   .      .      .# ##.# # ### #### ##
# ##  #  #.## #.#  .#  # . # .#.  #.#.# #.#   .#.#. # # #.. #.   # # # # ### # ##### #.##.##.### .##.#.   #.. # #
# ..#..#.#.##  .. # # #  #.# # .#.# # # # ###### # ## # ##.# #.##.#  ## ##. #  #  .. # ##  #   .#    .#.#. # #  #
# # #.#  #   .# ### ## #.# #. # # #.#   . ..       .     . .      .# .. . #. # #.### #   # # ## # ### # #.## #.##
# # #  #.# # ## # .   .    # #. # #  #.##.# #.## # ### # ## #.#.# # .#.###. ## ### # #.###.#   ## #    .       .#
# #   #  # ###.. #### # ## #...# .  #     .# ##.. #. . #.#.# # #.# # #.#. #.#      #.# .   . # . .##.###.# # ## #
# # #  # .    # #  ..   .# #.## #.#.##.## #     # # # #. # # # #.#.# #.# ##  # #.#.# # # #.#  # # .  .   #.#   ##
# # #.#  #.##.# ### # # #  #..     .  . #  ####.#.     #.# ..   . .. # #.   # # #.# # ## # # # #  #### #  ## #  #
#.  #  # . #. #  .#.#.# ##  ####### ## ## # .. . .## ##...# # ## #.# #. #.#       . .   .# .. . #...  .# # ..# ##
# # # #  ## ### # #.## #.  #.. .. . #..   # # ###  # # # #..  #.#. #.###.## ############## # ###  ######  ## #  #
# #.#. #     .         #.#  ## ####..# ## #.#     # . . . # ### ## #  .      .  .  .   ... # #  # #  .   # #.# ##
#.# #.# .# #.##.# # ## . # #...#  # # .#  #.# #.# ##.# # #..  .   . # #.## ### ### # ### # ..#.##. # # #.#.#.# ##
# #    #  #  .  #.   . # # #.# #.## .#. # .## ###    . #. # # ##.##  #.# # .   #  #  # # # # .  . ##.  # . # #  #
#..## #  #  ### # ###.## # #   # #  #  #  #  .    ##.#.# #. #.#.#  # #.#.# #.#. #  #.#.# # # ## # . #.#  ### # ##
# # .  #..# #.# # #   # .# .##.#. #  # .#  .##### # # #.#.##.## ## # # #.## # ###.## #    .# o# # # #. #. ...# ##
#.# # #..#. #.#   # # .# . # # # #  # ### # .  .  ..  ..     .              .       .#.# #.# #  # # #.#  ### #. #
#.##  .#.##   # # #.#.#. #.#...# .# #  ...# #.# # ## ##.## # #.### # # #.##%###.####.#.# .. .##. .# # .#  .  #.##
#  .#.## .# ## .#.# # .# # # #.#.# .# # # .# ## #.  # #.. #.   .  .## # # #.# # . .#   #.#.#. ###.#.#.#..####  ##
### # #  #  # #.# . # #  # ##.# . #.# # # # .  .  #     #  .#=# ##..# #  . .# # #.#  ##  #   #    #  . #   . #  #
# #   ##  #.#.# # #.#  # #   . # ## #.##   # ## #.### ## ## # #.##.## ####### ## # # # #   #. # # # # ## #.### ##
# . #  # ## # # #.#.# ##.# # ##. .. . . #.#  .          .. ..      .       . . .  .  # # ##  # ##.#...# .  . . .#
# ##  ##.#. # #   #   .  #.. ..# ## # ###..# ## # ## ### #.# #.##.# ### #.##.## # ## # # # #.# # .### ###########
###.#.#. ## ... #   # ##.# # ##.  # #  ...# # #.## # # # ## # # . #.# ##   # ..# #.#.# . . # .  #        .  . . #
#     .#  . ## # .## # # #   . # ## # ### #   #.  .   .   = .  #.# . ..  # #.#.  # #  ## ##  # ##.# # ## # ###.##
## ## #  ##.## ##      #.# # ##  #. # #  .# # # ##.# # # ##.# #.  # #.# #  # # # # #.# # #.#      .#.#.#.   .#  #
# #.#. # #.   .   # ###  #.#.  # ## #  ##   # # #  # ## # ## # # ## ##.#.#.  #.#.  #   #  .#.#.##.# .    ###  # #
# # . #..### # ##  #.  # # #.# #  #.# ##  # #.## #     .           .   .  .# # ..# # ##  ##..#  # #.##.#   #.# .#
#  .#. #   ## #   ## ## .# # # # ## #.. #. . .. .##.##### # ### ### ### ## # # #  .#. .# #.# # ## #  o.#.##  .# #
#.# # ## # .  . # #  #.# # # ##  .. # # #.## ## #  ..    #..#.#     .  # #.#  ##.# # #   # # #    .#.###  .# #  #
#.# # #   #.# # # ##   #. .#   #.## ## #   =  ..# ###### ## # ..#### ##  # # #. .#.#   # #.#. ### #.     ## . #.#
# # #. # #  # . # .# ###.# # #.#  #     # ######. .. .    # ###.. o .. # # #.# #.# #.#   # #.#  # .#.# #   # #  #
# #   # . # # # # #  #   # # ## .##.#.#.. .    .#.###### #.   ..#.### # .  #.. # ###.# # #.#.##  .# .  # ##  ## #
# #.#  #.##.# # #..#.#.# #.    # #.# ## #.# # ### #   ....#.### # #.##.#.# # #.  . ..# # #..    #  ###.#.# #.   #
#.#.  #..#  # # # #  # #.#.### #.. # #  # #  #.   #.# ##.#  #   #    .  .#   # # #.#   #   # ###  # .    #.  ## #
#   #. #  # # # # ##     #.#     ##  .# # ##.# ### # # # ### ### ####### ## ## # ### ##.###  #.## #######.## ##.#
#.#.# # .# .  #.# .  #.#  .###.# # # ## #.  .. .      .. ..         .    .  .   .. . ...   # ...           .    #
#.#.# ##. # #  .# ## # #.#    . ...   .  #.### ########.##.### ### ##.## ## ## ## # # ### ##.## # # ##### ## #.##
# # #  # #. # # #.#  #.# # ####.## #### ## # # . . .  ##.# # # #. .# #   # # # #.# ## # ##   #.#.##       #..# ##
# # #.## ## # #.#..# # #.# #   .      .#  .#. #.## ##  ..# #   .##.# # # # .    . . . ..   # # .    #####. # . .#
#.# # #   #    .# # .# #    #.#### ###. ## # # . . .  ## # ### #   # #     ### ######## #.##.#.## #  .. #.#..# ##
#.     # #. ##.#.. # # # # # .#  # #.#.# #.# ## # #### #.#   #. ##.# # # #   . #... .   ###  #.# # #### ##.## # #
# # # # . #  .. # ##.# # #. # # ##.#.#   # # .# #   .   .# ##  # . # .## . # #  #### ##  . #     .. . .. ....   #
# ##  ##.#  ###   #    . #.#  #    # # ## ## ## #.###### #   #   #.# #  .##.## #  ..    # ## #.# # ##.# ### ## ##
#.  #  # ##.# ##.# ###.#.# .# ###### #.      . . .      .  ##  #.#  .# # #  .. ## ##### # #.  .###  #  #.  # # ##
# ## ##.  .     .      # # #. .      . #.################ ## # # # # # # .####     .    #  # #   . #  #. #. ..  #
##     # ##.#.# ## # # #.#  # ##.# # #           ..  .  . . .  #.  #. ##.#   #.### # ##.###  # ###  #..# .#### ##
# .### #.#..#  ..##.#.    .# . # #. #  #.# ## ## # # ## #.## # #.# #.#.  #.# #.  ## # #    #.#.. #.#  #  #. .  .#
##.#.#    #.# ##. # # ##.# # # # ##  # ## # ###.# ## # #  #.#  .##.# # # # # # #      # ####.# ## # ## #.########
#. #  ## # .   # ##    #.# #   #    ##.    .    .  . .  # # ##.#   #.  # # # # # ## ##  #    # . .       . .  ..#
## # # #.## # #     ###  # ### # ## # .# ##.### # # ## #    .#   # # ### # ##   .. .  #  #.# #.## ## # #.# ## #.#
#. #. .  .# #. ## #    # #  .        #.#.#.  .#.#.##.## #.# #. #. .#         # ###.## #.#  # #.  # # # # #  #.# #
## #.# # #  #### ## #### # ## ## ##.#.    # ## .# .      .#  #. ## #.# # # # #   #. # # .#.# # #.#.#.#  ## ## #.#
##=# # .  #.     ..      #.#. ## ..# # ### ## # #########.#### # ### # # ### ### ### ## # # .#.  #=#.#.#      # #
#  # ###.#  ## ### ###.# # # #   #     . ..   ...         ..  . .    .  ..         .  .... # # #     # .#.#.# # #
##.# . .. #.###  .#. #.  #.#   #.# # # # ####### # # #############.## #.# #.#.#.# ####.###   # # #.#   # ## #.# #
## # #.#.# # #.##.#.# ## #  .##  # ##  # #    .#   #..    ...    .# ## # #.#.     .   #  . # # # # # #   .  # #.#
# .# # #    . .      . # #.## ## # ..#.#.##.# #.### .## ## # # ##. .   #  ...## # # ## .##.#.# ###.# ## ### #.###
## #.#..# # ## ## # # #  # #.  ..#.# # #     .   . #         #....#.#### ###   .#  .  #    . #  .  .. . ..  #   #
## # # # ..   .  ##.#  # # # ###.#.# ..# #.# ## ## # ##.### ## #.## # .  .   ### .##### ## # #####=#########. # #
# .#.# # # ## ##   .. #  #. #.. .. #.# #. # #  #.# #..     ..  .. ...# ## ##.  .#. . ..  . #.      ..  .. . # #.#
## # ## .      #.## #  # #.## # # ## # #.## ##.#.### ## ## ######## # # # ## ### ######.##.. ## ## # ##.#.#  .#.#
#     .# ## # #  #  # ##.# .   . .     .      .   . . .     . .            .  .. .    .    #  # # . . ## ## #.. #
##.# ##. ## ##.# #### #  # #### # # #.##.##.# ### ### ## ##.### #.## #.# ## # # ## # # ## #. #.   #.#.      # # #
#. #   #  .  .         # # #   #   ..#. # ### # # # ## ###.## # ##.##.##.#  #. ##  . # # # # .# #   #.## ##.#. .#
## # #.# ########## # # .#  ## #.# #..#   . . # # #  .   .   .    . ...   ### #  .# #     .  #.  ## #.# #.# # ###
# .#.# . #  .  .    #  # # #.   .. # ##.# # #.  #. # # ## #.#.## #.#.# #.#.   # #  .  #.#.##.## #       .   #.# #
## #.###   ####### #. ## # ### # #.#  . # #.# #.# # # # .## # #  .. #.## ######.#.# ## # # #  # # # ## # ## # # #
# .#  .  #  ..  .#  #.#  #      ##..# #   ..#  .# # .  .#       # ##  # . ..     .         #.#.  ## .#.##.# #  .#
## #.#.# ####### # ##  #.# ##.#.#  # ## ## #..# #  ## # .## # # . . #  # # # ## #.###.##### ..#.#.  #    .# #.#.#
#. ..       . ..    . #  #    .  #.#. ..#   .#..# #.### #.#.# # ### # # ..# # ##.#  .    . # ## # #=### ### # # #
## ##.## ###### ##### ## # # ## ## # ## .# #. #.# .  .  # #.#.# #  .#. # #  ..   # ##.# ##.  #. #  .   .   .#   #
# # #.#  .. . #   . #  # #.#  # #  .  # # .  #  ## #### #.# # #.  ###.#.  # # ## #.#..   . #.##   # #.## # #  ###
#  .   # ####   # # #.#  #.# #   # ##.# .# # ##     . #.  # # # #.     # #  #.#  #. #.#####.  # ### ###.# # #.#.#
##### #.      #.# # # .# # #  # ## .#.# # ## .  # # #.#.##.#.##.##### ##.#### ## # ##  . . # # .  . .  .  . # #.#
#   #  # ## ##  # # # #\ # ###. #  #  # #    ##.#. #  #       .. .       . .. .. #.#. ######  #.# ##.## ### # # #
##.## ## #.# # ## ###. # #.   #  # ## #   ##.# ..#  #.# ##.## #.# # ##.# ##.##.##  ## # ..   #  ##.#  # # # #   #
#  .  .      . .   .. # .# # #  #   # # #   . # # .##.# # ## # # ##  #.#= # #  # #.   ..##.#  #    # # .#.# # # #
## ##.### #### # # ###.#.# ## ## # ## #.#### ##  # #. # # .   . .   #  #.#. ##...#.## #  . #.## ## .. # #   . #.#
##.  # .#  . #.   #.     # ....  .      .       ##.#### # #### ##### ##.# ## ####.# #.######.# # #.# # # #### # #
#.## ## ######.## ## ##.# .## # ### # ### ##### . ... . .  . . ..                    .       .      . . .  . .  #
#.   . .   . .# .       .# #      # # #      .  # ## ## ##.# # ### #### #.#.# ## ## ## ############ #.#.## # ## #
###.### ###.# # ######## #.# ####.## # ######## ###  # #.#.##.## ##.  #.## # # # ## #   .   .    .# #  # # #  # #
# .. .#      .    ..    . .#     .     ..   . .     #  .    .      #.#.. .      .     ##.#.# ##.# #.#.#    ##...#
#.##### ####### ##.# ### ## .# ## # ### ##.#.##.###  # ## ## # # #.#  ##.##.# ### # #.   # .  . . #.#  ###..# # #
# .         . . ## #.# ## # #.## # #   #   .  # # # # # # #.# # ## # # ###.# ## ##.# ### # # ###.## # #  # #  # #
# #.##.######## .     . ..    .   . o# # ## #.#    .   ..  .  .  .            .       .   ..     .. ..## #  #.  #
#  #  .  .    #.#.# # # ##.# ## ## # # # #  # # # #######################.#.# ###.# ###.# # ### ## ##    #.# .# #
#### ##########  # # #.#.## # # # # ## #.##  .# # #    .       .   . .   .. #. .. ##   # #.# ..#    . ## #. # # #
#      .    .   #. ..   ... ... .   .      .# # # # ### ##.## ####.# # ##.#. # ##   # #    # #  # # # ## ..## ###
## # ##.## #.## .# # ## # ## # # ## ##.# ## # #.. # # # #.  #     # #  .# # # # # ### # ##.# # # # ##  ..#      #
#.# #   .# #.#..# #.##.#.    ### ##. # ## # # # # # . # .#.#  # # # # #. .# #     #    .          .   #### ## ###
#   . #.#  # .# #...    # ##.  . ..#.      .  . # # ##  ##  # ### #.#.### # #.# #  .##.# #.### #.## # # .   # . #
##### # ##  .## # ###### # # #####.# ## # # # #.# # #.# #. ##         . # # # ### ## ## # #  #.## #  . # ###..###
#   .....# #   .... .      ..     .  .. ..   . .  #   #. # # .# ## #.#.#. # .# ..     . .. # . .   .# #  . .#.  #
#################################################################################################################
