#######################
# # # #.# #=#%#.# # # #
#.....#.# # # #.#.....#
#.#=#.#.# # # #.#.#.#.#
#.....#.# # # #.#.....#
# # # #.# # # #.# # # #
# # # #.# # # #.# # # #
#          \          #
# # # #.# # # #.# # # #
# # # #.# # # #.# # # #
# # # #.# # # #.# # # #
#.....#.# # # #.#.....#
#.#=#.#.# # # #.#.#.#.#
#.....#.# # # #.#.....#
# # # #.# #=# #.# # # #
#######################
