##############
#.....====...#
#.#########..#
#.....====...#
#.#########..#
#.....====..o#
#\#########.%#
#.....====...#
#.#########..#
#.....====...#
##############
