#######################
#====.................#
#.....................#
#.....................#
#.....................#
#.....................#
#.....................#
#.....................#
#.....................#
#.....................#
#.....................#
#.....................#
#.....................#
#.....................#
#.....................#
#.....................#
#.....................#
#.....................#
#.....................#
#.....................#
#....................\#
#######################
