#######################
#..........#......=...#
#.###.####.#.####.###.#
#o###.####.#.####.###o#
#...=.................#
#.###.#.#######.#.###.#
#.....#....#....#.....#
#####.#### # ####.#####
#   #.#    =    #.#   #
#####.# ####### #.#####
#    .  #     #  .  = #
#####.# ####### #.#####
#   #.#    %    #.#   #
#####.# ####### #.#####
#...=......#..........#
#.###.####.#.####.###.#
#o..#......\......#..o#
###.#.#.#######.#.#.###
#.....#....#....#.....#
#.########.#.########.#
#...................=.#
#######################
