#################
#\   =#   oooooo#
#.###   #######o#
#.  ### #######o#
#.#   #     #.#o#
#.# # #### ## #o#
#.# #    #  # # #
#.# #### ## #   #
#.# #%#   # #####
#.# # # # #     #
#.# #   # #### ##
#.# # # # #=   =#
#################
