###############
#=...........o#
#.###.###.###.#
#.# #.# #.# #.#
#.###.###.###.#
#....\........#
#.###.###.###.#
#.# #.# #.# #.#
#.###.###.###.#
#.............#
#.###.###=###.#
#.# #.# #.# #.#
#.###.###.###.#
#o.....%.....=#
###############
