###############
#=...........o#
#.###=###.###.#
#.# #.# #.# #.#
#.###.###.###.#
#..=.\.=......#
#.###.###.###.#
#.# #.# #.# #.#
#.###=###.###.#
#.............#
#.###.###=###.#
#.# #.# #.# #.#
#.###.###.###.#
#o.....%.....=#
###############
